ID,Флаг дозвона,Флаг продажи,Расходы,PV,NPV
0,0,0,35,0,-35
1,1,0,71,0,-71
2,0,0,37,0,-37
3,0,0,58,0,-58
4,0,0,21,0,-21
5,0,0,37,0,-37
6,0,0,37,0,-37
7,1,1,91,1215,1124
8,0,0,56,0,-56
9,1,0,7,0,-7
10,1,0,41,0,-41
11,0,0,17,0,-17
12,0,0,68,0,-68
13,1,1,433,1594,1161
14,0,0,1,0,-1
15,1,1,377,1283,906
16,1,0,21,0,-21
17,1,1,654,1726,1072
18,1,1,153,1541,1388
19,0,0,39,0,-39
20,1,1,1280,1844,564
21,1,0,22,0,-22
22,1,0,151,0,-151
23,1,1,432,1611,1179
24,0,0,63,0,-63
25,0,0,423,0,-423
26,1,0,86,0,-86
27,1,1,707,2253,1546
28,1,1,387,1246,859
29,1,0,167,0,-167
30,0,0,10,0,-10
31,0,0,38,0,-38
32,0,0,15,0,-15
33,1,1,746,2337,1591
34,1,1,99,1203,1104
35,1,1,182,1408,1226
36,1,1,425,1232,807
37,0,0,26,0,-26
38,1,1,657,1263,606
39,0,0,130,0,-130
40,0,0,90,0,-90
41,1,1,363,1528,1165
42,1,1,603,1433,830
43,0,0,263,0,-263
44,1,1,1526,1524,-2
45,1,1,295,1272,977
46,1,1,453,1355,902
47,1,0,14,0,-14
48,1,0,4,0,-4
49,0,0,14,0,-14
50,0,0,121,0,-121
51,1,1,662,1623,961
52,1,0,17,0,-17
53,1,0,9,0,-9
54,1,0,0,0,0
55,0,0,71,0,-71
56,0,0,28,0,-28
57,1,1,285,1690,1405
58,0,0,48,0,-48
59,0,0,12,0,-12
60,1,1,256,1221,965
61,1,1,531,1216,685
62,1,0,7,0,-7
63,0,0,46,0,-46
64,0,0,32,0,-32
65,1,1,2195,1366,-829
66,0,0,31,0,-31
67,0,0,43,0,-43
68,1,1,226,1249,1023
69,0,0,68,0,-68
70,0,0,25,0,-25
71,0,0,36,0,-36
72,1,1,167,1756,1589
73,0,0,15,0,-15
74,1,1,231,4223,3992
75,1,1,238,1341,1103
76,1,0,20,0,-20
77,1,0,137,0,-137
78,1,0,20,0,-20
79,1,1,313,1688,1375
80,1,1,123,2402,2279
81,1,0,35,0,-35
82,0,0,15,0,-15
83,1,1,320,1256,936
84,1,1,283,1448,1165
85,1,0,7,0,-7
86,1,0,94,0,-94
87,0,0,13,0,-13
88,1,1,276,1537,1261
89,1,0,3,0,-3
90,1,1,674,1739,1065
91,0,0,16,0,-16
92,1,1,504,2876,2372
93,1,1,31,1470,1439
94,0,0,10,0,-10
95,1,1,314,1247,933
96,1,1,1276,1376,100
97,1,1,132,1262,1130
98,0,0,20,0,-20
99,1,0,45,0,-45
100,1,0,42,0,-42
101,1,0,57,0,-57
102,0,0,73,0,-73
103,0,0,85,0,-85
104,1,1,1056,1779,723
105,0,0,34,0,-34
106,1,1,709,1317,608
107,1,0,8,0,-8
108,0,0,40,0,-40
109,1,0,13,0,-13
110,1,0,41,0,-41
111,1,1,370,1218,848
112,0,0,44,0,-44
113,1,1,288,2092,1804
114,1,0,8,0,-8
115,1,0,14,0,-14
116,1,1,358,1215,857
117,0,0,3,0,-3
118,1,1,314,1501,1187
119,1,0,1,0,-1
120,1,1,188,1588,1400
121,1,0,64,0,-64
122,1,1,423,1816,1393
123,0,0,65,0,-65
124,1,0,44,0,-44
125,1,0,275,0,-275
126,1,1,820,1266,446
127,0,0,154,0,-154
128,1,0,43,0,-43
129,0,0,39,0,-39
130,0,0,44,0,-44
131,1,0,14,0,-14
132,1,1,1393,1527,134
133,1,0,60,0,-60
134,1,0,30,0,-30
135,0,0,52,0,-52
136,1,0,88,0,-88
137,0,0,13,0,-13
138,1,1,1761,1875,114
139,0,0,10,0,-10
140,1,0,41,0,-41
141,0,0,193,0,-193
142,1,0,24,0,-24
143,1,0,40,0,-40
144,0,0,136,0,-136
145,0,0,0,0,0
146,0,0,37,0,-37
147,1,1,259,1318,1059
148,1,1,173,1508,1335
149,1,0,72,0,-72
150,0,0,25,0,-25
151,1,0,43,0,-43
152,0,0,53,0,-53
153,0,0,3,0,-3
154,1,0,19,0,-19
155,1,0,25,0,-25
156,1,1,345,1289,944
157,0,0,13,0,-13
158,0,0,38,0,-38
159,1,0,95,0,-95
160,1,0,15,0,-15
161,1,1,792,1399,607
162,0,0,59,0,-59
163,1,0,61,0,-61
164,0,0,19,0,-19
165,1,1,1560,1420,-140
166,1,0,30,0,-30
167,1,1,111,1359,1248
168,1,0,40,0,-40
169,0,0,48,0,-48
170,1,1,548,1384,836
171,1,0,15,0,-15
172,1,0,19,0,-19
173,1,0,24,0,-24
174,1,1,260,1305,1045
175,1,0,6,0,-6
176,0,0,0,0,0
177,1,1,122,1304,1182
178,0,0,46,0,-46
179,1,1,210,1221,1011
180,1,0,0,0,0
181,0,0,189,0,-189
182,1,1,799,1442,643
183,0,0,117,0,-117
184,0,0,9,0,-9
185,0,0,109,0,-109
186,1,1,184,2094,1910
187,1,0,125,0,-125
188,0,0,27,0,-27
189,0,0,3,0,-3
190,1,1,168,1275,1107
191,0,0,20,0,-20
192,1,1,413,2283,1870
193,1,0,0,0,0
194,0,0,7,0,-7
195,1,1,599,1227,628
196,1,0,98,0,-98
197,1,1,723,1265,542
198,1,1,681,1623,942
199,0,0,55,0,-55
200,1,1,328,1551,1223
201,1,0,2,0,-2
202,1,0,34,0,-34
203,1,0,6,0,-6
204,0,0,13,0,-13
205,1,1,240,1696,1456
206,0,0,18,0,-18
207,1,1,1751,1623,-128
208,0,0,8,0,-8
209,0,0,65,0,-65
210,1,1,1341,1270,-71
211,1,0,115,0,-115
212,0,0,68,0,-68
213,1,1,261,1244,983
214,0,0,46,0,-46
215,1,1,48,1216,1168
216,1,0,11,0,-11
217,1,0,190,0,-190
218,0,0,31,0,-31
219,0,0,16,0,-16
220,1,0,49,0,-49
221,1,1,764,1457,693
222,1,1,410,1358,948
223,1,1,667,1215,548
224,1,0,16,0,-16
225,1,0,63,0,-63
226,0,0,74,0,-74
227,1,1,383,1433,1050
228,1,1,498,1321,823
229,1,0,10,0,-10
230,0,0,15,0,-15
231,0,0,16,0,-16
232,1,0,222,0,-222
233,0,0,0,0,0
234,1,1,153,1776,1623
235,1,0,110,0,-110
236,1,0,82,0,-82
237,1,0,25,0,-25
238,1,0,135,0,-135
239,1,0,5,0,-5
240,1,1,1012,1253,241
241,0,0,111,0,-111
242,0,0,26,0,-26
243,0,0,20,0,-20
244,0,0,34,0,-34
245,0,0,49,0,-49
246,1,0,6,0,-6
247,1,1,289,1223,934
248,1,0,60,0,-60
249,0,0,180,0,-180
250,1,1,128,1301,1173
251,1,0,49,0,-49
252,1,0,12,0,-12
253,0,0,6,0,-6
254,1,1,226,1687,1461
255,1,0,37,0,-37
256,1,0,65,0,-65
257,1,0,3,0,-3
258,1,1,338,1453,1115
259,1,1,159,2113,1954
260,1,0,149,0,-149
261,0,0,28,0,-28
262,1,0,53,0,-53
263,0,0,73,0,-73
264,1,1,1015,1358,343
265,1,1,382,1717,1335
266,1,1,143,4442,4299
267,1,0,46,0,-46
268,0,0,3,0,-3
269,1,0,52,0,-52
270,1,0,79,0,-79
271,1,0,130,0,-130
272,1,1,398,1257,859
273,0,0,43,0,-43
274,1,1,941,1287,346
275,0,0,25,0,-25
276,0,0,42,0,-42
277,1,1,419,1793,1374
278,1,0,33,0,-33
279,0,0,7,0,-7
280,1,0,22,0,-22
281,0,0,93,0,-93
282,1,0,86,0,-86
283,0,0,1,0,-1
284,1,1,564,3257,2693
285,0,0,114,0,-114
286,1,1,1315,1947,632
287,1,1,482,1236,754
288,0,0,9,0,-9
289,0,0,72,0,-72
290,0,0,61,0,-61
291,1,0,64,0,-64
292,0,0,81,0,-81
293,1,0,174,0,-174
294,1,0,111,0,-111
295,0,0,12,0,-12
296,0,0,97,0,-97
297,0,0,13,0,-13
298,1,1,784,1263,479
299,0,0,59,0,-59
300,1,0,155,0,-155
301,1,0,7,0,-7
302,0,0,1,0,-1
303,1,0,48,0,-48
304,1,1,360,1516,1156
305,0,0,13,0,-13
306,0,0,34,0,-34
307,1,1,68,1653,1585
308,0,0,61,0,-61
309,1,0,29,0,-29
310,1,1,1269,1442,173
311,0,0,8,0,-8
312,0,0,18,0,-18
313,1,1,830,1211,381
314,1,0,51,0,-51
315,1,0,0,0,0
316,1,0,16,0,-16
317,1,0,0,0,0
318,0,0,16,0,-16
319,0,0,19,0,-19
320,1,1,45,1294,1249
321,1,1,121,1223,1102
322,0,0,13,0,-13
323,1,0,64,0,-64
324,0,0,55,0,-55
325,1,0,54,0,-54
326,1,1,1581,1306,-275
327,0,0,10,0,-10
328,1,0,121,0,-121
329,0,0,4,0,-4
330,0,0,15,0,-15
331,0,0,8,0,-8
332,1,1,285,2083,1798
333,0,0,68,0,-68
334,0,0,49,0,-49
335,0,0,37,0,-37
336,1,0,58,0,-58
337,0,0,14,0,-14
338,0,0,73,0,-73
339,1,1,86,1924,1838
340,0,0,275,0,-275
341,0,0,28,0,-28
342,1,1,139,1355,1216
343,0,0,36,0,-36
344,1,0,2,0,-2
345,0,0,70,0,-70
346,1,1,223,1674,1451
347,0,0,4,0,-4
348,1,0,53,0,-53
349,0,0,28,0,-28
350,0,0,46,0,-46
351,1,1,146,1633,1487
352,1,0,33,0,-33
353,1,0,171,0,-171
354,1,1,1352,1382,30
355,1,0,3,0,-3
356,1,0,43,0,-43
357,1,1,1344,1521,177
358,0,0,19,0,-19
359,0,0,37,0,-37
360,0,0,0,0,0
361,0,0,2,0,-2
362,0,0,69,0,-69
363,0,0,4,0,-4
364,1,1,192,2107,1915
365,1,1,120,1574,1454
366,1,1,938,1578,640
367,1,1,1070,2178,1108
368,1,0,10,0,-10
369,1,1,394,1309,915
370,1,1,216,1287,1071
371,0,0,77,0,-77
372,1,0,9,0,-9
373,1,1,345,2312,1967
374,0,0,30,0,-30
375,1,0,72,0,-72
376,1,0,17,0,-17
377,0,0,131,0,-131
378,1,0,19,0,-19
379,1,1,688,1534,846
380,0,0,46,0,-46
381,0,0,108,0,-108
382,0,0,22,0,-22
383,1,1,690,1804,1114
384,1,0,22,0,-22
385,0,0,0,0,0
386,1,1,305,1544,1239
387,0,0,61,0,-61
388,0,0,20,0,-20
389,0,0,28,0,-28
390,1,1,2451,1286,-1165
391,1,0,99,0,-99
392,0,0,29,0,-29
393,0,0,63,0,-63
394,1,0,89,0,-89
395,0,0,47,0,-47
396,0,0,9,0,-9
397,0,0,29,0,-29
398,1,1,93,2263,2170
399,1,0,7,0,-7
400,1,0,2,0,-2
401,1,1,120,1435,1315
402,1,1,251,1828,1577
403,1,1,897,2168,1271
404,1,1,146,1228,1082
405,0,0,12,0,-12
406,1,1,245,1651,1406
407,1,1,442,1266,824
408,0,0,27,0,-27
409,0,0,19,0,-19
410,1,0,24,0,-24
411,1,0,23,0,-23
412,1,1,1296,2262,966
413,1,0,1,0,-1
414,1,1,106,1301,1195
415,1,0,124,0,-124
416,0,0,51,0,-51
417,1,0,70,0,-70
418,1,1,43,1405,1362
419,1,1,244,1568,1324
420,1,0,114,0,-114
421,1,1,511,1303,792
422,0,0,30,0,-30
423,1,0,142,0,-142
424,1,0,49,0,-49
425,1,1,1079,1435,356
426,0,0,36,0,-36
427,0,0,5,0,-5
428,1,0,9,0,-9
429,0,0,19,0,-19
430,1,1,313,1888,1575
431,0,0,7,0,-7
432,1,0,57,0,-57
433,1,0,26,0,-26
434,1,0,56,0,-56
435,1,0,79,0,-79
436,1,0,225,0,-225
437,1,1,655,2458,1803
438,0,0,85,0,-85
439,1,1,3583,1392,-2191
440,0,0,40,0,-40
441,0,0,12,0,-12
442,0,0,36,0,-36
443,1,0,23,0,-23
444,1,1,335,1743,1408
445,1,1,819,1391,572
446,0,0,21,0,-21
447,0,0,82,0,-82
448,0,0,57,0,-57
449,0,0,92,0,-92
450,1,0,58,0,-58
451,0,0,50,0,-50
452,1,1,411,1735,1324
453,1,0,8,0,-8
454,1,1,1977,2458,481
455,0,0,14,0,-14
456,0,0,52,0,-52
457,1,0,54,0,-54
458,1,0,36,0,-36
459,1,0,0,0,0
460,0,0,4,0,-4
461,1,0,6,0,-6
462,1,0,23,0,-23
463,1,0,30,0,-30
464,1,1,376,1222,846
465,1,1,170,1232,1062
466,1,1,441,1241,800
467,0,0,15,0,-15
468,0,0,149,0,-149
469,0,0,26,0,-26
470,0,0,25,0,-25
471,1,0,29,0,-29
472,1,0,33,0,-33
473,1,0,123,0,-123
474,1,0,37,0,-37
475,1,1,1129,1233,104
476,1,0,18,0,-18
477,0,0,26,0,-26
478,1,0,73,0,-73
479,0,0,56,0,-56
480,1,0,48,0,-48
481,1,1,348,1296,948
482,1,0,53,0,-53
483,1,0,181,0,-181
484,0,0,5,0,-5
485,1,1,59,1397,1338
486,1,0,210,0,-210
487,1,0,33,0,-33
488,1,0,46,0,-46
489,1,0,47,0,-47
490,1,1,1107,1844,737
491,0,0,29,0,-29
492,1,0,28,0,-28
493,1,0,5,0,-5
494,0,0,24,0,-24
495,0,0,2,0,-2
496,0,0,121,0,-121
497,0,0,66,0,-66
498,1,1,341,1970,1629
499,1,1,596,1391,795
500,0,0,35,0,-35
501,0,0,89,0,-89
502,0,0,66,0,-66
503,1,0,38,0,-38
504,0,0,18,0,-18
505,1,1,294,1455,1161
506,0,0,13,0,-13
507,0,0,46,0,-46
508,1,0,83,0,-83
509,1,1,410,1228,818
510,1,0,5,0,-5
511,1,0,11,0,-11
512,1,0,115,0,-115
513,1,1,84,1600,1516
514,1,1,186,1704,1518
515,0,0,219,0,-219
516,1,0,162,0,-162
517,1,1,415,1264,849
518,1,1,610,1303,693
519,0,0,36,0,-36
520,1,1,101,1976,1875
521,0,0,16,0,-16
522,0,0,50,0,-50
523,1,0,5,0,-5
524,0,0,21,0,-21
525,1,0,36,0,-36
526,1,0,9,0,-9
527,1,0,43,0,-43
528,0,0,40,0,-40
529,1,1,2064,1209,-855
530,0,0,7,0,-7
531,1,1,1310,1347,37
532,0,0,56,0,-56
533,1,0,8,0,-8
534,1,0,87,0,-87
535,1,1,359,1203,844
536,1,1,576,1278,702
537,0,0,72,0,-72
538,0,0,8,0,-8
539,0,0,2,0,-2
540,0,0,105,0,-105
541,0,0,5,0,-5
542,0,0,16,0,-16
543,1,1,453,1581,1128
544,1,1,929,1264,335
545,1,1,255,1316,1061
546,1,1,668,1242,574
547,0,0,9,0,-9
548,1,1,1185,1264,79
549,0,0,38,0,-38
550,1,0,37,0,-37
551,0,0,142,0,-142
552,0,0,7,0,-7
553,1,0,27,0,-27
554,1,0,8,0,-8
555,0,0,104,0,-104
556,1,0,47,0,-47
557,1,0,67,0,-67
558,1,0,35,0,-35
559,0,0,45,0,-45
560,0,0,138,0,-138
561,1,1,52,2405,2353
562,0,0,9,0,-9
563,0,0,1,0,-1
564,0,0,41,0,-41
565,0,0,162,0,-162
566,1,0,136,0,-136
567,1,0,33,0,-33
568,1,0,36,0,-36
569,0,0,22,0,-22
570,1,0,106,0,-106
571,0,0,70,0,-70
572,1,1,667,1200,533
573,1,1,204,1702,1498
574,1,1,265,1273,1008
575,1,1,43,1759,1716
576,1,1,290,1244,954
577,1,1,1076,2312,1236
578,1,1,178,3244,3066
579,0,0,82,0,-82
580,1,0,3,0,-3
581,1,0,64,0,-64
582,0,0,45,0,-45
583,1,0,3,0,-3
584,1,1,269,1212,943
585,0,0,7,0,-7
586,1,1,1013,2183,1170
587,0,0,26,0,-26
588,1,1,90,1274,1184
589,0,0,11,0,-11
590,1,1,11,1480,1469
591,0,0,11,0,-11
592,1,1,76,1250,1174
593,0,0,9,0,-9
594,1,0,7,0,-7
595,0,0,57,0,-57
596,1,1,17,1300,1283
597,0,0,16,0,-16
598,0,0,78,0,-78
599,0,0,55,0,-55
600,1,1,985,1273,288
601,1,1,1618,1380,-238
602,1,1,20,1888,1868
603,0,0,35,0,-35
604,1,1,255,1232,977
605,1,1,394,1531,1137
606,0,0,67,0,-67
607,1,0,42,0,-42
608,0,0,12,0,-12
609,0,0,17,0,-17
610,1,0,178,0,-178
611,1,0,52,0,-52
612,0,0,59,0,-59
613,1,0,47,0,-47
614,0,0,59,0,-59
615,1,1,54,1587,1533
616,1,0,106,0,-106
617,1,1,728,1673,945
618,1,0,26,0,-26
619,1,0,19,0,-19
620,1,1,1180,1911,731
621,0,0,16,0,-16
622,0,0,78,0,-78
623,1,1,184,1488,1304
624,1,1,1269,1300,31
625,0,0,162,0,-162
626,1,0,54,0,-54
627,0,0,47,0,-47
628,1,0,27,0,-27
629,1,0,151,0,-151
630,1,1,456,3461,3005
631,1,0,78,0,-78
632,0,0,62,0,-62
633,0,0,2,0,-2
634,1,1,335,1419,1084
635,1,1,1113,2443,1330
636,0,0,6,0,-6
637,1,0,112,0,-112
638,1,0,28,0,-28
639,1,0,32,0,-32
640,1,0,33,0,-33
641,1,0,5,0,-5
642,1,0,3,0,-3
643,1,1,56,1357,1301
644,1,0,39,0,-39
645,1,0,51,0,-51
646,1,1,311,5608,5297
647,0,0,65,0,-65
648,1,1,629,1729,1100
649,0,0,3,0,-3
650,1,0,66,0,-66
651,1,0,22,0,-22
652,1,1,1277,1739,462
653,1,0,7,0,-7
654,0,0,97,0,-97
655,0,0,2,0,-2
656,1,0,0,0,0
657,0,0,6,0,-6
658,0,0,3,0,-3
659,1,0,0,0,0
660,1,1,806,1342,536
661,1,1,209,1214,1005
662,0,0,56,0,-56
663,1,1,203,1890,1687
664,1,1,34,1448,1414
665,1,0,142,0,-142
666,0,0,56,0,-56
667,1,1,392,1352,960
668,1,0,35,0,-35
669,0,0,124,0,-124
670,1,1,210,1390,1180
671,0,0,35,0,-35
672,1,0,100,0,-100
673,0,0,35,0,-35
674,1,1,527,1411,884
675,1,0,50,0,-50
676,0,0,0,0,0
677,1,1,934,2051,1117
678,1,0,222,0,-222
679,1,1,58,1512,1454
680,1,1,484,2298,1814
681,1,1,423,1926,1503
682,0,0,49,0,-49
683,0,0,63,0,-63
684,0,0,17,0,-17
685,0,0,65,0,-65
686,0,0,66,0,-66
687,1,0,8,0,-8
688,1,1,236,1496,1260
689,0,0,5,0,-5
690,1,0,21,0,-21
691,1,1,1490,1224,-266
692,0,0,62,0,-62
693,1,0,61,0,-61
694,0,0,63,0,-63
695,0,0,27,0,-27
696,1,0,12,0,-12
697,1,0,114,0,-114
698,1,1,519,1426,907
699,1,0,11,0,-11
700,1,1,156,1224,1068
701,1,1,394,2054,1660
702,1,1,283,1569,1286
703,1,0,109,0,-109
704,0,0,10,0,-10
705,1,1,168,1381,1213
706,0,0,57,0,-57
707,1,0,17,0,-17
708,1,1,348,2178,1830
709,1,0,74,0,-74
710,0,0,19,0,-19
711,0,0,19,0,-19
712,1,0,16,0,-16
713,0,0,22,0,-22
714,1,1,1330,1839,509
715,1,1,116,1540,1424
716,1,1,1404,2235,831
717,1,1,738,1643,905
718,1,0,133,0,-133
719,1,0,35,0,-35
720,1,0,42,0,-42
721,1,1,189,1349,1160
722,1,1,27,1320,1293
723,0,0,35,0,-35
724,0,0,52,0,-52
725,1,0,7,0,-7
726,1,0,150,0,-150
727,1,0,4,0,-4
728,1,0,49,0,-49
729,1,1,369,1326,957
730,0,0,17,0,-17
731,0,0,11,0,-11
732,0,0,24,0,-24
733,0,0,183,0,-183
734,1,0,8,0,-8
735,1,1,207,1215,1008
736,1,0,3,0,-3
737,1,0,116,0,-116
738,1,1,271,1257,986
739,1,1,548,1214,666
740,1,1,507,1226,719
741,1,0,42,0,-42
742,1,0,26,0,-26
743,0,0,9,0,-9
744,0,0,6,0,-6
745,0,0,31,0,-31
746,0,0,0,0,0
747,0,0,3,0,-3
748,0,0,11,0,-11
749,1,1,146,1516,1370
750,1,0,5,0,-5
751,0,0,13,0,-13
752,1,1,430,1243,813
753,1,1,172,1226,1054
754,1,0,16,0,-16
755,1,1,322,2896,2574
756,1,0,20,0,-20
757,0,0,22,0,-22
758,1,0,21,0,-21
759,1,0,59,0,-59
760,1,1,62,1339,1277
761,0,0,109,0,-109
762,0,0,73,0,-73
763,0,0,33,0,-33
764,1,0,190,0,-190
765,0,0,28,0,-28
766,0,0,50,0,-50
767,1,0,45,0,-45
768,1,1,123,1410,1287
769,0,0,0,0,0
770,1,1,843,4411,3568
771,0,0,78,0,-78
772,0,0,167,0,-167
773,0,0,46,0,-46
774,1,1,125,1375,1250
775,0,0,4,0,-4
776,0,0,1,0,-1
777,1,1,201,1675,1474
778,1,1,425,1446,1021
779,0,0,39,0,-39
780,1,1,931,1293,362
781,1,0,22,0,-22
782,1,1,753,1506,753
783,1,0,14,0,-14
784,1,0,34,0,-34
785,1,0,11,0,-11
786,1,1,202,2012,1810
787,0,0,4,0,-4
788,1,1,59,1268,1209
789,0,0,42,0,-42
790,0,0,99,0,-99
791,0,0,3,0,-3
792,1,0,15,0,-15
793,1,1,583,1860,1277
794,0,0,50,0,-50
795,0,0,14,0,-14
796,0,0,29,0,-29
797,1,1,611,1323,712
798,0,0,41,0,-41
799,0,0,43,0,-43
800,0,0,19,0,-19
801,1,0,2,0,-2
802,1,1,696,1262,566
803,0,0,100,0,-100
804,1,0,159,0,-159
805,1,1,101,1328,1227
806,1,1,184,1521,1337
807,0,0,15,0,-15
808,1,0,4,0,-4
809,1,0,10,0,-10
810,0,0,5,0,-5
811,1,1,428,1271,843
812,1,0,54,0,-54
813,0,0,4,0,-4
814,1,0,62,0,-62
815,1,1,253,1535,1282
816,0,0,77,0,-77
817,0,0,63,0,-63
818,1,0,37,0,-37
819,1,0,32,0,-32
820,1,1,507,1696,1189
821,0,0,61,0,-61
822,0,0,45,0,-45
823,0,0,17,0,-17
824,0,0,16,0,-16
825,1,1,389,1208,819
826,1,0,63,0,-63
827,0,0,36,0,-36
828,0,0,0,0,0
829,0,0,121,0,-121
830,0,0,18,0,-18
831,1,0,17,0,-17
832,1,1,594,1215,621
833,1,0,55,0,-55
834,1,1,1255,1307,52
835,0,0,14,0,-14
836,0,0,58,0,-58
837,1,1,601,1588,987
838,0,0,42,0,-42
839,0,0,30,0,-30
840,0,0,20,0,-20
841,0,0,26,0,-26
842,0,0,69,0,-69
843,1,0,33,0,-33
844,0,0,20,0,-20
845,0,0,47,0,-47
846,0,0,26,0,-26
847,0,0,41,0,-41
848,1,1,67,1314,1247
849,0,0,8,0,-8
850,1,0,21,0,-21
851,0,0,46,0,-46
852,1,0,12,0,-12
853,0,0,40,0,-40
854,1,1,210,1504,1294
855,1,0,29,0,-29
856,1,0,93,0,-93
857,1,1,233,1309,1076
858,1,0,32,0,-32
859,1,1,874,1325,451
860,0,0,57,0,-57
861,1,0,114,0,-114
862,0,0,19,0,-19
863,1,1,40,1902,1862
864,1,0,258,0,-258
865,0,0,30,0,-30
866,1,0,16,0,-16
867,1,1,408,1819,1411
868,1,1,442,1202,760
869,1,1,105,1521,1416
870,1,0,15,0,-15
871,1,0,111,0,-111
872,0,0,220,0,-220
873,1,0,47,0,-47
874,0,0,5,0,-5
875,0,0,10,0,-10
876,0,0,52,0,-52
877,1,1,68,1325,1257
878,0,0,9,0,-9
879,0,0,141,0,-141
880,1,1,363,1293,930
881,1,0,58,0,-58
882,1,0,12,0,-12
883,1,1,883,1248,365
884,0,0,76,0,-76
885,1,1,392,1978,1586
886,1,1,667,2003,1336
887,0,0,103,0,-103
888,1,1,425,1482,1057
889,0,0,7,0,-7
890,0,0,7,0,-7
891,1,1,54,1586,1532
892,0,0,172,0,-172
893,1,1,145,1380,1235
894,1,1,26,2755,2729
895,1,0,148,0,-148
896,1,0,45,0,-45
897,1,0,37,0,-37
898,1,0,155,0,-155
899,1,1,285,1322,1037
900,0,0,84,0,-84
901,1,0,6,0,-6
902,1,1,844,1512,668
903,1,0,16,0,-16
904,0,0,6,0,-6
905,0,0,5,0,-5
906,1,1,126,1200,1074
907,0,0,95,0,-95
908,1,1,997,1337,340
909,1,0,131,0,-131
910,0,0,24,0,-24
911,1,0,5,0,-5
912,1,1,745,1410,665
913,1,1,839,2161,1322
914,1,0,142,0,-142
915,1,0,229,0,-229
916,1,1,237,1373,1136
917,0,0,65,0,-65
918,1,0,14,0,-14
919,0,0,298,0,-298
920,1,1,1861,2159,298
921,0,0,37,0,-37
922,0,0,102,0,-102
923,1,1,185,1399,1214
924,0,0,19,0,-19
925,0,0,17,0,-17
926,1,1,1479,1247,-232
927,1,1,119,1308,1189
928,1,0,44,0,-44
929,1,0,3,0,-3
930,1,0,93,0,-93
931,1,0,10,0,-10
932,1,1,151,1231,1080
933,1,0,27,0,-27
934,0,0,96,0,-96
935,1,0,3,0,-3
936,1,1,1017,2038,1021
937,0,0,27,0,-27
938,1,0,50,0,-50
939,1,1,572,1267,695
940,1,0,58,0,-58
941,0,0,13,0,-13
942,1,1,196,1308,1112
943,0,0,43,0,-43
944,0,0,138,0,-138
945,1,1,142,1556,1414
946,1,0,36,0,-36
947,0,0,144,0,-144
948,0,0,7,0,-7
949,0,0,24,0,-24
950,0,0,87,0,-87
951,1,0,23,0,-23
952,1,0,67,0,-67
953,1,1,310,1374,1064
954,0,0,14,0,-14
955,0,0,10,0,-10
956,1,1,192,1252,1060
957,1,1,838,1219,381
958,0,0,62,0,-62
959,1,1,179,1652,1473
960,1,1,371,1200,829
961,1,0,8,0,-8
962,1,0,92,0,-92
963,0,0,116,0,-116
964,0,0,14,0,-14
965,0,0,180,0,-180
966,1,0,13,0,-13
967,1,0,5,0,-5
968,0,0,112,0,-112
969,1,1,80,1247,1167
970,1,1,38,1250,1212
971,1,1,444,1438,994
972,1,0,10,0,-10
973,1,1,572,1895,1323
974,0,0,49,0,-49
975,1,0,144,0,-144
976,0,0,9,0,-9
977,0,0,3,0,-3
978,1,0,9,0,-9
979,0,0,4,0,-4
980,1,0,17,0,-17
981,1,1,260,1286,1026
982,1,1,341,1328,987
983,0,0,96,0,-96
984,0,0,26,0,-26
985,1,0,68,0,-68
986,1,1,2123,1503,-620
987,0,0,48,0,-48
988,1,1,490,1442,952
989,0,0,18,0,-18
990,1,1,1672,1296,-376
991,1,1,861,2054,1193
992,0,0,95,0,-95
993,0,0,9,0,-9
994,0,0,62,0,-62
995,1,0,1,0,-1
996,0,0,28,0,-28
997,1,0,17,0,-17
998,0,0,153,0,-153
999,0,0,84,0,-84
1000,1,1,673,1266,593
1001,1,1,323,1748,1425
1002,0,0,29,0,-29
1003,0,0,30,0,-30
1004,1,1,1222,1211,-11
1005,1,1,55,1222,1167
1006,1,0,27,0,-27
1007,1,1,36,1453,1417
1008,0,0,38,0,-38
1009,1,1,1005,1276,271
1010,0,0,73,0,-73
1011,1,0,44,0,-44
1012,1,1,1327,2006,679
1013,1,1,316,2301,1985
1014,0,0,103,0,-103
1015,1,1,86,1342,1256
1016,1,1,102,1572,1470
1017,1,1,1901,1545,-356
1018,1,1,152,1362,1210
1019,0,0,32,0,-32
1020,0,0,33,0,-33
1021,1,0,20,0,-20
1022,1,1,418,1232,814
1023,1,1,57,1243,1186
1024,1,1,294,1227,933
1025,1,0,7,0,-7
1026,1,0,7,0,-7
1027,1,0,11,0,-11
1028,1,1,69,2573,2504
1029,1,1,423,2027,1604
1030,0,0,52,0,-52
1031,1,0,31,0,-31
1032,0,0,57,0,-57
1033,0,0,39,0,-39
1034,0,0,33,0,-33
1035,1,0,172,0,-172
1036,0,0,0,0,0
1037,1,0,16,0,-16
1038,1,0,28,0,-28
1039,1,1,374,1346,972
1040,1,1,594,1502,908
1041,1,0,2,0,-2
1042,1,1,3,1446,1443
1043,1,1,10,1861,1851
1044,1,0,32,0,-32
1045,1,1,705,1558,853
1046,0,0,69,0,-69
1047,0,0,45,0,-45
1048,1,0,234,0,-234
1049,0,0,55,0,-55
1050,0,0,40,0,-40
1051,0,0,121,0,-121
1052,0,0,10,0,-10
1053,1,0,174,0,-174
1054,0,0,66,0,-66
1055,1,1,295,1265,970
1056,1,0,1,0,-1
1057,0,0,146,0,-146
1058,0,0,75,0,-75
1059,1,1,433,1280,847
1060,0,0,7,0,-7
1061,0,0,122,0,-122
1062,1,0,37,0,-37
1063,1,0,4,0,-4
1064,1,0,96,0,-96
1065,0,0,4,0,-4
1066,0,0,38,0,-38
1067,1,0,7,0,-7
1068,0,0,71,0,-71
1069,1,0,58,0,-58
1070,1,0,5,0,-5
1071,1,0,83,0,-83
1072,0,0,5,0,-5
1073,1,0,9,0,-9
1074,1,0,68,0,-68
1075,0,0,59,0,-59
1076,1,1,175,1208,1033
1077,0,0,121,0,-121
1078,0,0,7,0,-7
1079,1,0,188,0,-188
1080,0,0,18,0,-18
1081,1,0,114,0,-114
1082,1,1,408,1306,898
1083,1,0,61,0,-61
1084,1,0,38,0,-38
1085,0,0,100,0,-100
1086,1,1,1326,1459,133
1087,1,0,112,0,-112
1088,1,0,5,0,-5
1089,1,1,51,2760,2709
1090,1,1,432,1304,872
1091,1,1,631,1224,593
1092,1,1,695,2380,1685
1093,0,0,9,0,-9
1094,0,0,35,0,-35
1095,0,0,104,0,-104
1096,0,0,158,0,-158
1097,0,0,35,0,-35
1098,1,1,1751,1321,-430
1099,0,0,7,0,-7
1100,1,0,121,0,-121
1101,0,0,52,0,-52
1102,0,0,14,0,-14
1103,1,1,664,1331,667
1104,1,0,26,0,-26
1105,0,0,11,0,-11
1106,1,0,57,0,-57
1107,1,1,1001,1243,242
1108,1,1,10,1277,1267
1109,1,0,4,0,-4
1110,0,0,167,0,-167
1111,1,1,117,1357,1240
1112,1,0,166,0,-166
1113,0,0,12,0,-12
1114,1,1,2137,1403,-734
1115,0,0,93,0,-93
1116,1,0,53,0,-53
1117,1,1,1110,2000,890
1118,1,1,379,1361,982
1119,0,0,16,0,-16
1120,0,0,15,0,-15
1121,0,0,272,0,-272
1122,1,0,1,0,-1
1123,1,0,3,0,-3
1124,1,0,104,0,-104
1125,1,1,1249,1628,379
1126,1,0,68,0,-68
1127,1,0,60,0,-60
1128,0,0,49,0,-49
1129,1,1,167,1464,1297
1130,1,1,975,1581,606
1131,1,1,772,1434,662
1132,1,1,100,1309,1209
1133,0,0,6,0,-6
1134,0,0,114,0,-114
1135,0,0,5,0,-5
1136,0,0,18,0,-18
1137,0,0,80,0,-80
1138,1,0,2,0,-2
1139,1,1,534,1223,689
1140,0,0,43,0,-43
1141,1,0,17,0,-17
1142,1,1,466,1500,1034
1143,1,1,106,1260,1154
1144,0,0,20,0,-20
1145,1,0,102,0,-102
1146,0,0,67,0,-67
1147,1,0,27,0,-27
1148,1,1,1590,2035,445
1149,1,1,542,1223,681
1150,1,0,0,0,0
1151,0,0,26,0,-26
1152,0,0,26,0,-26
1153,1,0,10,0,-10
1154,0,0,10,0,-10
1155,1,1,482,1568,1086
1156,1,1,1245,1239,-6
1157,0,0,7,0,-7
1158,1,0,22,0,-22
1159,0,0,87,0,-87
1160,1,1,115,1638,1523
1161,1,0,26,0,-26
1162,1,1,280,1806,1526
1163,1,0,87,0,-87
1164,1,0,111,0,-111
1165,1,0,59,0,-59
1166,1,1,1435,1237,-198
1167,1,0,9,0,-9
1168,0,0,89,0,-89
1169,1,0,46,0,-46
1170,1,1,359,1291,932
1171,0,0,42,0,-42
1172,0,0,5,0,-5
1173,0,0,72,0,-72
1174,0,0,0,0,0
1175,0,0,8,0,-8
1176,0,0,8,0,-8
1177,1,1,57,1970,1913
1178,0,0,13,0,-13
1179,0,0,15,0,-15
1180,1,1,77,1667,1590
1181,0,0,5,0,-5
1182,1,1,262,1762,1500
1183,0,0,11,0,-11
1184,1,1,182,1215,1033
1185,0,0,91,0,-91
1186,1,0,219,0,-219
1187,0,0,56,0,-56
1188,0,0,104,0,-104
1189,1,1,210,1602,1392
1190,0,0,41,0,-41
1191,1,0,152,0,-152
1192,1,0,126,0,-126
1193,1,1,512,2652,2140
1194,0,0,23,0,-23
1195,1,1,391,1234,843
1196,1,0,28,0,-28
1197,1,1,434,1738,1304
1198,1,1,1227,1855,628
1199,1,1,364,1330,966
1200,1,1,616,2507,1891
1201,0,0,56,0,-56
1202,1,1,117,1237,1120
1203,1,0,16,0,-16
1204,0,0,39,0,-39
1205,0,0,26,0,-26
1206,1,0,43,0,-43
1207,1,0,16,0,-16
1208,1,1,1463,1666,203
1209,0,0,48,0,-48
1210,1,0,85,0,-85
1211,0,0,4,0,-4
1212,1,0,86,0,-86
1213,0,0,4,0,-4
1214,1,0,163,0,-163
1215,0,0,76,0,-76
1216,0,0,200,0,-200
1217,1,0,65,0,-65
1218,0,0,9,0,-9
1219,0,0,59,0,-59
1220,0,0,83,0,-83
1221,1,0,111,0,-111
1222,1,1,468,1221,753
1223,1,0,38,0,-38
1224,0,0,92,0,-92
1225,0,0,30,0,-30
1226,1,1,406,1646,1240
1227,0,0,118,0,-118
1228,1,1,355,1418,1063
1229,0,0,34,0,-34
1230,1,0,78,0,-78
1231,0,0,39,0,-39
1232,0,0,12,0,-12
1233,0,0,107,0,-107
1234,1,0,76,0,-76
1235,0,0,6,0,-6
1236,1,0,9,0,-9
1237,1,1,1150,1364,214
1238,0,0,179,0,-179
1239,1,1,117,1376,1259
1240,1,1,374,1687,1313
1241,0,0,58,0,-58
1242,0,0,134,0,-134
1243,0,0,9,0,-9
1244,1,0,59,0,-59
1245,0,0,42,0,-42
1246,1,1,20,1257,1237
1247,0,0,85,0,-85
1248,0,0,51,0,-51
1249,0,0,27,0,-27
1250,1,1,712,1618,906
1251,0,0,10,0,-10
1252,0,0,16,0,-16
1253,0,0,49,0,-49
1254,0,0,191,0,-191
1255,0,0,79,0,-79
1256,1,0,18,0,-18
1257,0,0,70,0,-70
1258,0,0,54,0,-54
1259,1,1,375,1810,1435
1260,0,0,16,0,-16
1261,1,1,126,1711,1585
1262,1,0,2,0,-2
1263,1,0,10,0,-10
1264,0,0,0,0,0
1265,0,0,44,0,-44
1266,1,1,240,1249,1009
1267,1,0,20,0,-20
1268,1,1,180,1253,1073
1269,0,0,187,0,-187
1270,0,0,10,0,-10
1271,0,0,39,0,-39
1272,1,0,52,0,-52
1273,0,0,125,0,-125
1274,1,1,123,1591,1468
1275,0,0,33,0,-33
1276,1,0,22,0,-22
1277,1,0,44,0,-44
1278,0,0,26,0,-26
1279,0,0,85,0,-85
1280,0,0,138,0,-138
1281,0,0,23,0,-23
1282,1,0,36,0,-36
1283,1,0,6,0,-6
1284,1,0,31,0,-31
1285,1,0,26,0,-26
1286,1,1,189,2057,1868
1287,1,0,13,0,-13
1288,1,0,91,0,-91
1289,0,0,7,0,-7
1290,1,0,49,0,-49
1291,1,0,3,0,-3
1292,0,0,48,0,-48
1293,1,0,1,0,-1
1294,0,0,17,0,-17
1295,1,0,1,0,-1
1296,0,0,66,0,-66
1297,1,0,51,0,-51
1298,0,0,3,0,-3
1299,0,0,84,0,-84
1300,1,0,49,0,-49
1301,0,0,38,0,-38
1302,1,0,99,0,-99
1303,0,0,7,0,-7
1304,1,0,135,0,-135
1305,1,1,413,1378,965
1306,1,1,536,1207,671
1307,0,0,17,0,-17
1308,0,0,58,0,-58
1309,1,0,122,0,-122
1310,1,1,1745,1358,-387
1311,1,0,80,0,-80
1312,1,0,74,0,-74
1313,0,0,71,0,-71
1314,1,1,694,2117,1423
1315,1,0,33,0,-33
1316,0,0,12,0,-12
1317,1,0,72,0,-72
1318,1,0,1,0,-1
1319,1,0,3,0,-3
1320,1,1,143,1205,1062
1321,0,0,7,0,-7
1322,1,1,922,1675,753
1323,0,0,13,0,-13
1324,1,0,2,0,-2
1325,1,1,744,1231,487
1326,0,0,75,0,-75
1327,1,1,937,1342,405
1328,1,0,73,0,-73
1329,0,0,25,0,-25
1330,1,1,2352,1250,-1102
1331,0,0,48,0,-48
1332,0,0,74,0,-74
1333,1,0,144,0,-144
1334,1,0,51,0,-51
1335,0,0,11,0,-11
1336,1,1,281,1541,1260
1337,1,1,951,2330,1379
1338,0,0,125,0,-125
1339,1,0,13,0,-13
1340,0,0,1,0,-1
1341,1,0,2,0,-2
1342,0,0,32,0,-32
1343,0,0,43,0,-43
1344,1,1,500,1353,853
1345,0,0,58,0,-58
1346,1,0,86,0,-86
1347,1,1,357,1314,957
1348,1,1,43,1446,1403
1349,1,1,78,1202,1124
1350,1,0,33,0,-33
1351,0,0,92,0,-92
1352,0,0,142,0,-142
1353,1,0,4,0,-4
1354,1,1,416,1262,846
1355,0,0,66,0,-66
1356,0,0,151,0,-151
1357,1,0,41,0,-41
1358,1,0,46,0,-46
1359,1,0,83,0,-83
1360,1,0,18,0,-18
1361,0,0,18,0,-18
1362,0,0,18,0,-18
1363,1,0,74,0,-74
1364,0,0,26,0,-26
1365,1,1,600,1295,695
1366,1,1,124,1247,1123
1367,1,1,546,1229,683
1368,0,0,67,0,-67
1369,1,1,27,2467,2440
1370,1,0,35,0,-35
1371,0,0,26,0,-26
1372,0,0,35,0,-35
1373,1,0,50,0,-50
1374,1,0,1,0,-1
1375,1,1,636,1415,779
1376,1,1,175,1744,1569
1377,1,0,23,0,-23
1378,0,0,20,0,-20
1379,1,1,420,1520,1100
1380,1,1,675,1263,588
1381,1,0,68,0,-68
1382,0,0,74,0,-74
1383,0,0,65,0,-65
1384,0,0,13,0,-13
1385,1,1,95,1324,1229
1386,1,1,848,1525,677
1387,0,0,30,0,-30
1388,1,0,193,0,-193
1389,1,1,1201,1384,183
1390,0,0,33,0,-33
1391,0,0,42,0,-42
1392,0,0,11,0,-11
1393,1,0,57,0,-57
1394,1,1,312,1545,1233
1395,1,0,1,0,-1
1396,0,0,12,0,-12
1397,1,0,22,0,-22
1398,1,0,11,0,-11
1399,0,0,88,0,-88
1400,0,0,60,0,-60
1401,0,0,131,0,-131
1402,1,1,302,1252,950
1403,1,0,9,0,-9
1404,1,0,29,0,-29
1405,0,0,15,0,-15
1406,1,0,8,0,-8
1407,1,1,475,1447,972
1408,1,1,82,1726,1644
1409,1,0,31,0,-31
1410,1,1,26,1322,1296
1411,0,0,51,0,-51
1412,0,0,19,0,-19
1413,0,0,274,0,-274
1414,1,1,94,1491,1397
1415,0,0,43,0,-43
1416,0,0,37,0,-37
1417,0,0,8,0,-8
1418,1,0,183,0,-183
1419,0,0,23,0,-23
1420,0,0,63,0,-63
1421,1,1,640,1408,768
1422,1,0,66,0,-66
1423,1,1,559,1559,1000
1424,1,1,61,1898,1837
1425,0,0,27,0,-27
1426,0,0,38,0,-38
1427,1,1,825,1415,590
1428,1,0,14,0,-14
1429,1,0,118,0,-118
1430,1,0,0,0,0
1431,0,0,68,0,-68
1432,1,1,518,1275,757
1433,0,0,10,0,-10
1434,1,1,577,2554,1977
1435,1,0,51,0,-51
1436,1,0,45,0,-45
1437,0,0,28,0,-28
1438,1,1,359,1311,952
1439,0,0,10,0,-10
1440,0,0,5,0,-5
1441,0,0,95,0,-95
1442,0,0,7,0,-7
1443,1,1,573,1515,942
1444,1,0,87,0,-87
1445,1,0,70,0,-70
1446,1,1,1076,2338,1262
1447,1,1,437,1983,1546
1448,1,1,606,1267,661
1449,1,1,693,1223,530
1450,1,1,1364,1284,-80
1451,1,1,100,1293,1193
1452,1,0,52,0,-52
1453,1,1,93,1220,1127
1454,0,0,49,0,-49
1455,1,0,0,0,0
1456,1,0,18,0,-18
1457,1,1,202,1207,1005
1458,1,1,210,1417,1207
1459,1,0,89,0,-89
1460,0,0,247,0,-247
1461,1,1,196,1778,1582
1462,1,1,357,1309,952
1463,1,1,342,1552,1210
1464,0,0,146,0,-146
1465,1,1,674,1272,598
1466,0,0,7,0,-7
1467,0,0,17,0,-17
1468,1,1,1775,1369,-406
1469,1,1,240,1481,1241
1470,1,1,293,1265,972
1471,0,0,15,0,-15
1472,1,1,212,4288,4076
1473,1,0,0,0,0
1474,0,0,16,0,-16
1475,1,0,36,0,-36
1476,1,0,35,0,-35
1477,0,0,6,0,-6
1478,0,0,95,0,-95
1479,0,0,160,0,-160
1480,1,1,133,1550,1417
1481,0,0,4,0,-4
1482,1,1,1081,1544,463
1483,0,0,14,0,-14
1484,1,1,111,1270,1159
1485,1,1,1060,2046,986
1486,1,0,11,0,-11
1487,0,0,1,0,-1
1488,0,0,1,0,-1
1489,1,1,484,1382,898
1490,1,0,18,0,-18
1491,1,1,1434,1224,-210
1492,0,0,12,0,-12
1493,1,0,26,0,-26
1494,1,1,99,2127,2028
1495,0,0,11,0,-11
1496,1,1,327,1425,1098
1497,0,0,41,0,-41
1498,0,0,5,0,-5
1499,1,1,289,1209,920
1500,0,0,14,0,-14
1501,1,1,321,1463,1142
1502,1,0,21,0,-21
1503,0,0,71,0,-71
1504,0,0,107,0,-107
1505,0,0,0,0,0
1506,0,0,10,0,-10
1507,0,0,153,0,-153
1508,0,0,17,0,-17
1509,1,1,2261,1910,-351
1510,1,0,4,0,-4
1511,1,0,76,0,-76
1512,0,0,62,0,-62
1513,1,1,356,1420,1064
1514,1,1,165,1258,1093
1515,0,0,8,0,-8
1516,1,0,9,0,-9
1517,0,0,7,0,-7
1518,1,1,58,1987,1929
1519,0,0,100,0,-100
1520,1,0,9,0,-9
1521,0,0,73,0,-73
1522,0,0,87,0,-87
1523,1,0,118,0,-118
1524,0,0,13,0,-13
1525,1,1,592,1346,754
1526,1,1,660,1249,589
1527,1,0,187,0,-187
1528,1,0,28,0,-28
1529,0,0,6,0,-6
1530,1,0,35,0,-35
1531,0,0,12,0,-12
1532,1,1,129,1211,1082
1533,0,0,94,0,-94
1534,0,0,7,0,-7
1535,1,0,284,0,-284
1536,0,0,3,0,-3
1537,1,1,143,2181,2038
1538,0,0,22,0,-22
1539,0,0,68,0,-68
1540,1,1,217,1409,1192
1541,1,1,832,1722,890
1542,0,0,9,0,-9
1543,1,1,825,1218,393
1544,1,0,57,0,-57
1545,1,1,261,1345,1084
1546,1,1,364,1274,910
1547,0,0,76,0,-76
1548,1,1,1145,2791,1646
1549,1,0,6,0,-6
1550,1,0,1,0,-1
1551,0,0,2,0,-2
1552,0,0,183,0,-183
1553,1,1,160,1561,1401
1554,0,0,12,0,-12
1555,0,0,4,0,-4
1556,1,1,1080,1402,322
1557,1,0,37,0,-37
1558,1,0,54,0,-54
1559,1,1,25,1615,1590
1560,1,1,3331,1220,-2111
1561,0,0,20,0,-20
1562,1,1,31,2898,2867
1563,1,0,33,0,-33
1564,0,0,52,0,-52
1565,0,0,20,0,-20
1566,1,1,469,1340,871
1567,0,0,52,0,-52
1568,1,1,571,1457,886
1569,1,0,8,0,-8
1570,0,0,11,0,-11
1571,1,1,182,1522,1340
1572,0,0,84,0,-84
1573,1,1,686,1984,1298
1574,0,0,6,0,-6
1575,0,0,63,0,-63
1576,1,1,93,1212,1119
1577,0,0,7,0,-7
1578,1,0,48,0,-48
1579,1,0,11,0,-11
1580,1,0,48,0,-48
1581,1,1,369,1511,1142
1582,0,0,38,0,-38
1583,1,0,9,0,-9
1584,0,0,149,0,-149
1585,1,0,36,0,-36
1586,0,0,95,0,-95
1587,1,0,249,0,-249
1588,1,0,37,0,-37
1589,1,1,441,1316,875
1590,1,1,193,1416,1223
1591,1,0,103,0,-103
1592,1,1,684,1388,704
1593,1,0,55,0,-55
1594,0,0,90,0,-90
1595,1,0,27,0,-27
1596,1,1,41,1498,1457
1597,1,0,103,0,-103
1598,1,0,79,0,-79
1599,0,0,177,0,-177
1600,0,0,3,0,-3
1601,1,1,578,1797,1219
1602,1,1,96,1533,1437
1603,1,1,421,1238,817
1604,1,0,28,0,-28
1605,1,1,182,1332,1150
1606,0,0,28,0,-28
1607,1,1,472,1707,1235
1608,0,0,2,0,-2
1609,1,1,325,1255,930
1610,0,0,76,0,-76
1611,1,1,742,1540,798
1612,1,0,14,0,-14
1613,1,1,50,2007,1957
1614,1,1,32,1248,1216
1615,1,1,1185,1208,23
1616,1,1,133,1363,1230
1617,1,1,22,1480,1458
1618,1,1,495,1252,757
1619,1,1,465,1614,1149
1620,1,0,6,0,-6
1621,0,0,35,0,-35
1622,1,0,14,0,-14
1623,0,0,21,0,-21
1624,1,1,110,1868,1758
1625,0,0,11,0,-11
1626,0,0,72,0,-72
1627,1,0,16,0,-16
1628,0,0,43,0,-43
1629,0,0,10,0,-10
1630,1,1,278,1681,1403
1631,1,1,131,1949,1818
1632,1,0,191,0,-191
1633,0,0,96,0,-96
1634,0,0,22,0,-22
1635,1,1,386,1653,1267
1636,1,1,733,1308,575
1637,0,0,27,0,-27
1638,1,1,167,1396,1229
1639,1,1,655,1745,1090
1640,0,0,59,0,-59
1641,1,1,958,3705,2747
1642,1,0,33,0,-33
1643,0,0,26,0,-26
1644,0,0,68,0,-68
1645,0,0,24,0,-24
1646,1,1,174,1488,1314
1647,0,0,35,0,-35
1648,1,0,141,0,-141
1649,0,0,23,0,-23
1650,1,1,271,1211,940
1651,1,1,707,1344,637
1652,0,0,102,0,-102
1653,1,1,396,1308,912
1654,0,0,11,0,-11
1655,1,0,12,0,-12
1656,0,0,27,0,-27
1657,1,1,150,1203,1053
1658,1,1,162,2012,1850
1659,1,0,120,0,-120
1660,1,1,911,1283,372
1661,1,0,41,0,-41
1662,1,1,528,1259,731
1663,0,0,21,0,-21
1664,1,0,38,0,-38
1665,1,0,18,0,-18
1666,1,1,348,1465,1117
1667,0,0,31,0,-31
1668,1,1,140,1371,1231
1669,0,0,125,0,-125
1670,1,1,1278,1920,642
1671,1,0,47,0,-47
1672,1,1,978,1515,537
1673,1,1,233,3031,2798
1674,1,1,920,1443,523
1675,1,1,836,1371,535
1676,0,0,15,0,-15
1677,0,0,30,0,-30
1678,1,0,19,0,-19
1679,0,0,9,0,-9
1680,0,0,180,0,-180
1681,0,0,52,0,-52
1682,0,0,69,0,-69
1683,1,0,2,0,-2
1684,1,0,14,0,-14
1685,1,0,169,0,-169
1686,0,0,43,0,-43
1687,0,0,26,0,-26
1688,1,0,17,0,-17
1689,1,1,123,1231,1108
1690,1,0,19,0,-19
1691,1,0,140,0,-140
1692,1,1,313,1397,1084
1693,0,0,18,0,-18
1694,1,1,162,1234,1072
1695,0,0,4,0,-4
1696,1,0,76,0,-76
1697,0,0,54,0,-54
1698,1,1,587,1404,817
1699,0,0,1,0,-1
1700,1,1,820,1309,489
1701,1,0,52,0,-52
1702,0,0,10,0,-10
1703,0,0,84,0,-84
1704,1,0,1,0,-1
1705,1,0,83,0,-83
1706,1,0,8,0,-8
1707,1,1,806,1253,447
1708,0,0,23,0,-23
1709,1,0,7,0,-7
1710,1,0,12,0,-12
1711,1,1,895,1615,720
1712,0,0,70,0,-70
1713,0,0,63,0,-63
1714,0,0,184,0,-184
1715,1,0,30,0,-30
1716,0,0,6,0,-6
1717,1,1,598,2285,1687
1718,0,0,89,0,-89
1719,1,0,38,0,-38
1720,0,0,37,0,-37
1721,0,0,13,0,-13
1722,1,1,1668,1363,-305
1723,0,0,41,0,-41
1724,0,0,10,0,-10
1725,0,0,9,0,-9
1726,0,0,10,0,-10
1727,1,0,43,0,-43
1728,0,0,2,0,-2
1729,1,0,6,0,-6
1730,1,1,550,1379,829
1731,1,0,14,0,-14
1732,1,0,118,0,-118
1733,1,1,53,1463,1410
1734,0,0,56,0,-56
1735,1,1,669,2675,2006
1736,1,0,11,0,-11
1737,1,0,74,0,-74
1738,1,1,191,1545,1354
1739,1,0,122,0,-122
1740,1,0,7,0,-7
1741,0,0,11,0,-11
1742,0,0,118,0,-118
1743,1,1,192,1653,1461
1744,1,0,1,0,-1
1745,1,1,624,1585,961
1746,0,0,39,0,-39
1747,1,0,127,0,-127
1748,1,1,103,1380,1277
1749,0,0,75,0,-75
1750,0,0,11,0,-11
1751,1,0,24,0,-24
1752,1,1,313,1304,991
1753,1,1,1045,1373,328
1754,1,0,11,0,-11
1755,0,0,39,0,-39
1756,1,1,642,1223,581
1757,0,0,0,0,0
1758,0,0,18,0,-18
1759,1,0,55,0,-55
1760,1,0,40,0,-40
1761,0,0,8,0,-8
1762,1,1,561,1679,1118
1763,0,0,66,0,-66
1764,1,1,102,1567,1465
1765,1,1,269,2590,2321
1766,0,0,20,0,-20
1767,1,0,14,0,-14
1768,0,0,20,0,-20
1769,1,1,175,1284,1109
1770,1,0,148,0,-148
1771,1,1,69,1464,1395
1772,1,0,27,0,-27
1773,1,1,1399,1604,205
1774,1,1,666,1235,569
1775,0,0,49,0,-49
1776,1,0,19,0,-19
1777,1,1,899,1773,874
1778,1,0,2,0,-2
1779,1,0,18,0,-18
1780,1,1,219,1352,1133
1781,0,0,72,0,-72
1782,0,0,27,0,-27
1783,1,1,67,2292,2225
1784,1,0,3,0,-3
1785,0,0,10,0,-10
1786,0,0,125,0,-125
1787,0,0,6,0,-6
1788,1,1,366,1274,908
1789,0,0,17,0,-17
1790,1,0,66,0,-66
1791,0,0,27,0,-27
1792,0,0,12,0,-12
1793,1,1,105,1896,1791
1794,1,1,1029,1247,218
1795,1,1,589,1565,976
1796,1,1,619,1336,717
1797,1,0,31,0,-31
1798,1,0,2,0,-2
1799,0,0,117,0,-117
1800,1,0,48,0,-48
1801,1,0,197,0,-197
1802,1,0,147,0,-147
1803,1,1,2128,1956,-172
1804,1,0,60,0,-60
1805,1,1,508,1725,1217
1806,0,0,116,0,-116
1807,0,0,145,0,-145
1808,1,1,516,1458,942
1809,1,0,64,0,-64
1810,1,1,511,1848,1337
1811,0,0,10,0,-10
1812,0,0,125,0,-125
1813,0,0,71,0,-71
1814,1,0,215,0,-215
1815,0,0,63,0,-63
1816,0,0,40,0,-40
1817,0,0,81,0,-81
1818,1,0,158,0,-158
1819,0,0,7,0,-7
1820,0,0,88,0,-88
1821,0,0,40,0,-40
1822,0,0,67,0,-67
1823,0,0,20,0,-20
1824,1,0,70,0,-70
1825,1,0,121,0,-121
1826,1,0,17,0,-17
1827,1,1,397,1217,820
1828,1,0,23,0,-23
1829,0,0,27,0,-27
1830,0,0,84,0,-84
1831,0,0,0,0,0
1832,0,0,47,0,-47
1833,1,0,65,0,-65
1834,0,0,40,0,-40
1835,1,0,34,0,-34
1836,1,0,26,0,-26
1837,0,0,7,0,-7
1838,0,0,55,0,-55
1839,1,1,35,1603,1568
1840,0,0,42,0,-42
1841,0,0,66,0,-66
1842,1,1,330,1527,1197
1843,1,1,142,1225,1083
1844,0,0,60,0,-60
1845,0,0,1,0,-1
1846,1,1,525,1505,980
1847,0,0,15,0,-15
1848,0,0,91,0,-91
1849,0,0,12,0,-12
1850,1,1,621,1372,751
1851,1,1,1052,1770,718
1852,1,1,39,1319,1280
1853,1,0,114,0,-114
1854,1,0,28,0,-28
1855,1,1,1690,1720,30
1856,1,1,2297,1254,-1043
1857,0,0,65,0,-65
1858,0,0,160,0,-160
1859,1,1,340,1908,1568
1860,1,0,15,0,-15
1861,1,0,14,0,-14
1862,0,0,11,0,-11
1863,0,0,4,0,-4
1864,1,0,12,0,-12
1865,1,1,1034,2048,1014
1866,1,0,6,0,-6
1867,0,0,1,0,-1
1868,0,0,14,0,-14
1869,0,0,258,0,-258
1870,0,0,5,0,-5
1871,1,0,51,0,-51
1872,1,1,94,1223,1129
1873,0,0,139,0,-139
1874,0,0,73,0,-73
1875,0,0,34,0,-34
1876,0,0,30,0,-30
1877,1,0,45,0,-45
1878,1,1,1539,1314,-225
1879,0,0,41,0,-41
1880,1,0,193,0,-193
1881,0,0,17,0,-17
1882,1,1,286,1253,967
1883,1,1,850,4447,3597
1884,1,0,32,0,-32
1885,1,0,53,0,-53
1886,1,1,47,1868,1821
1887,1,0,39,0,-39
1888,0,0,100,0,-100
1889,0,0,49,0,-49
1890,1,1,483,1433,950
1891,1,1,445,1592,1147
1892,1,0,60,0,-60
1893,1,0,15,0,-15
1894,0,0,29,0,-29
1895,0,0,154,0,-154
1896,0,0,3,0,-3
1897,1,1,656,1353,697
1898,1,0,44,0,-44
1899,0,0,6,0,-6
1900,1,1,112,1284,1172
1901,1,1,986,1523,537
1902,0,0,70,0,-70
1903,0,0,55,0,-55
1904,1,1,209,2404,2195
1905,0,0,80,0,-80
1906,0,0,120,0,-120
1907,1,1,618,1444,826
1908,0,0,227,0,-227
1909,1,0,43,0,-43
1910,1,0,57,0,-57
1911,1,0,53,0,-53
1912,1,1,893,1376,483
1913,1,1,96,1774,1678
1914,1,0,52,0,-52
1915,0,0,98,0,-98
1916,0,0,22,0,-22
1917,1,0,76,0,-76
1918,0,0,40,0,-40
1919,0,0,54,0,-54
1920,1,0,86,0,-86
1921,0,0,75,0,-75
1922,1,1,1204,1898,694
1923,1,1,289,1492,1203
1924,0,0,82,0,-82
1925,0,0,4,0,-4
1926,1,1,197,1297,1100
1927,1,1,675,2612,1937
1928,1,0,98,0,-98
1929,1,1,214,1317,1103
1930,0,0,77,0,-77
1931,1,0,20,0,-20
1932,1,1,628,2446,1818
1933,0,0,74,0,-74
1934,0,0,19,0,-19
1935,1,0,25,0,-25
1936,1,1,362,1291,929
1937,0,0,73,0,-73
1938,1,1,519,1732,1213
1939,0,0,51,0,-51
1940,1,0,11,0,-11
1941,1,1,219,1620,1401
1942,1,1,600,1338,738
1943,1,0,67,0,-67
1944,1,1,527,1247,720
1945,1,0,152,0,-152
1946,1,0,1,0,-1
1947,1,0,17,0,-17
1948,0,0,0,0,0
1949,0,0,0,0,0
1950,0,0,39,0,-39
1951,1,0,58,0,-58
1952,1,0,56,0,-56
1953,1,1,233,1211,978
1954,0,0,7,0,-7
1955,0,0,14,0,-14
1956,1,1,152,1411,1259
1957,1,1,362,1322,960
1958,1,0,274,0,-274
1959,0,0,179,0,-179
1960,0,0,40,0,-40
1961,1,0,10,0,-10
1962,0,0,65,0,-65
1963,0,0,6,0,-6
1964,1,0,1,0,-1
1965,1,0,21,0,-21
1966,0,0,24,0,-24
1967,0,0,27,0,-27
1968,1,0,55,0,-55
1969,1,1,180,2689,2509
1970,1,1,1667,1580,-87
1971,0,0,9,0,-9
1972,0,0,7,0,-7
1973,0,0,71,0,-71
1974,1,0,10,0,-10
1975,0,0,263,0,-263
1976,1,0,11,0,-11
1977,0,0,115,0,-115
1978,1,0,15,0,-15
1979,0,0,94,0,-94
1980,0,0,13,0,-13
1981,1,1,102,1228,1126
1982,1,0,118,0,-118
1983,0,0,32,0,-32
1984,1,0,47,0,-47
1985,1,0,39,0,-39
1986,1,1,1000,1443,443
1987,1,1,395,1621,1226
1988,0,0,18,0,-18
1989,0,0,40,0,-40
1990,1,1,290,2035,1745
1991,0,0,53,0,-53
1992,0,0,166,0,-166
1993,0,0,12,0,-12
1994,1,1,1056,1665,609
1995,1,1,1008,1234,226
1996,0,0,21,0,-21
1997,0,0,43,0,-43
1998,0,0,44,0,-44
1999,0,0,161,0,-161
2000,0,0,28,0,-28
2001,1,0,0,0,0
2002,0,0,44,0,-44
2003,0,0,32,0,-32
2004,0,0,49,0,-49
2005,0,0,1,0,-1
2006,0,0,91,0,-91
2007,0,0,37,0,-37
2008,0,0,30,0,-30
2009,1,0,16,0,-16
2010,1,1,402,1935,1533
2011,1,0,72,0,-72
2012,0,0,39,0,-39
2013,0,0,43,0,-43
2014,0,0,49,0,-49
2015,1,1,555,1743,1188
2016,1,0,44,0,-44
2017,1,0,3,0,-3
2018,1,0,84,0,-84
2019,0,0,35,0,-35
2020,0,0,3,0,-3
2021,0,0,69,0,-69
2022,0,0,25,0,-25
2023,0,0,243,0,-243
2024,1,0,1,0,-1
2025,1,1,170,1726,1556
2026,1,0,302,0,-302
2027,0,0,25,0,-25
2028,1,1,1049,1215,166
2029,1,0,23,0,-23
2030,0,0,2,0,-2
2031,1,0,14,0,-14
2032,1,0,0,0,0
2033,1,1,180,1255,1075
2034,1,0,25,0,-25
2035,1,0,9,0,-9
2036,1,1,478,1536,1058
2037,1,1,486,1410,924
2038,0,0,167,0,-167
2039,0,0,1,0,-1
2040,1,0,77,0,-77
2041,0,0,46,0,-46
2042,1,0,224,0,-224
2043,1,0,45,0,-45
2044,0,0,67,0,-67
2045,1,0,38,0,-38
2046,0,0,1,0,-1
2047,1,0,1,0,-1
2048,1,1,378,1250,872
2049,0,0,11,0,-11
2050,1,0,9,0,-9
2051,1,0,30,0,-30
2052,1,1,2241,1349,-892
2053,1,1,1332,1692,360
2054,0,0,40,0,-40
2055,1,1,1317,1407,90
2056,1,0,28,0,-28
2057,1,0,1,0,-1
2058,0,0,56,0,-56
2059,0,0,69,0,-69
2060,0,0,10,0,-10
2061,0,0,208,0,-208
2062,1,1,754,1332,578
2063,1,0,239,0,-239
2064,1,0,3,0,-3
2065,0,0,37,0,-37
2066,0,0,65,0,-65
2067,1,0,137,0,-137
2068,1,0,72,0,-72
2069,1,0,32,0,-32
2070,0,0,103,0,-103
2071,1,1,201,1296,1095
2072,1,1,2310,1353,-957
2073,0,0,101,0,-101
2074,0,0,79,0,-79
2075,0,0,92,0,-92
2076,1,1,2012,1826,-186
2077,0,0,146,0,-146
2078,1,1,144,1346,1202
2079,0,0,13,0,-13
2080,0,0,9,0,-9
2081,1,0,26,0,-26
2082,1,1,654,1203,549
2083,1,0,1,0,-1
2084,1,1,153,1566,1413
2085,1,0,12,0,-12
2086,1,1,588,1802,1214
2087,1,0,32,0,-32
2088,1,1,244,1335,1091
2089,0,0,9,0,-9
2090,1,0,30,0,-30
2091,0,0,118,0,-118
2092,0,0,20,0,-20
2093,1,0,16,0,-16
2094,0,0,6,0,-6
2095,1,0,9,0,-9
2096,1,0,23,0,-23
2097,0,0,96,0,-96
2098,1,0,2,0,-2
2099,1,1,246,1407,1161
2100,0,0,24,0,-24
2101,0,0,3,0,-3
2102,1,0,11,0,-11
2103,1,0,9,0,-9
2104,0,0,177,0,-177
2105,0,0,3,0,-3
2106,1,1,619,1591,972
2107,0,0,34,0,-34
2108,0,0,112,0,-112
2109,0,0,33,0,-33
2110,1,0,106,0,-106
2111,1,0,19,0,-19
2112,1,0,4,0,-4
2113,0,0,119,0,-119
2114,1,0,86,0,-86
2115,1,0,5,0,-5
2116,0,0,9,0,-9
2117,0,0,51,0,-51
2118,1,0,86,0,-86
2119,1,1,52,1363,1311
2120,1,0,52,0,-52
2121,1,1,694,1290,596
2122,1,0,72,0,-72
2123,0,0,252,0,-252
2124,1,0,56,0,-56
2125,0,0,6,0,-6
2126,0,0,3,0,-3
2127,1,1,51,1794,1743
2128,0,0,188,0,-188
2129,1,0,21,0,-21
2130,0,0,20,0,-20
2131,0,0,1,0,-1
2132,1,1,247,1705,1458
2133,1,1,239,1339,1100
2134,0,0,108,0,-108
2135,1,1,944,1222,278
2136,1,0,23,0,-23
2137,1,0,196,0,-196
2138,1,1,1155,1267,112
2139,1,1,284,1230,946
2140,0,0,13,0,-13
2141,1,0,10,0,-10
2142,1,0,8,0,-8
2143,1,0,36,0,-36
2144,0,0,16,0,-16
2145,0,0,67,0,-67
2146,1,0,8,0,-8
2147,1,0,147,0,-147
2148,0,0,31,0,-31
2149,1,1,445,1308,863
2150,1,1,178,1264,1086
2151,1,0,2,0,-2
2152,1,1,611,2454,1843
2153,1,0,27,0,-27
2154,0,0,8,0,-8
2155,0,0,6,0,-6
2156,0,0,49,0,-49
2157,1,0,5,0,-5
2158,1,0,43,0,-43
2159,0,0,52,0,-52
2160,0,0,57,0,-57
2161,1,0,86,0,-86
2162,1,1,821,1650,829
2163,0,0,26,0,-26
2164,0,0,58,0,-58
2165,0,0,100,0,-100
2166,1,0,12,0,-12
2167,0,0,20,0,-20
2168,1,0,15,0,-15
2169,0,0,16,0,-16
2170,0,0,0,0,0
2171,0,0,54,0,-54
2172,1,1,1156,1240,84
2173,1,0,112,0,-112
2174,0,0,57,0,-57
2175,1,1,1381,1803,422
2176,0,0,11,0,-11
2177,1,0,20,0,-20
2178,0,0,39,0,-39
2179,1,1,260,1265,1005
2180,1,0,50,0,-50
2181,1,0,34,0,-34
2182,1,1,3021,1390,-1631
2183,1,0,30,0,-30
2184,1,0,76,0,-76
2185,1,1,320,1523,1203
2186,1,1,427,2264,1837
2187,0,0,57,0,-57
2188,0,0,112,0,-112
2189,1,1,2199,2395,196
2190,0,0,46,0,-46
2191,1,1,698,1892,1194
2192,1,0,85,0,-85
2193,1,0,248,0,-248
2194,0,0,126,0,-126
2195,1,1,475,2181,1706
2196,1,1,298,1331,1033
2197,0,0,22,0,-22
2198,1,0,144,0,-144
2199,0,0,30,0,-30
2200,1,1,915,2153,1238
2201,1,1,1434,2119,685
2202,0,0,13,0,-13
2203,1,1,131,1217,1086
2204,0,0,13,0,-13
2205,1,0,64,0,-64
2206,0,0,24,0,-24
2207,1,0,33,0,-33
2208,0,0,27,0,-27
2209,0,0,50,0,-50
2210,1,0,10,0,-10
2211,1,0,3,0,-3
2212,1,1,1985,1237,-748
2213,1,1,687,1247,560
2214,1,1,729,1299,570
2215,0,0,65,0,-65
2216,1,1,206,1991,1785
2217,0,0,137,0,-137
2218,0,0,14,0,-14
2219,1,0,13,0,-13
2220,1,1,245,1742,1497
2221,1,0,8,0,-8
2222,0,0,26,0,-26
2223,1,1,861,1327,466
2224,1,0,6,0,-6
2225,0,0,17,0,-17
2226,0,0,7,0,-7
2227,0,0,204,0,-204
2228,1,1,294,1443,1149
2229,0,0,100,0,-100
2230,0,0,69,0,-69
2231,1,0,38,0,-38
2232,0,0,13,0,-13
2233,1,1,476,1259,783
2234,0,0,0,0,0
2235,0,0,111,0,-111
2236,1,0,15,0,-15
2237,0,0,44,0,-44
2238,0,0,6,0,-6
2239,1,1,969,1404,435
2240,1,0,334,0,-334
2241,1,0,21,0,-21
2242,1,1,200,1735,1535
2243,1,0,94,0,-94
2244,1,1,74,1261,1187
2245,1,0,9,0,-9
2246,0,0,8,0,-8
2247,1,0,16,0,-16
2248,0,0,1,0,-1
2249,1,0,102,0,-102
2250,0,0,135,0,-135
2251,1,0,59,0,-59
2252,1,0,4,0,-4
2253,0,0,148,0,-148
2254,0,0,1,0,-1
2255,1,1,442,2121,1679
2256,0,0,16,0,-16
2257,1,1,305,1252,947
2258,0,0,11,0,-11
2259,1,1,133,1781,1648
2260,1,1,53,1404,1351
2261,0,0,118,0,-118
2262,1,0,25,0,-25
2263,1,0,36,0,-36
2264,1,1,484,2236,1752
2265,1,1,2281,1336,-945
2266,0,0,86,0,-86
2267,0,0,42,0,-42
2268,0,0,148,0,-148
2269,0,0,19,0,-19
2270,1,1,512,1700,1188
2271,1,0,102,0,-102
2272,1,0,22,0,-22
2273,0,0,52,0,-52
2274,1,0,61,0,-61
2275,1,0,22,0,-22
2276,1,1,96,1212,1116
2277,0,0,80,0,-80
2278,1,1,69,1253,1184
2279,1,0,43,0,-43
2280,1,0,11,0,-11
2281,0,0,194,0,-194
2282,1,0,27,0,-27
2283,0,0,11,0,-11
2284,1,1,242,1341,1099
2285,0,0,9,0,-9
2286,0,0,261,0,-261
2287,1,0,12,0,-12
2288,1,0,102,0,-102
2289,1,1,28,1352,1324
2290,1,1,302,1965,1663
2291,1,1,908,1229,321
2292,1,1,558,1264,706
2293,1,0,7,0,-7
2294,1,1,388,2304,1916
2295,0,0,44,0,-44
2296,1,0,78,0,-78
2297,1,1,268,2393,2125
2298,1,0,6,0,-6
2299,1,1,700,1613,913
2300,1,1,901,1432,531
2301,0,0,26,0,-26
2302,1,0,14,0,-14
2303,0,0,4,0,-4
2304,0,0,9,0,-9
2305,1,0,48,0,-48
2306,0,0,54,0,-54
2307,1,1,529,1508,979
2308,0,0,66,0,-66
2309,1,1,412,1887,1475
2310,1,1,450,1397,947
2311,0,0,42,0,-42
2312,1,1,163,1296,1133
2313,1,0,22,0,-22
2314,1,1,45,1674,1629
2315,0,0,10,0,-10
2316,1,1,56,1424,1368
2317,0,0,13,0,-13
2318,1,0,33,0,-33
2319,0,0,56,0,-56
2320,1,1,645,1651,1006
2321,0,0,13,0,-13
2322,0,0,38,0,-38
2323,1,0,56,0,-56
2324,1,1,137,1728,1591
2325,1,0,44,0,-44
2326,1,0,46,0,-46
2327,0,0,114,0,-114
2328,0,0,105,0,-105
2329,0,0,2,0,-2
2330,0,0,73,0,-73
2331,1,1,724,1209,485
2332,1,1,47,1350,1303
2333,1,0,40,0,-40
2334,0,0,6,0,-6
2335,0,0,40,0,-40
2336,1,1,211,1205,994
2337,1,1,101,1280,1179
2338,1,1,175,1204,1029
2339,0,0,48,0,-48
2340,0,0,34,0,-34
2341,1,0,94,0,-94
2342,0,0,56,0,-56
2343,1,1,356,1688,1332
2344,1,0,105,0,-105
2345,0,0,1,0,-1
2346,0,0,146,0,-146
2347,0,0,1,0,-1
2348,1,1,1212,1418,206
2349,1,1,423,1294,871
2350,1,1,479,1319,840
2351,0,0,46,0,-46
2352,0,0,79,0,-79
2353,0,0,34,0,-34
2354,0,0,266,0,-266
2355,0,0,5,0,-5
2356,1,0,65,0,-65
2357,1,1,155,1491,1336
2358,0,0,41,0,-41
2359,0,0,29,0,-29
2360,1,1,832,1223,391
2361,1,0,80,0,-80
2362,0,0,25,0,-25
2363,1,1,501,1296,795
2364,0,0,10,0,-10
2365,1,1,662,1636,974
2366,1,1,363,1553,1190
2367,1,1,298,1289,991
2368,1,1,323,1267,944
2369,0,0,8,0,-8
2370,0,0,47,0,-47
2371,0,0,111,0,-111
2372,0,0,38,0,-38
2373,1,1,351,1303,952
2374,0,0,159,0,-159
2375,1,0,63,0,-63
2376,1,0,48,0,-48
2377,1,1,263,1327,1064
2378,1,0,64,0,-64
2379,1,0,47,0,-47
2380,1,0,42,0,-42
2381,0,0,31,0,-31
2382,1,1,974,1209,235
2383,1,0,85,0,-85
2384,0,0,64,0,-64
2385,1,1,167,1476,1309
2386,0,0,17,0,-17
2387,1,1,1854,1253,-601
2388,1,1,382,1530,1148
2389,0,0,33,0,-33
2390,0,0,118,0,-118
2391,0,0,35,0,-35
2392,1,1,351,1254,903
2393,0,0,16,0,-16
2394,1,1,831,1666,835
2395,1,1,450,1421,971
2396,0,0,14,0,-14
2397,1,0,8,0,-8
2398,1,1,715,1204,489
2399,1,0,19,0,-19
2400,0,0,13,0,-13
2401,0,0,94,0,-94
2402,1,0,7,0,-7
2403,0,0,54,0,-54
2404,0,0,39,0,-39
2405,0,0,109,0,-109
2406,1,0,74,0,-74
2407,0,0,175,0,-175
2408,1,1,393,1203,810
2409,1,1,280,1200,920
2410,0,0,50,0,-50
2411,0,0,1,0,-1
2412,1,0,0,0,0
2413,1,1,315,1548,1233
2414,1,0,11,0,-11
2415,0,0,4,0,-4
2416,1,1,227,1459,1232
2417,1,1,297,1545,1248
2418,1,0,37,0,-37
2419,1,0,38,0,-38
2420,0,0,8,0,-8
2421,1,1,111,1978,1867
2422,0,0,13,0,-13
2423,0,0,1,0,-1
2424,1,0,183,0,-183
2425,1,1,72,1283,1211
2426,1,1,135,1334,1199
2427,1,1,292,1552,1260
2428,1,0,34,0,-34
2429,0,0,16,0,-16
2430,0,0,14,0,-14
2431,0,0,223,0,-223
2432,1,1,2492,1414,-1078
2433,0,0,82,0,-82
2434,0,0,80,0,-80
2435,1,1,142,1209,1067
2436,1,1,107,1323,1216
2437,1,0,94,0,-94
2438,1,1,469,1546,1077
2439,1,1,522,2749,2227
2440,0,0,245,0,-245
2441,1,1,393,1321,928
2442,1,0,69,0,-69
2443,1,0,34,0,-34
2444,1,1,116,1257,1141
2445,1,0,171,0,-171
2446,0,0,172,0,-172
2447,0,0,35,0,-35
2448,1,0,196,0,-196
2449,1,1,261,1423,1162
2450,1,0,0,0,0
2451,1,1,102,1269,1167
2452,1,0,24,0,-24
2453,1,1,226,2390,2164
2454,1,0,44,0,-44
2455,1,0,19,0,-19
2456,0,0,33,0,-33
2457,1,0,92,0,-92
2458,0,0,33,0,-33
2459,0,0,64,0,-64
2460,1,1,797,1256,459
2461,1,0,64,0,-64
2462,0,0,64,0,-64
2463,1,1,669,1287,618
2464,0,0,14,0,-14
2465,1,1,307,1379,1072
2466,1,0,13,0,-13
2467,0,0,48,0,-48
2468,1,1,205,1214,1009
2469,1,0,9,0,-9
2470,1,0,9,0,-9
2471,0,0,16,0,-16
2472,0,0,2,0,-2
2473,0,0,55,0,-55
2474,0,0,84,0,-84
2475,0,0,8,0,-8
2476,1,1,52,1408,1356
2477,0,0,32,0,-32
2478,1,0,5,0,-5
2479,1,1,563,1217,654
2480,0,0,4,0,-4
2481,0,0,0,0,0
2482,0,0,105,0,-105
2483,0,0,25,0,-25
2484,0,0,62,0,-62
2485,0,0,20,0,-20
2486,1,0,38,0,-38
2487,0,0,12,0,-12
2488,1,1,647,1340,693
2489,1,0,27,0,-27
2490,1,0,0,0,0
2491,1,0,93,0,-93
2492,0,0,19,0,-19
2493,1,0,6,0,-6
2494,1,1,202,1273,1071
2495,1,1,115,1691,1576
2496,1,1,1633,1350,-283
2497,1,1,1415,1834,419
2498,1,0,27,0,-27
2499,0,0,113,0,-113
2500,1,0,290,0,-290
2501,1,0,38,0,-38
2502,0,0,0,0,0
2503,0,0,38,0,-38
2504,1,0,81,0,-81
2505,0,0,12,0,-12
2506,1,0,43,0,-43
2507,1,1,297,1238,941
2508,1,0,11,0,-11
2509,0,0,0,0,0
2510,1,0,36,0,-36
2511,1,0,73,0,-73
2512,0,0,0,0,0
2513,0,0,0,0,0
2514,1,0,10,0,-10
2515,0,0,77,0,-77
2516,0,0,54,0,-54
2517,1,1,231,1610,1379
2518,1,0,72,0,-72
2519,0,0,42,0,-42
2520,0,0,17,0,-17
2521,0,0,141,0,-141
2522,0,0,59,0,-59
2523,0,0,121,0,-121
2524,1,0,2,0,-2
2525,1,0,21,0,-21
2526,1,0,105,0,-105
2527,1,1,439,1463,1024
2528,1,1,795,1479,684
2529,0,0,0,0,0
2530,1,0,3,0,-3
2531,1,0,27,0,-27
2532,0,0,258,0,-258
2533,0,0,6,0,-6
2534,1,0,17,0,-17
2535,0,0,164,0,-164
2536,1,1,134,1271,1137
2537,0,0,16,0,-16
2538,1,0,110,0,-110
2539,1,1,157,1393,1236
2540,1,1,1629,1253,-376
2541,1,1,54,1246,1192
2542,1,0,79,0,-79
2543,0,0,29,0,-29
2544,1,0,89,0,-89
2545,1,1,157,1609,1452
2546,0,0,35,0,-35
2547,0,0,69,0,-69
2548,0,0,9,0,-9
2549,0,0,99,0,-99
2550,1,0,19,0,-19
2551,1,0,0,0,0
2552,1,0,86,0,-86
2553,1,0,47,0,-47
2554,1,0,2,0,-2
2555,0,0,26,0,-26
2556,1,0,0,0,0
2557,0,0,86,0,-86
2558,0,0,50,0,-50
2559,1,0,50,0,-50
2560,1,1,1275,1844,569
2561,1,0,27,0,-27
2562,1,0,10,0,-10
2563,1,0,27,0,-27
2564,1,1,848,1585,737
2565,1,0,81,0,-81
2566,1,0,95,0,-95
2567,1,1,86,1200,1114
2568,0,0,53,0,-53
2569,1,0,75,0,-75
2570,1,1,138,1376,1238
2571,1,1,504,1228,724
2572,0,0,42,0,-42
2573,1,0,24,0,-24
2574,1,0,111,0,-111
2575,1,1,126,1290,1164
2576,0,0,86,0,-86
2577,1,0,0,0,0
2578,1,1,422,2108,1686
2579,1,0,99,0,-99
2580,1,1,59,1394,1335
2581,1,0,28,0,-28
2582,1,1,451,1328,877
2583,0,0,18,0,-18
2584,0,0,25,0,-25
2585,1,0,10,0,-10
2586,1,1,14,1423,1409
2587,0,0,49,0,-49
2588,0,0,64,0,-64
2589,1,1,319,2579,2260
2590,1,1,1589,1903,314
2591,0,0,48,0,-48
2592,0,0,35,0,-35
2593,1,0,59,0,-59
2594,1,0,9,0,-9
2595,1,0,19,0,-19
2596,0,0,58,0,-58
2597,0,0,257,0,-257
2598,0,0,79,0,-79
2599,1,1,30,1408,1378
2600,1,0,3,0,-3
2601,0,0,13,0,-13
2602,0,0,131,0,-131
2603,1,1,1586,1206,-380
2604,0,0,95,0,-95
2605,1,0,12,0,-12
2606,0,0,105,0,-105
2607,1,1,1805,1243,-562
2608,0,0,0,0,0
2609,1,1,1018,1298,280
2610,1,0,49,0,-49
2611,0,0,4,0,-4
2612,0,0,90,0,-90
2613,1,1,203,1586,1383
2614,1,1,504,1511,1007
2615,1,0,61,0,-61
2616,1,1,383,1227,844
2617,1,1,477,1436,959
2618,0,0,35,0,-35
2619,1,0,1,0,-1
2620,1,0,21,0,-21
2621,1,0,50,0,-50
2622,0,0,38,0,-38
2623,1,1,242,1248,1006
2624,0,0,31,0,-31
2625,0,0,8,0,-8
2626,1,0,37,0,-37
2627,1,0,46,0,-46
2628,1,0,3,0,-3
2629,0,0,56,0,-56
2630,1,0,43,0,-43
2631,0,0,31,0,-31
2632,0,0,12,0,-12
2633,1,0,86,0,-86
2634,0,0,3,0,-3
2635,1,0,57,0,-57
2636,1,0,28,0,-28
2637,1,1,309,1709,1400
2638,1,0,27,0,-27
2639,1,0,63,0,-63
2640,0,0,28,0,-28
2641,0,0,25,0,-25
2642,1,0,31,0,-31
2643,1,0,9,0,-9
2644,0,0,9,0,-9
2645,0,0,47,0,-47
2646,1,1,644,1234,590
2647,0,0,12,0,-12
2648,1,0,61,0,-61
2649,0,0,12,0,-12
2650,1,0,12,0,-12
2651,0,0,137,0,-137
2652,1,1,118,1496,1378
2653,0,0,86,0,-86
2654,1,1,213,1279,1066
2655,1,1,1453,1527,74
2656,0,0,6,0,-6
2657,1,0,66,0,-66
2658,1,1,172,2950,2778
2659,1,1,520,1822,1302
2660,1,1,380,1529,1149
2661,1,0,25,0,-25
2662,1,1,783,1222,439
2663,0,0,22,0,-22
2664,0,0,14,0,-14
2665,1,0,19,0,-19
2666,1,1,211,1611,1400
2667,1,1,360,1221,861
2668,0,0,6,0,-6
2669,0,0,13,0,-13
2670,0,0,0,0,0
2671,1,0,116,0,-116
2672,0,0,138,0,-138
2673,0,0,93,0,-93
2674,1,1,213,1279,1066
2675,0,0,52,0,-52
2676,1,1,598,1221,623
2677,1,1,422,1365,943
2678,1,1,640,1416,776
2679,0,0,57,0,-57
2680,0,0,3,0,-3
2681,1,0,78,0,-78
2682,1,0,79,0,-79
2683,1,1,640,1208,568
2684,1,0,3,0,-3
2685,1,1,642,1309,667
2686,0,0,29,0,-29
2687,0,0,75,0,-75
2688,1,0,19,0,-19
2689,1,1,479,1910,1431
2690,1,1,333,1279,946
2691,1,0,114,0,-114
2692,0,0,12,0,-12
2693,1,0,9,0,-9
2694,1,0,10,0,-10
2695,0,0,87,0,-87
2696,1,0,15,0,-15
2697,1,0,20,0,-20
2698,1,0,55,0,-55
2699,0,0,7,0,-7
2700,1,1,264,1246,982
2701,1,0,114,0,-114
2702,1,0,97,0,-97
2703,0,0,29,0,-29
2704,1,1,79,1305,1226
2705,0,0,47,0,-47
2706,1,1,434,1615,1181
2707,1,1,780,1554,774
2708,1,1,201,1237,1036
2709,1,1,239,1349,1110
2710,1,0,0,0,0
2711,0,0,22,0,-22
2712,0,0,43,0,-43
2713,1,0,8,0,-8
2714,0,0,327,0,-327
2715,1,1,545,1572,1027
2716,0,0,4,0,-4
2717,1,0,129,0,-129
2718,1,0,21,0,-21
2719,1,1,1388,1265,-123
2720,1,0,61,0,-61
2721,1,0,42,0,-42
2722,0,0,13,0,-13
2723,0,0,29,0,-29
2724,1,1,275,1378,1103
2725,1,0,91,0,-91
2726,1,1,263,1335,1072
2727,0,0,40,0,-40
2728,1,0,95,0,-95
2729,1,1,264,1293,1029
2730,1,1,262,1487,1225
2731,1,1,202,1322,1120
2732,1,1,383,1271,888
2733,1,1,757,1413,656
2734,1,1,559,2500,1941
2735,1,0,3,0,-3
2736,0,0,0,0,0
2737,0,0,2,0,-2
2738,1,0,47,0,-47
2739,1,1,42,1442,1400
2740,1,0,39,0,-39
2741,1,1,509,1821,1312
2742,1,0,6,0,-6
2743,0,0,19,0,-19
2744,1,1,2378,1579,-799
2745,0,0,1,0,-1
2746,0,0,7,0,-7
2747,1,0,4,0,-4
2748,0,0,31,0,-31
2749,0,0,52,0,-52
2750,0,0,56,0,-56
2751,0,0,246,0,-246
2752,1,1,508,1207,699
2753,0,0,58,0,-58
2754,1,1,246,1217,971
2755,1,0,24,0,-24
2756,1,0,28,0,-28
2757,1,1,274,1358,1084
2758,1,1,278,1274,996
2759,0,0,50,0,-50
2760,1,1,1112,1376,264
2761,1,1,529,1714,1185
2762,1,1,822,1240,418
2763,0,0,37,0,-37
2764,1,1,158,1241,1083
2765,1,1,123,1202,1079
2766,1,0,14,0,-14
2767,0,0,14,0,-14
2768,1,1,341,1283,942
2769,1,0,40,0,-40
2770,1,1,407,1480,1073
2771,1,0,35,0,-35
2772,1,1,255,2777,2522
2773,1,0,114,0,-114
2774,0,0,33,0,-33
2775,0,0,2,0,-2
2776,1,1,95,1306,1211
2777,0,0,34,0,-34
2778,1,1,183,1312,1129
2779,1,0,129,0,-129
2780,1,0,3,0,-3
2781,0,0,76,0,-76
2782,1,0,65,0,-65
2783,1,0,34,0,-34
2784,1,1,744,2326,1582
2785,0,0,12,0,-12
2786,0,0,5,0,-5
2787,1,0,25,0,-25
2788,1,0,8,0,-8
2789,1,1,445,1935,1490
2790,1,1,38,1229,1191
2791,0,0,42,0,-42
2792,0,0,96,0,-96
2793,0,0,95,0,-95
2794,0,0,23,0,-23
2795,1,1,364,1307,943
2796,1,1,270,1277,1007
2797,0,0,34,0,-34
2798,1,1,710,1614,904
2799,1,1,716,1654,938
2800,1,0,24,0,-24
2801,1,1,553,1530,977
2802,0,0,61,0,-61
2803,1,0,177,0,-177
2804,1,1,1059,1241,182
2805,1,0,50,0,-50
2806,1,0,1,0,-1
2807,1,1,479,1720,1241
2808,1,0,196,0,-196
2809,1,0,7,0,-7
2810,1,0,148,0,-148
2811,0,0,54,0,-54
2812,0,0,141,0,-141
2813,1,0,3,0,-3
2814,0,0,96,0,-96
2815,1,0,25,0,-25
2816,1,0,1,0,-1
2817,1,0,161,0,-161
2818,0,0,230,0,-230
2819,1,0,197,0,-197
2820,1,1,1154,1424,270
2821,0,0,96,0,-96
2822,0,0,15,0,-15
2823,1,0,0,0,0
2824,1,0,3,0,-3
2825,0,0,112,0,-112
2826,0,0,5,0,-5
2827,1,1,1118,1257,139
2828,1,0,13,0,-13
2829,1,1,411,2356,1945
2830,1,1,242,3794,3552
2831,0,0,34,0,-34
2832,1,0,93,0,-93
2833,0,0,57,0,-57
2834,1,0,83,0,-83
2835,1,0,24,0,-24
2836,0,0,93,0,-93
2837,1,1,351,1255,904
2838,0,0,0,0,0
2839,0,0,13,0,-13
2840,1,0,37,0,-37
2841,1,0,2,0,-2
2842,0,0,16,0,-16
2843,0,0,13,0,-13
2844,1,0,29,0,-29
2845,1,1,205,1261,1056
2846,0,0,49,0,-49
2847,1,1,975,1490,515
2848,0,0,0,0,0
2849,1,0,88,0,-88
2850,0,0,26,0,-26
2851,1,1,633,1563,930
2852,1,0,33,0,-33
2853,0,0,4,0,-4
2854,0,0,2,0,-2
2855,0,0,150,0,-150
2856,0,0,117,0,-117
2857,1,0,0,0,0
2858,1,0,97,0,-97
2859,0,0,34,0,-34
2860,1,0,6,0,-6
2861,1,1,282,1226,944
2862,0,0,5,0,-5
2863,1,0,55,0,-55
2864,0,0,115,0,-115
2865,0,0,37,0,-37
2866,0,0,47,0,-47
2867,0,0,35,0,-35
2868,0,0,62,0,-62
2869,0,0,6,0,-6
2870,0,0,11,0,-11
2871,0,0,307,0,-307
2872,0,0,13,0,-13
2873,1,0,66,0,-66
2874,1,0,30,0,-30
2875,1,1,689,1245,556
2876,1,1,399,1585,1186
2877,1,0,61,0,-61
2878,1,1,553,1318,765
2879,1,0,32,0,-32
2880,0,0,20,0,-20
2881,1,1,834,1484,650
2882,0,0,25,0,-25
2883,1,0,121,0,-121
2884,1,0,0,0,0
2885,1,1,261,3619,3358
2886,1,0,56,0,-56
2887,1,1,150,1433,1283
2888,1,0,7,0,-7
2889,0,0,88,0,-88
2890,1,1,832,1430,598
2891,0,0,5,0,-5
2892,1,1,1507,1522,15
2893,0,0,151,0,-151
2894,0,0,36,0,-36
2895,1,1,229,1638,1409
2896,0,0,29,0,-29
2897,0,0,79,0,-79
2898,0,0,14,0,-14
2899,1,1,246,1355,1109
2900,1,0,9,0,-9
2901,0,0,94,0,-94
2902,1,0,40,0,-40
2903,1,0,7,0,-7
2904,0,0,13,0,-13
2905,1,0,25,0,-25
2906,1,0,38,0,-38
2907,1,1,124,1513,1389
2908,1,1,588,1258,670
2909,0,0,16,0,-16
2910,0,0,62,0,-62
2911,1,0,67,0,-67
2912,1,1,456,1846,1390
2913,0,0,19,0,-19
2914,1,0,60,0,-60
2915,0,0,49,0,-49
2916,0,0,50,0,-50
2917,1,1,336,1644,1308
2918,1,1,233,2005,1772
2919,1,0,0,0,0
2920,0,0,2,0,-2
2921,1,0,104,0,-104
2922,1,1,750,1361,611
2923,1,0,35,0,-35
2924,1,1,339,1252,913
2925,1,1,400,1777,1377
2926,0,0,97,0,-97
2927,1,0,2,0,-2
2928,1,1,396,1914,1518
2929,0,0,79,0,-79
2930,1,0,14,0,-14
2931,0,0,94,0,-94
2932,1,1,179,1848,1669
2933,1,0,6,0,-6
2934,0,0,161,0,-161
2935,1,0,19,0,-19
2936,0,0,7,0,-7
2937,1,1,19,1249,1230
2938,0,0,1,0,-1
2939,1,1,455,2485,2030
2940,1,0,127,0,-127
2941,1,1,451,1338,887
2942,0,0,128,0,-128
2943,1,1,165,2045,1880
2944,1,0,241,0,-241
2945,1,1,166,1835,1669
2946,0,0,30,0,-30
2947,1,0,112,0,-112
2948,1,1,128,1563,1435
2949,1,0,147,0,-147
2950,1,1,868,1997,1129
2951,1,1,110,1467,1357
2952,0,0,22,0,-22
2953,0,0,1,0,-1
2954,1,0,7,0,-7
2955,1,1,223,1791,1568
2956,1,0,321,0,-321
2957,0,0,150,0,-150
2958,1,1,484,1235,751
2959,1,1,342,1709,1367
2960,1,1,324,1506,1182
2961,1,1,1128,1205,77
2962,1,0,53,0,-53
2963,1,1,71,1640,1569
2964,1,0,35,0,-35
2965,0,0,12,0,-12
2966,1,1,373,1219,846
2967,1,1,1986,1206,-780
2968,1,1,1017,1919,902
2969,1,0,33,0,-33
2970,1,0,23,0,-23
2971,1,0,68,0,-68
2972,0,0,44,0,-44
2973,1,1,205,1230,1025
2974,0,0,26,0,-26
2975,0,0,53,0,-53
2976,0,0,23,0,-23
2977,1,0,123,0,-123
2978,1,0,2,0,-2
2979,1,0,31,0,-31
2980,0,0,10,0,-10
2981,1,0,56,0,-56
2982,1,0,30,0,-30
2983,1,0,53,0,-53
2984,0,0,5,0,-5
2985,1,0,28,0,-28
2986,1,1,1853,1203,-650
2987,1,1,833,1206,373
2988,1,0,89,0,-89
2989,0,0,52,0,-52
2990,1,0,53,0,-53
2991,1,1,178,1207,1029
2992,1,1,200,1698,1498
2993,1,1,532,2134,1602
2994,1,0,38,0,-38
2995,0,0,42,0,-42
2996,1,1,522,2285,1763
2997,1,0,25,0,-25
2998,1,1,767,1584,817
2999,1,1,400,1379,979
3000,0,0,36,0,-36
3001,0,0,18,0,-18
3002,1,0,124,0,-124
3003,1,0,16,0,-16
3004,1,0,3,0,-3
3005,1,0,25,0,-25
3006,0,0,10,0,-10
3007,1,1,760,1331,571
3008,0,0,33,0,-33
3009,0,0,10,0,-10
3010,1,1,809,1433,624
3011,1,0,29,0,-29
3012,1,0,93,0,-93
3013,1,1,379,1254,875
3014,1,1,140,1558,1418
3015,1,1,328,1234,906
3016,1,1,291,1390,1099
3017,1,1,506,1467,961
3018,1,1,268,1512,1244
3019,1,0,22,0,-22
3020,1,1,353,1836,1483
3021,1,0,7,0,-7
3022,1,1,177,1827,1650
3023,1,1,128,1814,1686
3024,0,0,169,0,-169
3025,0,0,63,0,-63
3026,1,0,53,0,-53
3027,0,0,82,0,-82
3028,1,1,138,1737,1599
3029,1,1,419,1988,1569
3030,0,0,100,0,-100
3031,1,0,37,0,-37
3032,0,0,39,0,-39
3033,0,0,18,0,-18
3034,0,0,162,0,-162
3035,0,0,39,0,-39
3036,1,0,107,0,-107
3037,1,0,105,0,-105
3038,1,0,105,0,-105
3039,1,1,967,1336,369
3040,1,0,16,0,-16
3041,0,0,32,0,-32
3042,0,0,40,0,-40
3043,0,0,14,0,-14
3044,0,0,27,0,-27
3045,0,0,119,0,-119
3046,0,0,86,0,-86
3047,0,0,100,0,-100
3048,0,0,40,0,-40
3049,1,0,7,0,-7
3050,1,1,660,1553,893
3051,0,0,109,0,-109
3052,1,1,126,1211,1085
3053,1,0,38,0,-38
3054,0,0,18,0,-18
3055,0,0,24,0,-24
3056,0,0,23,0,-23
3057,1,0,11,0,-11
3058,0,0,1,0,-1
3059,1,1,611,1480,869
3060,0,0,52,0,-52
3061,1,1,755,1292,537
3062,0,0,27,0,-27
3063,0,0,4,0,-4
3064,0,0,39,0,-39
3065,1,1,32,1463,1431
3066,0,0,28,0,-28
3067,0,0,23,0,-23
3068,1,0,10,0,-10
3069,1,0,54,0,-54
3070,1,0,36,0,-36
3071,1,0,13,0,-13
3072,1,1,251,1491,1240
3073,0,0,31,0,-31
3074,0,0,12,0,-12
3075,0,0,117,0,-117
3076,1,1,181,1656,1475
3077,0,0,179,0,-179
3078,0,0,81,0,-81
3079,1,0,48,0,-48
3080,0,0,79,0,-79
3081,1,0,44,0,-44
3082,1,1,297,1219,922
3083,1,0,135,0,-135
3084,0,0,7,0,-7
3085,1,0,21,0,-21
3086,1,0,24,0,-24
3087,1,0,97,0,-97
3088,0,0,39,0,-39
3089,1,1,804,6722,5918
3090,1,1,665,1518,853
3091,1,1,279,1226,947
3092,0,0,17,0,-17
3093,0,0,31,0,-31
3094,0,0,30,0,-30
3095,1,0,19,0,-19
3096,0,0,255,0,-255
3097,1,1,789,2186,1397
3098,1,1,112,1319,1207
3099,0,0,19,0,-19
3100,1,0,7,0,-7
3101,1,0,18,0,-18
3102,0,0,8,0,-8
3103,1,0,25,0,-25
3104,1,0,17,0,-17
3105,1,1,112,1560,1448
3106,0,0,60,0,-60
3107,1,1,548,1508,960
3108,1,0,14,0,-14
3109,1,0,38,0,-38
3110,1,0,1,0,-1
3111,1,0,16,0,-16
3112,0,0,97,0,-97
3113,0,0,27,0,-27
3114,1,0,13,0,-13
3115,1,1,193,2133,1940
3116,0,0,74,0,-74
3117,0,0,12,0,-12
3118,0,0,39,0,-39
3119,1,0,117,0,-117
3120,1,0,13,0,-13
3121,0,0,68,0,-68
3122,0,0,73,0,-73
3123,0,0,16,0,-16
3124,0,0,1,0,-1
3125,0,0,127,0,-127
3126,1,0,2,0,-2
3127,1,1,351,1389,1038
3128,0,0,33,0,-33
3129,1,1,288,1202,914
3130,0,0,8,0,-8
3131,1,0,59,0,-59
3132,0,0,32,0,-32
3133,1,0,60,0,-60
3134,0,0,66,0,-66
3135,1,0,4,0,-4
3136,1,0,24,0,-24
3137,1,1,281,1440,1159
3138,1,0,23,0,-23
3139,1,0,27,0,-27
3140,1,0,10,0,-10
3141,1,1,1070,1636,566
3142,1,0,25,0,-25
3143,1,1,577,1507,930
3144,1,1,1098,1564,466
3145,1,0,62,0,-62
3146,1,0,72,0,-72
3147,1,0,46,0,-46
3148,1,0,33,0,-33
3149,0,0,62,0,-62
3150,1,0,10,0,-10
3151,1,1,312,1205,893
3152,0,0,67,0,-67
3153,0,0,75,0,-75
3154,1,0,62,0,-62
3155,0,0,107,0,-107
3156,1,0,0,0,0
3157,1,0,50,0,-50
3158,1,1,1834,1432,-402
3159,1,1,539,1557,1018
3160,0,0,1,0,-1
3161,0,0,64,0,-64
3162,0,0,258,0,-258
3163,1,0,45,0,-45
3164,0,0,19,0,-19
3165,0,0,54,0,-54
3166,0,0,31,0,-31
3167,0,0,1,0,-1
3168,1,0,33,0,-33
3169,1,1,719,1334,615
3170,0,0,44,0,-44
3171,0,0,32,0,-32
3172,1,0,38,0,-38
3173,1,1,1149,1230,81
3174,0,0,34,0,-34
3175,1,0,24,0,-24
3176,1,0,118,0,-118
3177,0,0,11,0,-11
3178,0,0,8,0,-8
3179,1,0,146,0,-146
3180,1,1,434,1208,774
3181,1,1,1114,1296,182
3182,0,0,48,0,-48
3183,1,0,37,0,-37
3184,0,0,11,0,-11
3185,1,0,20,0,-20
3186,1,1,2093,1520,-573
3187,0,0,15,0,-15
3188,1,0,18,0,-18
3189,0,0,141,0,-141
3190,0,0,84,0,-84
3191,0,0,23,0,-23
3192,1,0,45,0,-45
3193,1,1,441,2580,2139
3194,1,1,308,1331,1023
3195,0,0,191,0,-191
3196,0,0,29,0,-29
3197,0,0,13,0,-13
3198,1,1,100,1274,1174
3199,1,0,11,0,-11
3200,1,1,99,1696,1597
3201,1,1,341,1997,1656
3202,0,0,32,0,-32
3203,0,0,49,0,-49
3204,1,1,589,1426,837
3205,0,0,88,0,-88
3206,0,0,38,0,-38
3207,1,0,26,0,-26
3208,1,0,73,0,-73
3209,1,0,0,0,0
3210,1,1,1254,1230,-24
3211,1,0,67,0,-67
3212,0,0,7,0,-7
3213,1,0,25,0,-25
3214,1,0,20,0,-20
3215,0,0,37,0,-37
3216,0,0,2,0,-2
3217,1,0,193,0,-193
3218,1,0,55,0,-55
3219,1,0,59,0,-59
3220,1,0,3,0,-3
3221,1,1,187,1466,1279
3222,1,1,160,1320,1160
3223,1,0,302,0,-302
3224,1,0,30,0,-30
3225,1,1,1440,1452,12
3226,0,0,7,0,-7
3227,1,1,34,2278,2244
3228,0,0,33,0,-33
3229,0,0,36,0,-36
3230,1,1,274,1261,987
3231,1,0,23,0,-23
3232,1,0,100,0,-100
3233,1,1,1783,2450,667
3234,1,1,29,1297,1268
3235,0,0,11,0,-11
3236,0,0,8,0,-8
3237,1,1,786,1212,426
3238,1,1,11,1231,1220
3239,0,0,0,0,0
3240,0,0,0,0,0
3241,0,0,95,0,-95
3242,0,0,84,0,-84
3243,1,0,4,0,-4
3244,0,0,184,0,-184
3245,1,1,37,1201,1164
3246,1,0,78,0,-78
3247,0,0,51,0,-51
3248,1,1,962,1733,771
3249,0,0,40,0,-40
3250,1,0,56,0,-56
3251,1,1,139,1203,1064
3252,0,0,216,0,-216
3253,1,0,26,0,-26
3254,1,0,2,0,-2
3255,0,0,52,0,-52
3256,1,0,119,0,-119
3257,1,0,6,0,-6
3258,0,0,25,0,-25
3259,0,0,22,0,-22
3260,1,1,1177,1641,464
3261,1,1,312,1278,966
3262,0,0,92,0,-92
3263,1,0,13,0,-13
3264,0,0,7,0,-7
3265,1,1,983,1450,467
3266,0,0,23,0,-23
3267,1,0,9,0,-9
3268,1,0,59,0,-59
3269,0,0,59,0,-59
3270,1,0,15,0,-15
3271,1,0,29,0,-29
3272,1,0,123,0,-123
3273,0,0,79,0,-79
3274,1,1,1387,1443,56
3275,1,1,889,1391,502
3276,1,1,94,1442,1348
3277,0,0,26,0,-26
3278,0,0,53,0,-53
3279,1,1,645,1256,611
3280,1,1,40,1477,1437
3281,1,1,519,1448,929
3282,1,1,355,1667,1312
3283,1,1,1687,2008,321
3284,1,1,62,1550,1488
3285,0,0,61,0,-61
3286,0,0,12,0,-12
3287,1,1,222,1404,1182
3288,0,0,76,0,-76
3289,0,0,57,0,-57
3290,1,0,0,0,0
3291,1,0,39,0,-39
3292,1,0,15,0,-15
3293,0,0,5,0,-5
3294,0,0,5,0,-5
3295,1,1,535,1322,787
3296,1,1,169,1300,1131
3297,0,0,41,0,-41
3298,1,0,5,0,-5
3299,1,0,35,0,-35
3300,0,0,15,0,-15
3301,1,0,4,0,-4
3302,0,0,20,0,-20
3303,1,1,1403,1930,527
3304,0,0,46,0,-46
3305,1,1,525,3493,2968
3306,0,0,2,0,-2
3307,1,1,2102,1501,-601
3308,0,0,14,0,-14
3309,0,0,12,0,-12
3310,0,0,127,0,-127
3311,0,0,19,0,-19
3312,0,0,20,0,-20
3313,0,0,6,0,-6
3314,0,0,30,0,-30
3315,0,0,41,0,-41
3316,1,1,840,1285,445
3317,1,1,581,1492,911
3318,1,0,11,0,-11
3319,1,1,343,1220,877
3320,1,0,14,0,-14
3321,0,0,43,0,-43
3322,1,1,162,1309,1147
3323,1,0,40,0,-40
3324,1,0,101,0,-101
3325,0,0,118,0,-118
3326,0,0,20,0,-20
3327,1,1,547,2623,2076
3328,1,1,1460,1355,-105
3329,1,1,438,1403,965
3330,1,1,1339,1732,393
3331,1,0,131,0,-131
3332,1,0,44,0,-44
3333,0,0,50,0,-50
3334,0,0,0,0,0
3335,1,0,63,0,-63
3336,1,1,762,1414,652
3337,0,0,37,0,-37
3338,0,0,29,0,-29
3339,1,0,67,0,-67
3340,0,0,50,0,-50
3341,0,0,33,0,-33
3342,0,0,62,0,-62
3343,1,0,13,0,-13
3344,0,0,82,0,-82
3345,0,0,6,0,-6
3346,1,0,11,0,-11
3347,0,0,27,0,-27
3348,1,1,797,1664,867
3349,1,1,64,1888,1824
3350,1,1,715,1274,559
3351,1,0,16,0,-16
3352,1,0,133,0,-133
3353,1,1,983,1277,294
3354,0,0,37,0,-37
3355,1,0,76,0,-76
3356,0,0,32,0,-32
3357,0,0,7,0,-7
3358,1,1,538,2241,1703
3359,1,1,243,1251,1008
3360,1,1,3395,1583,-1812
3361,1,1,50,1324,1274
3362,0,0,78,0,-78
3363,0,0,101,0,-101
3364,1,1,396,1266,870
3365,0,0,24,0,-24
3366,0,0,56,0,-56
3367,1,1,820,1200,380
3368,1,1,53,1325,1272
3369,1,0,33,0,-33
3370,0,0,21,0,-21
3371,1,0,60,0,-60
3372,0,0,66,0,-66
3373,1,0,14,0,-14
3374,1,0,2,0,-2
3375,1,0,1,0,-1
3376,0,0,65,0,-65
3377,1,1,182,1342,1160
3378,1,1,203,1300,1097
3379,1,0,3,0,-3
3380,1,0,52,0,-52
3381,0,0,17,0,-17
3382,1,0,76,0,-76
3383,0,0,71,0,-71
3384,1,1,172,1481,1309
3385,0,0,61,0,-61
3386,1,1,82,1847,1765
3387,1,0,62,0,-62
3388,1,1,47,1954,1907
3389,0,0,0,0,0
3390,1,0,187,0,-187
3391,1,1,71,1704,1633
3392,1,0,28,0,-28
3393,1,1,916,1458,542
3394,1,0,72,0,-72
3395,0,0,98,0,-98
3396,0,0,72,0,-72
3397,1,0,144,0,-144
3398,1,1,735,1232,497
3399,1,1,467,2295,1828
3400,1,1,732,1240,508
3401,0,0,40,0,-40
3402,1,0,95,0,-95
3403,0,0,84,0,-84
3404,0,0,54,0,-54
3405,0,0,114,0,-114
3406,1,0,3,0,-3
3407,1,0,6,0,-6
3408,0,0,68,0,-68
3409,0,0,23,0,-23
3410,0,0,63,0,-63
3411,0,0,24,0,-24
3412,1,0,51,0,-51
3413,1,1,293,1670,1377
3414,1,0,50,0,-50
3415,1,1,484,3607,3123
3416,1,1,1256,1215,-41
3417,1,1,876,2064,1188
3418,0,0,8,0,-8
3419,0,0,22,0,-22
3420,0,0,32,0,-32
3421,0,0,35,0,-35
3422,0,0,31,0,-31
3423,0,0,169,0,-169
3424,0,0,23,0,-23
3425,0,0,57,0,-57
3426,1,0,115,0,-115
3427,1,0,8,0,-8
3428,0,0,7,0,-7
3429,0,0,221,0,-221
3430,1,1,957,6155,5198
3431,1,1,95,1788,1693
3432,1,0,36,0,-36
3433,1,0,45,0,-45
3434,1,1,1742,1220,-522
3435,1,0,57,0,-57
3436,1,1,62,1404,1342
3437,1,0,12,0,-12
3438,1,1,73,2849,2776
3439,0,0,28,0,-28
3440,1,0,7,0,-7
3441,0,0,16,0,-16
3442,1,0,3,0,-3
3443,1,0,2,0,-2
3444,1,1,1817,1522,-295
3445,0,0,125,0,-125
3446,1,1,778,1625,847
3447,0,0,30,0,-30
3448,1,0,47,0,-47
3449,0,0,7,0,-7
3450,1,1,978,1257,279
3451,1,0,18,0,-18
3452,0,0,88,0,-88
3453,0,0,0,0,0
3454,1,1,972,1264,292
3455,1,1,109,1736,1627
3456,0,0,1,0,-1
3457,1,0,16,0,-16
3458,0,0,3,0,-3
3459,1,0,140,0,-140
3460,1,1,230,4672,4442
3461,1,0,7,0,-7
3462,1,0,4,0,-4
3463,0,0,222,0,-222
3464,1,1,690,1725,1035
3465,0,0,16,0,-16
3466,1,1,106,1484,1378
3467,0,0,168,0,-168
3468,1,0,40,0,-40
3469,0,0,282,0,-282
3470,1,1,143,1262,1119
3471,0,0,39,0,-39
3472,1,0,7,0,-7
3473,1,1,382,1339,957
3474,1,0,72,0,-72
3475,0,0,12,0,-12
3476,1,0,53,0,-53
3477,0,0,71,0,-71
3478,1,0,12,0,-12
3479,0,0,3,0,-3
3480,1,1,1813,1228,-585
3481,1,1,995,1361,366
3482,1,1,231,1335,1104
3483,1,1,1084,1331,247
3484,1,0,26,0,-26
3485,0,0,32,0,-32
3486,1,1,579,1597,1018
3487,1,0,116,0,-116
3488,1,0,37,0,-37
3489,0,0,55,0,-55
3490,1,0,22,0,-22
3491,0,0,16,0,-16
3492,1,1,166,1666,1500
3493,1,0,13,0,-13
3494,1,1,146,1673,1527
3495,0,0,82,0,-82
3496,1,0,190,0,-190
3497,1,1,1682,1376,-306
3498,1,0,58,0,-58
3499,1,0,99,0,-99
3500,0,0,20,0,-20
3501,1,0,71,0,-71
3502,1,1,52,1775,1723
3503,1,0,65,0,-65
3504,0,0,42,0,-42
3505,0,0,62,0,-62
3506,1,1,266,1270,1004
3507,1,0,0,0,0
3508,1,1,1483,1392,-91
3509,1,0,2,0,-2
3510,1,1,1331,1450,119
3511,1,1,978,1235,257
3512,0,0,165,0,-165
3513,1,1,381,1228,847
3514,0,0,21,0,-21
3515,1,1,791,1228,437
3516,0,0,58,0,-58
3517,0,0,10,0,-10
3518,1,1,711,1763,1052
3519,0,0,31,0,-31
3520,0,0,23,0,-23
3521,0,0,57,0,-57
3522,0,0,8,0,-8
3523,0,0,93,0,-93
3524,1,0,65,0,-65
3525,1,1,611,1353,742
3526,1,1,698,1319,621
3527,1,0,379,0,-379
3528,1,0,1,0,-1
3529,0,0,5,0,-5
3530,0,0,45,0,-45
3531,1,1,891,1219,328
3532,1,1,306,1572,1266
3533,0,0,2,0,-2
3534,0,0,31,0,-31
3535,1,1,374,1970,1596
3536,0,0,95,0,-95
3537,0,0,151,0,-151
3538,1,0,106,0,-106
3539,1,0,6,0,-6
3540,0,0,5,0,-5
3541,0,0,18,0,-18
3542,0,0,162,0,-162
3543,0,0,39,0,-39
3544,0,0,8,0,-8
3545,0,0,7,0,-7
3546,0,0,82,0,-82
3547,0,0,152,0,-152
3548,1,1,1127,1413,286
3549,0,0,48,0,-48
3550,1,0,4,0,-4
3551,0,0,80,0,-80
3552,1,1,447,1314,867
3553,1,1,386,1502,1116
3554,0,0,76,0,-76
3555,1,0,52,0,-52
3556,1,1,182,1205,1023
3557,1,1,106,1322,1216
3558,0,0,0,0,0
3559,0,0,44,0,-44
3560,0,0,52,0,-52
3561,1,0,24,0,-24
3562,1,0,95,0,-95
3563,0,0,12,0,-12
3564,0,0,116,0,-116
3565,0,0,21,0,-21
3566,1,1,413,1757,1344
3567,1,0,41,0,-41
3568,1,0,13,0,-13
3569,0,0,125,0,-125
3570,1,0,18,0,-18
3571,1,1,202,1251,1049
3572,0,0,12,0,-12
3573,0,0,76,0,-76
3574,1,0,122,0,-122
3575,0,0,29,0,-29
3576,0,0,23,0,-23
3577,0,0,48,0,-48
3578,1,1,61,1254,1193
3579,1,1,337,1336,999
3580,1,0,9,0,-9
3581,0,0,30,0,-30
3582,1,0,5,0,-5
3583,1,0,56,0,-56
3584,1,1,204,1202,998
3585,0,0,37,0,-37
3586,0,0,34,0,-34
3587,0,0,37,0,-37
3588,1,0,38,0,-38
3589,0,0,5,0,-5
3590,1,0,113,0,-113
3591,1,1,960,1631,671
3592,1,0,19,0,-19
3593,1,0,82,0,-82
3594,1,1,976,1325,349
3595,0,0,6,0,-6
3596,1,1,600,1233,633
3597,0,0,17,0,-17
3598,1,0,141,0,-141
3599,1,0,9,0,-9
3600,0,0,182,0,-182
3601,0,0,1,0,-1
3602,0,0,2,0,-2
3603,0,0,21,0,-21
3604,0,0,11,0,-11
3605,1,1,67,1312,1245
3606,1,0,4,0,-4
3607,0,0,57,0,-57
3608,0,0,30,0,-30
3609,1,1,89,2090,2001
3610,0,0,84,0,-84
3611,1,0,7,0,-7
3612,1,0,17,0,-17
3613,0,0,85,0,-85
3614,0,0,64,0,-64
3615,0,0,67,0,-67
3616,0,0,29,0,-29
3617,0,0,23,0,-23
3618,1,1,133,1647,1514
3619,0,0,48,0,-48
3620,0,0,70,0,-70
3621,0,0,54,0,-54
3622,1,1,181,1792,1611
3623,1,1,490,1253,763
3624,0,0,62,0,-62
3625,1,0,2,0,-2
3626,0,0,130,0,-130
3627,0,0,65,0,-65
3628,0,0,19,0,-19
3629,0,0,95,0,-95
3630,0,0,11,0,-11
3631,0,0,85,0,-85
3632,1,1,494,1338,844
3633,1,0,1,0,-1
3634,1,0,105,0,-105
3635,1,1,717,5800,5083
3636,0,0,111,0,-111
3637,0,0,63,0,-63
3638,0,0,67,0,-67
3639,1,0,58,0,-58
3640,1,0,5,0,-5
3641,0,0,19,0,-19
3642,0,0,72,0,-72
3643,1,1,475,1423,948
3644,1,0,22,0,-22
3645,1,0,25,0,-25
3646,1,0,203,0,-203
3647,1,0,131,0,-131
3648,1,1,44,2438,2394
3649,0,0,27,0,-27
3650,1,1,385,1426,1041
3651,1,1,322,1503,1181
3652,1,1,138,1200,1062
3653,0,0,81,0,-81
3654,1,1,251,1375,1124
3655,0,0,66,0,-66
3656,1,1,1569,1272,-297
3657,1,1,125,1484,1359
3658,1,1,1055,1228,173
3659,1,0,76,0,-76
3660,0,0,33,0,-33
3661,0,0,126,0,-126
3662,1,1,232,1240,1008
3663,0,0,180,0,-180
3664,0,0,30,0,-30
3665,1,1,421,2720,2299
3666,1,1,117,1469,1352
3667,1,1,269,3886,3617
3668,1,0,44,0,-44
3669,1,1,90,1208,1118
3670,1,0,9,0,-9
3671,0,0,26,0,-26
3672,0,0,60,0,-60
3673,1,0,29,0,-29
3674,0,0,167,0,-167
3675,1,0,8,0,-8
3676,0,0,21,0,-21
3677,1,1,606,1309,703
3678,1,0,6,0,-6
3679,1,1,1238,1465,227
3680,0,0,72,0,-72
3681,1,1,61,1457,1396
3682,0,0,24,0,-24
3683,1,1,439,1552,1113
3684,1,1,778,1329,551
3685,0,0,20,0,-20
3686,0,0,2,0,-2
3687,1,1,1274,1217,-57
3688,0,0,13,0,-13
3689,0,0,60,0,-60
3690,1,0,42,0,-42
3691,1,0,8,0,-8
3692,1,0,77,0,-77
3693,0,0,26,0,-26
3694,0,0,105,0,-105
3695,0,0,267,0,-267
3696,1,0,123,0,-123
3697,0,0,19,0,-19
3698,1,0,9,0,-9
3699,0,0,34,0,-34
3700,1,0,13,0,-13
3701,0,0,8,0,-8
3702,0,0,11,0,-11
3703,0,0,3,0,-3
3704,0,0,8,0,-8
3705,1,0,21,0,-21
3706,0,0,20,0,-20
3707,1,1,26,2300,2274
3708,1,0,44,0,-44
3709,1,1,115,1356,1241
3710,1,0,56,0,-56
3711,0,0,11,0,-11
3712,1,1,1604,1693,89
3713,0,0,117,0,-117
3714,1,1,215,1441,1226
3715,1,0,108,0,-108
3716,0,0,4,0,-4
3717,1,0,109,0,-109
3718,0,0,97,0,-97
3719,1,1,616,1295,679
3720,1,1,347,1263,916
3721,1,1,995,1214,219
3722,0,0,58,0,-58
3723,1,1,332,1217,885
3724,0,0,16,0,-16
3725,0,0,19,0,-19
3726,1,1,468,1364,896
3727,1,0,36,0,-36
3728,1,1,832,1304,472
3729,1,1,1884,1520,-364
3730,0,0,21,0,-21
3731,0,0,79,0,-79
3732,1,1,894,1655,761
3733,1,1,1322,1215,-107
3734,1,0,255,0,-255
3735,1,1,549,1748,1199
3736,1,1,1645,1766,121
3737,1,0,89,0,-89
3738,1,0,47,0,-47
3739,0,0,19,0,-19
3740,1,1,592,1469,877
3741,1,0,82,0,-82
3742,1,0,79,0,-79
3743,0,0,34,0,-34
3744,1,1,1307,2081,774
3745,1,1,633,1293,660
3746,1,0,9,0,-9
3747,1,0,24,0,-24
3748,0,0,9,0,-9
3749,0,0,34,0,-34
3750,0,0,4,0,-4
3751,1,1,279,1701,1422
3752,1,0,13,0,-13
3753,0,0,22,0,-22
3754,1,1,237,1227,990
3755,0,0,63,0,-63
3756,0,0,35,0,-35
3757,1,0,26,0,-26
3758,1,0,5,0,-5
3759,1,0,72,0,-72
3760,1,0,31,0,-31
3761,0,0,44,0,-44
3762,0,0,57,0,-57
3763,1,1,601,1295,694
3764,1,1,130,1354,1224
3765,0,0,53,0,-53
3766,1,0,66,0,-66
3767,1,0,0,0,0
3768,1,0,28,0,-28
3769,1,1,219,1432,1213
3770,1,1,193,1242,1049
3771,1,1,744,1270,526
3772,0,0,43,0,-43
3773,1,1,834,1334,500
3774,1,1,893,1284,391
3775,0,0,6,0,-6
3776,1,0,0,0,0
3777,1,1,94,1419,1325
3778,0,0,41,0,-41
3779,0,0,35,0,-35
3780,0,0,64,0,-64
3781,1,1,1390,1406,16
3782,1,1,83,1304,1221
3783,1,1,177,1224,1047
3784,1,0,22,0,-22
3785,1,1,737,1303,566
3786,0,0,10,0,-10
3787,1,0,0,0,0
3788,1,0,164,0,-164
3789,0,0,96,0,-96
3790,1,0,25,0,-25
3791,0,0,171,0,-171
3792,0,0,26,0,-26
3793,1,0,6,0,-6
3794,0,0,34,0,-34
3795,1,0,30,0,-30
3796,1,1,486,1304,818
3797,1,0,7,0,-7
3798,0,0,24,0,-24
3799,0,0,15,0,-15
3800,1,1,494,1898,1404
3801,1,0,11,0,-11
3802,1,0,92,0,-92
3803,1,1,2152,1687,-465
3804,1,1,169,1791,1622
3805,1,1,962,1313,351
3806,0,0,76,0,-76
3807,1,1,158,1206,1048
3808,1,1,1136,1259,123
3809,1,0,9,0,-9
3810,0,0,13,0,-13
3811,0,0,68,0,-68
3812,1,1,932,1884,952
3813,1,1,37,1292,1255
3814,1,1,663,1209,546
3815,1,0,12,0,-12
3816,1,0,4,0,-4
3817,0,0,74,0,-74
3818,0,0,2,0,-2
3819,0,0,24,0,-24
3820,0,0,7,0,-7
3821,1,0,47,0,-47
3822,1,1,454,1209,755
3823,1,1,445,1270,825
3824,0,0,106,0,-106
3825,1,0,3,0,-3
3826,0,0,22,0,-22
3827,0,0,16,0,-16
3828,1,1,841,1359,518
3829,0,0,158,0,-158
3830,1,0,20,0,-20
3831,1,1,327,1456,1129
3832,0,0,65,0,-65
3833,1,0,25,0,-25
3834,1,0,1,0,-1
3835,1,1,5,1479,1474
3836,1,1,497,3413,2916
3837,1,1,840,1271,431
3838,0,0,42,0,-42
3839,1,0,26,0,-26
3840,0,0,22,0,-22
3841,1,1,364,1469,1105
3842,1,0,44,0,-44
3843,1,0,66,0,-66
3844,1,0,35,0,-35
3845,1,0,123,0,-123
3846,0,0,42,0,-42
3847,1,1,639,1412,773
3848,1,1,473,1829,1356
3849,1,1,351,1270,919
3850,0,0,40,0,-40
3851,0,0,54,0,-54
3852,0,0,96,0,-96
3853,1,0,13,0,-13
3854,1,0,24,0,-24
3855,0,0,35,0,-35
3856,1,0,32,0,-32
3857,0,0,12,0,-12
3858,0,0,68,0,-68
3859,1,0,55,0,-55
3860,1,1,2635,1232,-1403
3861,0,0,42,0,-42
3862,1,0,174,0,-174
3863,0,0,23,0,-23
3864,1,0,156,0,-156
3865,0,0,93,0,-93
3866,0,0,77,0,-77
3867,0,0,7,0,-7
3868,0,0,20,0,-20
3869,1,1,413,1253,840
3870,1,1,509,1626,1117
3871,1,0,17,0,-17
3872,1,0,3,0,-3
3873,0,0,22,0,-22
3874,1,0,8,0,-8
3875,1,0,19,0,-19
3876,1,0,0,0,0
3877,0,0,13,0,-13
3878,1,1,765,1251,486
3879,1,0,96,0,-96
3880,0,0,11,0,-11
3881,1,1,388,1284,896
3882,1,1,557,1268,711
3883,1,0,31,0,-31
3884,1,1,1607,1457,-150
3885,1,0,36,0,-36
3886,0,0,46,0,-46
3887,0,0,31,0,-31
3888,1,0,7,0,-7
3889,1,0,4,0,-4
3890,0,0,142,0,-142
3891,0,0,12,0,-12
3892,1,1,149,1420,1271
3893,1,1,491,1264,773
3894,1,0,79,0,-79
3895,1,0,29,0,-29
3896,1,1,869,1343,474
3897,1,0,6,0,-6
3898,0,0,89,0,-89
3899,0,0,93,0,-93
3900,1,1,134,1904,1770
3901,1,0,316,0,-316
3902,1,1,438,2331,1893
3903,1,0,44,0,-44
3904,1,1,158,1268,1110
3905,0,0,13,0,-13
3906,0,0,5,0,-5
3907,1,0,58,0,-58
3908,0,0,141,0,-141
3909,0,0,22,0,-22
3910,0,0,42,0,-42
3911,0,0,87,0,-87
3912,1,1,341,1538,1197
3913,0,0,120,0,-120
3914,1,1,962,1426,464
3915,1,0,41,0,-41
3916,0,0,17,0,-17
3917,1,0,35,0,-35
3918,1,1,661,1507,846
3919,0,0,76,0,-76
3920,1,0,0,0,0
3921,0,0,254,0,-254
3922,0,0,7,0,-7
3923,1,1,51,1308,1257
3924,0,0,5,0,-5
3925,1,0,1,0,-1
3926,1,1,233,1555,1322
3927,0,0,7,0,-7
3928,1,0,62,0,-62
3929,1,0,52,0,-52
3930,1,0,7,0,-7
3931,0,0,5,0,-5
3932,1,0,10,0,-10
3933,0,0,5,0,-5
3934,0,0,20,0,-20
3935,1,1,512,1308,796
3936,0,0,4,0,-4
3937,1,0,8,0,-8
3938,1,1,235,1268,1033
3939,1,1,953,3435,2482
3940,1,0,14,0,-14
3941,0,0,51,0,-51
3942,0,0,27,0,-27
3943,0,0,16,0,-16
3944,0,0,54,0,-54
3945,0,0,19,0,-19
3946,1,0,7,0,-7
3947,1,1,898,1465,567
3948,1,0,54,0,-54
3949,0,0,135,0,-135
3950,1,1,438,1819,1381
3951,0,0,1,0,-1
3952,1,0,56,0,-56
3953,0,0,118,0,-118
3954,1,0,21,0,-21
3955,0,0,19,0,-19
3956,0,0,1,0,-1
3957,1,1,883,1214,331
3958,0,0,13,0,-13
3959,0,0,217,0,-217
3960,1,1,173,1484,1311
3961,0,0,31,0,-31
3962,0,0,31,0,-31
3963,1,0,44,0,-44
3964,0,0,92,0,-92
3965,1,1,561,1772,1211
3966,1,1,189,1347,1158
3967,0,0,39,0,-39
3968,1,1,956,1208,252
3969,0,0,169,0,-169
3970,1,1,791,3256,2465
3971,1,0,15,0,-15
3972,0,0,16,0,-16
3973,0,0,25,0,-25
3974,1,1,140,1688,1548
3975,1,0,16,0,-16
3976,0,0,150,0,-150
3977,1,0,7,0,-7
3978,1,1,365,1375,1010
3979,0,0,253,0,-253
3980,1,0,0,0,0
3981,1,1,1192,1253,61
3982,0,0,89,0,-89
3983,1,0,15,0,-15
3984,1,0,42,0,-42
3985,1,0,6,0,-6
3986,0,0,116,0,-116
3987,0,0,25,0,-25
3988,0,0,39,0,-39
3989,1,1,1304,1993,689
3990,0,0,29,0,-29
3991,0,0,28,0,-28
3992,1,0,29,0,-29
3993,1,1,176,1488,1312
3994,1,0,38,0,-38
3995,1,0,278,0,-278
3996,0,0,13,0,-13
3997,0,0,25,0,-25
3998,1,0,14,0,-14
3999,0,0,22,0,-22
4000,1,0,19,0,-19
4001,0,0,17,0,-17
4002,1,0,89,0,-89
4003,0,0,36,0,-36
4004,0,0,92,0,-92
4005,0,0,0,0,0
4006,1,0,14,0,-14
4007,1,0,19,0,-19
4008,1,1,861,1482,621
4009,1,1,305,1947,1642
4010,0,0,82,0,-82
4011,1,0,55,0,-55
4012,0,0,27,0,-27
4013,0,0,4,0,-4
4014,1,0,19,0,-19
4015,1,0,69,0,-69
4016,1,1,1138,1782,644
4017,1,0,88,0,-88
4018,1,1,35,1293,1258
4019,1,0,20,0,-20
4020,0,0,8,0,-8
4021,1,1,94,1364,1270
4022,1,0,29,0,-29
4023,1,0,43,0,-43
4024,1,1,161,1638,1477
4025,1,1,1332,1293,-39
4026,0,0,15,0,-15
4027,0,0,25,0,-25
4028,1,0,85,0,-85
4029,1,1,242,1205,963
4030,1,0,3,0,-3
4031,0,0,61,0,-61
4032,0,0,16,0,-16
4033,1,1,55,1523,1468
4034,1,1,1487,1242,-245
4035,1,0,89,0,-89
4036,1,1,275,1980,1705
4037,0,0,66,0,-66
4038,0,0,10,0,-10
4039,1,0,86,0,-86
4040,0,0,86,0,-86
4041,1,1,186,1625,1439
4042,0,0,0,0,0
4043,1,0,6,0,-6
4044,0,0,5,0,-5
4045,1,0,103,0,-103
4046,0,0,11,0,-11
4047,0,0,10,0,-10
4048,1,0,7,0,-7
4049,1,0,17,0,-17
4050,1,0,11,0,-11
4051,0,0,55,0,-55
4052,1,1,183,1616,1433
4053,0,0,49,0,-49
4054,0,0,27,0,-27
4055,0,0,59,0,-59
4056,0,0,81,0,-81
4057,1,1,1145,1323,178
4058,1,1,276,2561,2285
4059,1,1,278,1563,1285
4060,0,0,56,0,-56
4061,1,0,103,0,-103
4062,1,1,229,1557,1328
4063,1,1,229,1209,980
4064,1,0,2,0,-2
4065,1,1,117,1469,1352
4066,0,0,31,0,-31
4067,0,0,6,0,-6
4068,1,1,324,1400,1076
4069,1,1,558,2542,1984
4070,0,0,1,0,-1
4071,0,0,76,0,-76
4072,0,0,3,0,-3
4073,1,1,320,1241,921
4074,0,0,79,0,-79
4075,1,0,14,0,-14
4076,0,0,39,0,-39
4077,0,0,67,0,-67
4078,1,0,67,0,-67
4079,1,1,29,1473,1444
4080,1,1,24,1725,1701
4081,1,1,528,1413,885
4082,1,0,71,0,-71
4083,0,0,131,0,-131
4084,0,0,22,0,-22
4085,0,0,5,0,-5
4086,0,0,83,0,-83
4087,0,0,10,0,-10
4088,1,1,343,1413,1070
4089,0,0,86,0,-86
4090,0,0,41,0,-41
4091,0,0,17,0,-17
4092,1,1,861,1714,853
4093,0,0,28,0,-28
4094,1,1,1086,2792,1706
4095,1,0,17,0,-17
4096,1,0,32,0,-32
4097,1,1,350,2093,1743
4098,0,0,47,0,-47
4099,1,1,725,1340,615
4100,0,0,12,0,-12
4101,0,0,107,0,-107
4102,0,0,11,0,-11
4103,1,1,2195,1367,-828
4104,0,0,11,0,-11
4105,1,0,72,0,-72
4106,0,0,148,0,-148
4107,1,0,5,0,-5
4108,1,1,241,4775,4534
4109,0,0,33,0,-33
4110,0,0,56,0,-56
4111,1,0,26,0,-26
4112,1,0,28,0,-28
4113,1,0,72,0,-72
4114,1,1,382,1598,1216
4115,1,1,182,1213,1031
4116,0,0,5,0,-5
4117,0,0,98,0,-98
4118,0,0,12,0,-12
4119,1,0,93,0,-93
4120,0,0,16,0,-16
4121,1,1,186,1370,1184
4122,1,0,151,0,-151
4123,0,0,21,0,-21
4124,1,1,512,1550,1038
4125,1,0,21,0,-21
4126,0,0,13,0,-13
4127,1,0,78,0,-78
4128,1,0,80,0,-80
4129,0,0,47,0,-47
4130,1,1,1517,1391,-126
4131,1,1,1431,1775,344
4132,1,0,7,0,-7
4133,1,0,88,0,-88
4134,0,0,9,0,-9
4135,0,0,124,0,-124
4136,1,0,17,0,-17
4137,1,1,525,1831,1306
4138,1,1,456,1579,1123
4139,0,0,29,0,-29
4140,1,0,154,0,-154
4141,1,0,38,0,-38
4142,1,1,864,1437,573
4143,1,0,6,0,-6
4144,1,0,18,0,-18
4145,1,1,371,1456,1085
4146,0,0,96,0,-96
4147,0,0,60,0,-60
4148,1,1,242,1338,1096
4149,0,0,115,0,-115
4150,0,0,7,0,-7
4151,1,0,4,0,-4
4152,0,0,10,0,-10
4153,1,0,110,0,-110
4154,1,1,96,1212,1116
4155,1,0,99,0,-99
4156,0,0,37,0,-37
4157,1,1,133,1290,1157
4158,1,1,409,1617,1208
4159,0,0,10,0,-10
4160,1,1,330,1237,907
4161,0,0,83,0,-83
4162,1,1,1018,1571,553
4163,1,1,108,1392,1284
4164,0,0,63,0,-63
4165,1,0,43,0,-43
4166,0,0,77,0,-77
4167,1,0,27,0,-27
4168,1,0,26,0,-26
4169,1,1,1385,1230,-155
4170,1,1,120,1413,1293
4171,0,0,12,0,-12
4172,0,0,24,0,-24
4173,0,0,20,0,-20
4174,1,0,8,0,-8
4175,0,0,79,0,-79
4176,0,0,19,0,-19
4177,1,0,11,0,-11
4178,1,0,17,0,-17
4179,0,0,6,0,-6
4180,0,0,17,0,-17
4181,0,0,10,0,-10
4182,1,1,43,1359,1316
4183,1,1,267,1346,1079
4184,0,0,6,0,-6
4185,0,0,31,0,-31
4186,1,0,247,0,-247
4187,1,0,10,0,-10
4188,1,1,899,1239,340
4189,1,1,463,1890,1427
4190,0,0,15,0,-15
4191,0,0,41,0,-41
4192,1,1,66,2478,2412
4193,1,0,35,0,-35
4194,0,0,217,0,-217
4195,1,0,11,0,-11
4196,1,1,307,1312,1005
4197,1,0,31,0,-31
4198,1,0,30,0,-30
4199,0,0,4,0,-4
4200,1,1,1929,1631,-298
4201,0,0,0,0,0
4202,0,0,208,0,-208
4203,0,0,38,0,-38
4204,0,0,36,0,-36
4205,1,0,1,0,-1
4206,1,0,16,0,-16
4207,1,0,5,0,-5
4208,1,1,1091,1700,609
4209,0,0,2,0,-2
4210,1,1,121,1257,1136
4211,1,0,105,0,-105
4212,0,0,43,0,-43
4213,0,0,6,0,-6
4214,1,1,1053,1211,158
4215,0,0,82,0,-82
4216,1,1,490,1776,1286
4217,1,1,134,1908,1774
4218,1,1,149,1412,1263
4219,1,0,13,0,-13
4220,0,0,44,0,-44
4221,1,0,0,0,0
4222,0,0,4,0,-4
4223,0,0,15,0,-15
4224,1,1,396,1423,1027
4225,1,1,353,1341,988
4226,0,0,73,0,-73
4227,1,1,176,2989,2813
4228,1,0,19,0,-19
4229,1,0,58,0,-58
4230,0,0,27,0,-27
4231,0,0,69,0,-69
4232,1,1,235,1466,1231
4233,0,0,48,0,-48
4234,1,1,158,1353,1195
4235,1,1,212,2023,1811
4236,0,0,7,0,-7
4237,1,1,238,1584,1346
4238,1,0,138,0,-138
4239,1,1,1652,2855,1203
4240,1,0,21,0,-21
4241,0,0,37,0,-37
4242,0,0,5,0,-5
4243,1,0,4,0,-4
4244,1,0,28,0,-28
4245,0,0,18,0,-18
4246,1,1,236,2458,2222
4247,0,0,48,0,-48
4248,1,0,15,0,-15
4249,0,0,25,0,-25
4250,1,0,42,0,-42
4251,1,0,26,0,-26
4252,0,0,117,0,-117
4253,0,0,3,0,-3
4254,0,0,68,0,-68
4255,1,0,53,0,-53
4256,1,1,91,1493,1402
4257,1,1,738,1533,795
4258,1,0,116,0,-116
4259,0,0,31,0,-31
4260,1,1,513,1440,927
4261,1,0,31,0,-31
4262,0,0,264,0,-264
4263,0,0,6,0,-6
4264,0,0,13,0,-13
4265,1,1,834,1415,581
4266,1,0,0,0,0
4267,1,0,80,0,-80
4268,1,0,52,0,-52
4269,0,0,8,0,-8
4270,0,0,19,0,-19
4271,1,0,107,0,-107
4272,0,0,34,0,-34
4273,1,1,1225,1539,314
4274,1,1,194,2136,1942
4275,1,0,2,0,-2
4276,1,0,45,0,-45
4277,1,0,3,0,-3
4278,1,0,111,0,-111
4279,1,1,428,1314,886
4280,1,0,73,0,-73
4281,1,1,2499,1687,-812
4282,1,1,126,1324,1198
4283,1,1,1013,3925,2912
4284,1,0,94,0,-94
4285,0,0,40,0,-40
4286,1,0,29,0,-29
4287,1,1,257,1307,1050
4288,1,0,50,0,-50
4289,0,0,123,0,-123
4290,1,0,17,0,-17
4291,1,0,34,0,-34
4292,1,1,140,1263,1123
4293,0,0,81,0,-81
4294,0,0,65,0,-65
4295,0,0,0,0,0
4296,1,0,24,0,-24
4297,1,1,531,1741,1210
4298,1,0,1,0,-1
4299,1,0,0,0,0
4300,1,1,1135,1462,327
4301,1,1,295,2196,1901
4302,0,0,3,0,-3
4303,1,0,26,0,-26
4304,0,0,20,0,-20
4305,1,1,194,1202,1008
4306,0,0,78,0,-78
4307,0,0,3,0,-3
4308,0,0,5,0,-5
4309,0,0,55,0,-55
4310,1,1,1701,1514,-187
4311,1,1,261,1361,1100
4312,1,0,64,0,-64
4313,1,1,188,1242,1054
4314,1,0,137,0,-137
4315,1,0,77,0,-77
4316,1,1,1677,1714,37
4317,1,1,202,1300,1098
4318,0,0,14,0,-14
4319,1,1,608,2075,1467
4320,1,1,111,1594,1483
4321,1,1,554,1778,1224
4322,0,0,9,0,-9
4323,1,0,167,0,-167
4324,1,1,652,1305,653
4325,1,0,15,0,-15
4326,0,0,66,0,-66
4327,1,1,210,1335,1125
4328,1,1,298,1568,1270
4329,0,0,30,0,-30
4330,0,0,48,0,-48
4331,1,0,22,0,-22
4332,1,0,119,0,-119
4333,0,0,58,0,-58
4334,0,0,7,0,-7
4335,0,0,1,0,-1
4336,1,0,57,0,-57
4337,1,0,32,0,-32
4338,1,1,864,1896,1032
4339,0,0,163,0,-163
4340,1,0,4,0,-4
4341,0,0,226,0,-226
4342,0,0,25,0,-25
4343,0,0,14,0,-14
4344,1,1,22,2774,2752
4345,0,0,44,0,-44
4346,1,0,105,0,-105
4347,0,0,45,0,-45
4348,1,1,392,1840,1448
4349,1,0,0,0,0
4350,1,1,550,1598,1048
4351,1,0,38,0,-38
4352,0,0,93,0,-93
4353,0,0,39,0,-39
4354,0,0,26,0,-26
4355,0,0,137,0,-137
4356,1,0,1,0,-1
4357,1,1,56,2344,2288
4358,0,0,36,0,-36
4359,1,0,9,0,-9
4360,1,0,4,0,-4
4361,1,1,162,1224,1062
4362,1,1,492,1285,793
4363,0,0,32,0,-32
4364,0,0,12,0,-12
4365,0,0,81,0,-81
4366,0,0,6,0,-6
4367,1,1,334,1248,914
4368,1,0,4,0,-4
4369,0,0,34,0,-34
4370,1,1,1247,1356,109
4371,0,0,82,0,-82
4372,0,0,12,0,-12
4373,0,0,53,0,-53
4374,1,0,1,0,-1
4375,1,0,13,0,-13
4376,1,1,1433,1306,-127
4377,1,1,565,2298,1733
4378,1,1,187,1266,1079
4379,1,0,79,0,-79
4380,1,1,933,1583,650
4381,1,1,73,1571,1498
4382,0,0,2,0,-2
4383,1,1,292,1466,1174
4384,1,1,178,2172,1994
4385,0,0,42,0,-42
4386,1,0,25,0,-25
4387,1,1,910,1366,456
4388,1,1,499,1307,808
4389,1,0,53,0,-53
4390,1,1,1451,1777,326
4391,1,1,485,1236,751
4392,1,1,604,1885,1281
4393,1,0,2,0,-2
4394,0,0,38,0,-38
4395,1,0,18,0,-18
4396,1,0,75,0,-75
4397,1,1,91,1306,1215
4398,0,0,128,0,-128
4399,1,1,476,1425,949
4400,1,0,79,0,-79
4401,1,0,5,0,-5
4402,1,0,210,0,-210
4403,0,0,1,0,-1
4404,0,0,27,0,-27
4405,1,1,326,1428,1102
4406,0,0,5,0,-5
4407,1,0,44,0,-44
4408,1,1,540,1509,969
4409,0,0,3,0,-3
4410,0,0,12,0,-12
4411,1,0,25,0,-25
4412,0,0,8,0,-8
4413,0,0,94,0,-94
4414,1,0,13,0,-13
4415,1,1,755,2345,1590
4416,1,0,56,0,-56
4417,1,1,396,1466,1070
4418,0,0,75,0,-75
4419,1,1,1060,1632,572
4420,1,1,700,1669,969
4421,0,0,45,0,-45
4422,0,0,27,0,-27
4423,1,0,26,0,-26
4424,1,0,32,0,-32
4425,0,0,90,0,-90
4426,1,1,921,1259,338
4427,0,0,74,0,-74
4428,0,0,7,0,-7
4429,0,0,52,0,-52
4430,0,0,6,0,-6
4431,0,0,1,0,-1
4432,1,0,31,0,-31
4433,0,0,25,0,-25
4434,1,0,78,0,-78
4435,0,0,3,0,-3
4436,1,1,236,1596,1360
4437,1,1,1093,1602,509
4438,1,0,47,0,-47
4439,1,0,37,0,-37
4440,1,1,1333,2236,903
4441,1,0,114,0,-114
4442,0,0,107,0,-107
4443,1,0,9,0,-9
4444,0,0,70,0,-70
4445,0,0,21,0,-21
4446,1,1,225,1224,999
4447,1,1,165,2392,2227
4448,1,1,260,1245,985
4449,1,1,939,1212,273
4450,1,1,32,1256,1224
4451,0,0,26,0,-26
4452,1,1,795,2208,1413
4453,1,0,6,0,-6
4454,1,0,27,0,-27
4455,1,0,0,0,0
4456,0,0,19,0,-19
4457,0,0,14,0,-14
4458,1,1,230,3074,2844
4459,1,1,1452,1344,-108
4460,0,0,3,0,-3
4461,1,0,28,0,-28
4462,0,0,34,0,-34
4463,1,1,93,1984,1891
4464,1,0,10,0,-10
4465,1,1,106,1314,1208
4466,0,0,67,0,-67
4467,1,1,548,1802,1254
4468,0,0,6,0,-6
4469,1,1,191,1215,1024
4470,1,1,737,1230,493
4471,0,0,21,0,-21
4472,0,0,29,0,-29
4473,0,0,27,0,-27
4474,1,0,19,0,-19
4475,1,1,399,1413,1014
4476,0,0,32,0,-32
4477,1,1,435,1532,1097
4478,1,0,65,0,-65
4479,0,0,81,0,-81
4480,0,0,37,0,-37
4481,1,1,356,1808,1452
4482,0,0,32,0,-32
4483,1,1,397,4181,3784
4484,1,1,341,1249,908
4485,0,0,291,0,-291
4486,1,0,62,0,-62
4487,1,0,87,0,-87
4488,1,0,16,0,-16
4489,1,1,45,1380,1335
4490,0,0,3,0,-3
4491,1,0,201,0,-201
4492,1,1,266,1351,1085
4493,1,1,906,1311,405
4494,0,0,23,0,-23
4495,1,0,33,0,-33
4496,1,0,18,0,-18
4497,0,0,23,0,-23
4498,1,1,684,1800,1116
4499,0,0,32,0,-32
4500,1,1,635,1421,786
4501,1,1,172,1279,1107
4502,0,0,45,0,-45
4503,1,0,190,0,-190
4504,0,0,107,0,-107
4505,1,0,17,0,-17
4506,1,0,25,0,-25
4507,1,0,14,0,-14
4508,1,1,38,1335,1297
4509,0,0,10,0,-10
4510,1,1,863,1818,955
4511,1,1,771,1208,437
4512,0,0,31,0,-31
4513,1,1,299,1482,1183
4514,1,1,126,1247,1121
4515,1,1,269,1288,1019
4516,1,0,11,0,-11
4517,0,0,36,0,-36
4518,1,0,13,0,-13
4519,1,1,822,1630,808
4520,1,0,128,0,-128
4521,1,0,22,0,-22
4522,1,0,57,0,-57
4523,1,1,849,2143,1294
4524,0,0,39,0,-39
4525,1,0,42,0,-42
4526,1,1,410,1283,873
4527,1,0,23,0,-23
4528,0,0,70,0,-70
4529,1,0,123,0,-123
4530,1,1,479,1774,1295
4531,0,0,160,0,-160
4532,0,0,14,0,-14
4533,1,0,42,0,-42
4534,1,1,227,1247,1020
4535,0,0,80,0,-80
4536,1,0,8,0,-8
4537,0,0,21,0,-21
4538,0,0,6,0,-6
4539,0,0,5,0,-5
4540,0,0,24,0,-24
4541,1,1,406,2375,1969
4542,1,1,151,1407,1256
4543,1,0,12,0,-12
4544,1,0,72,0,-72
4545,1,1,933,2843,1910
4546,0,0,0,0,0
4547,1,0,61,0,-61
4548,1,0,29,0,-29
4549,1,0,106,0,-106
4550,0,0,12,0,-12
4551,0,0,36,0,-36
4552,1,0,52,0,-52
4553,1,0,87,0,-87
4554,0,0,33,0,-33
4555,0,0,128,0,-128
4556,1,1,704,1645,941
4557,1,0,0,0,0
4558,1,0,6,0,-6
4559,0,0,10,0,-10
4560,0,0,0,0,0
4561,1,0,2,0,-2
4562,0,0,10,0,-10
4563,0,0,102,0,-102
4564,1,0,86,0,-86
4565,1,1,35,1908,1873
4566,0,0,84,0,-84
4567,0,0,16,0,-16
4568,1,0,49,0,-49
4569,1,0,42,0,-42
4570,0,0,8,0,-8
4571,1,0,81,0,-81
4572,0,0,28,0,-28
4573,1,0,19,0,-19
4574,1,1,477,2287,1810
4575,1,0,3,0,-3
4576,0,0,30,0,-30
4577,1,0,7,0,-7
4578,1,1,938,1731,793
4579,0,0,8,0,-8
4580,1,1,62,1200,1138
4581,0,0,22,0,-22
4582,1,0,32,0,-32
4583,0,0,15,0,-15
4584,1,0,10,0,-10
4585,1,0,42,0,-42
4586,1,1,169,1226,1057
4587,1,1,824,2389,1565
4588,0,0,4,0,-4
4589,0,0,27,0,-27
4590,1,1,1393,1272,-121
4591,1,1,31,1342,1311
4592,0,0,70,0,-70
4593,1,0,37,0,-37
4594,1,0,2,0,-2
4595,1,1,663,1432,769
4596,0,0,39,0,-39
4597,1,1,468,1269,801
4598,1,0,24,0,-24
4599,0,0,27,0,-27
4600,1,0,83,0,-83
4601,1,1,71,1395,1324
4602,1,1,666,1239,573
4603,0,0,66,0,-66
4604,1,0,4,0,-4
4605,1,1,181,1506,1325
4606,1,0,4,0,-4
4607,1,0,33,0,-33
4608,1,0,26,0,-26
4609,1,0,45,0,-45
4610,1,1,491,1992,1501
4611,1,0,31,0,-31
4612,0,0,305,0,-305
4613,1,0,98,0,-98
4614,0,0,25,0,-25
4615,1,1,597,1213,616
4616,1,1,490,1446,956
4617,1,0,37,0,-37
4618,0,0,112,0,-112
4619,0,0,145,0,-145
4620,1,1,13,1517,1504
4621,1,0,8,0,-8
4622,0,0,177,0,-177
4623,0,0,12,0,-12
4624,1,1,264,1363,1099
4625,0,0,201,0,-201
4626,0,0,7,0,-7
4627,1,0,56,0,-56
4628,0,0,27,0,-27
4629,1,0,13,0,-13
4630,0,0,26,0,-26
4631,1,0,39,0,-39
4632,1,1,293,3258,2965
4633,1,1,1277,1275,-2
4634,0,0,56,0,-56
4635,1,1,302,2133,1831
4636,0,0,24,0,-24
4637,1,0,19,0,-19
4638,1,1,686,1277,591
4639,0,0,120,0,-120
4640,1,1,674,1781,1107
4641,0,0,28,0,-28
4642,1,0,37,0,-37
4643,0,0,0,0,0
4644,1,1,42,1468,1426
4645,1,0,36,0,-36
4646,1,0,6,0,-6
4647,1,1,583,1246,663
4648,1,1,310,1332,1022
4649,0,0,44,0,-44
4650,0,0,14,0,-14
4651,1,1,28,1532,1504
4652,0,0,82,0,-82
4653,1,0,6,0,-6
4654,1,1,750,1706,956
4655,1,0,72,0,-72
4656,0,0,0,0,0
4657,0,0,0,0,0
4658,1,0,44,0,-44
4659,1,0,1,0,-1
4660,1,1,391,1200,809
4661,1,1,242,2205,1963
4662,1,0,140,0,-140
4663,1,1,462,1270,808
4664,0,0,2,0,-2
4665,0,0,10,0,-10
4666,0,0,15,0,-15
4667,1,0,163,0,-163
4668,0,0,27,0,-27
4669,1,1,500,1520,1020
4670,1,1,727,1436,709
4671,1,0,16,0,-16
4672,1,1,181,1214,1033
4673,1,0,22,0,-22
4674,0,0,8,0,-8
4675,0,0,270,0,-270
4676,1,1,939,1359,420
4677,1,0,2,0,-2
4678,1,1,500,4929,4429
4679,1,1,887,2016,1129
4680,1,1,358,1310,952
4681,1,1,591,1557,966
4682,0,0,181,0,-181
4683,1,1,963,2238,1275
4684,1,0,88,0,-88
4685,1,0,159,0,-159
4686,1,1,1162,1457,295
4687,0,0,36,0,-36
4688,0,0,32,0,-32
4689,1,0,159,0,-159
4690,1,0,5,0,-5
4691,0,0,43,0,-43
4692,0,0,36,0,-36
4693,1,1,77,1255,1178
4694,1,1,280,1418,1138
4695,0,0,53,0,-53
4696,1,1,94,1360,1266
4697,1,1,402,1203,801
4698,1,1,463,1629,1166
4699,1,0,18,0,-18
4700,1,0,22,0,-22
4701,1,0,53,0,-53
4702,1,0,6,0,-6
4703,0,0,22,0,-22
4704,0,0,39,0,-39
4705,1,0,63,0,-63
4706,1,1,846,2527,1681
4707,0,0,27,0,-27
4708,1,0,19,0,-19
4709,0,0,25,0,-25
4710,1,0,14,0,-14
4711,1,0,67,0,-67
4712,1,0,18,0,-18
4713,0,0,48,0,-48
4714,1,1,510,1299,789
4715,0,0,141,0,-141
4716,1,0,29,0,-29
4717,1,0,123,0,-123
4718,1,0,46,0,-46
4719,0,0,14,0,-14
4720,1,1,205,1562,1357
4721,1,1,261,1274,1013
4722,0,0,24,0,-24
4723,0,0,67,0,-67
4724,0,0,50,0,-50
4725,1,1,157,1686,1529
4726,1,0,16,0,-16
4727,0,0,0,0,0
4728,1,0,85,0,-85
4729,1,1,226,1318,1092
4730,1,1,984,1576,592
4731,1,1,321,1292,971
4732,0,0,21,0,-21
4733,0,0,100,0,-100
4734,0,0,84,0,-84
4735,1,0,13,0,-13
4736,0,0,151,0,-151
4737,1,0,91,0,-91
4738,1,0,152,0,-152
4739,1,0,11,0,-11
4740,1,0,25,0,-25
4741,1,0,7,0,-7
4742,1,0,15,0,-15
4743,0,0,68,0,-68
4744,1,1,1065,1292,227
4745,0,0,29,0,-29
4746,1,1,136,1468,1332
4747,1,0,102,0,-102
4748,0,0,48,0,-48
4749,0,0,13,0,-13
4750,0,0,55,0,-55
4751,1,0,94,0,-94
4752,1,0,5,0,-5
4753,0,0,23,0,-23
4754,0,0,11,0,-11
4755,0,0,55,0,-55
4756,1,0,17,0,-17
4757,1,1,529,2163,1634
4758,1,0,7,0,-7
4759,0,0,78,0,-78
4760,1,1,243,1286,1043
4761,1,0,26,0,-26
4762,1,1,1412,1221,-191
4763,1,0,2,0,-2
4764,0,0,10,0,-10
4765,1,1,29,1211,1182
4766,1,1,294,1209,915
4767,1,0,100,0,-100
4768,0,0,0,0,0
4769,1,0,65,0,-65
4770,0,0,54,0,-54
4771,0,0,84,0,-84
4772,1,1,90,2053,1963
4773,1,0,20,0,-20
4774,0,0,101,0,-101
4775,1,1,470,1526,1056
4776,1,0,118,0,-118
4777,0,0,38,0,-38
4778,1,1,363,1342,979
4779,1,1,590,1418,828
4780,0,0,113,0,-113
4781,0,0,9,0,-9
4782,1,0,2,0,-2
4783,1,1,759,1475,716
4784,1,1,1163,1606,443
4785,0,0,2,0,-2
4786,1,0,13,0,-13
4787,1,1,328,2781,2453
4788,0,0,24,0,-24
4789,1,0,246,0,-246
4790,1,1,866,1263,397
4791,1,0,60,0,-60
4792,0,0,41,0,-41
4793,1,0,143,0,-143
4794,0,0,10,0,-10
4795,1,1,317,1325,1008
4796,1,0,153,0,-153
4797,0,0,25,0,-25
4798,1,1,369,1601,1232
4799,1,0,20,0,-20
4800,0,0,32,0,-32
4801,0,0,2,0,-2
4802,1,1,188,1396,1208
4803,1,0,46,0,-46
4804,1,1,967,1313,346
4805,1,0,73,0,-73
4806,0,0,26,0,-26
4807,1,0,56,0,-56
4808,0,0,130,0,-130
4809,0,0,47,0,-47
4810,0,0,45,0,-45
4811,0,0,44,0,-44
4812,0,0,43,0,-43
4813,1,0,120,0,-120
4814,1,0,91,0,-91
4815,1,0,64,0,-64
4816,1,0,63,0,-63
4817,1,0,40,0,-40
4818,0,0,20,0,-20
4819,1,1,338,1357,1019
4820,1,1,698,1403,705
4821,1,0,15,0,-15
4822,0,0,4,0,-4
4823,0,0,2,0,-2
4824,0,0,8,0,-8
4825,1,1,346,1406,1060
4826,0,0,54,0,-54
4827,1,0,74,0,-74
4828,1,1,458,1677,1219
4829,1,1,392,1298,906
4830,0,0,5,0,-5
4831,1,1,53,1382,1329
4832,1,1,357,1257,900
4833,0,0,113,0,-113
4834,1,1,2009,2098,89
4835,1,0,1,0,-1
4836,1,1,1288,1399,111
4837,0,0,23,0,-23
4838,1,0,9,0,-9
4839,1,0,58,0,-58
4840,0,0,16,0,-16
4841,0,0,0,0,0
4842,1,1,380,1238,858
4843,0,0,30,0,-30
4844,1,0,38,0,-38
4845,1,1,119,1366,1247
4846,0,0,3,0,-3
4847,0,0,147,0,-147
4848,1,0,40,0,-40
4849,0,0,17,0,-17
4850,0,0,127,0,-127
4851,1,1,110,1486,1376
4852,1,1,318,1307,989
4853,0,0,65,0,-65
4854,1,1,140,1334,1194
4855,1,1,228,1564,1336
4856,0,0,108,0,-108
4857,0,0,53,0,-53
4858,0,0,48,0,-48
4859,1,1,243,1440,1197
4860,1,0,19,0,-19
4861,0,0,45,0,-45
4862,0,0,43,0,-43
4863,1,0,211,0,-211
4864,1,0,72,0,-72
4865,1,1,224,1491,1267
4866,1,1,594,1362,768
4867,0,0,2,0,-2
4868,0,0,3,0,-3
4869,0,0,15,0,-15
4870,1,1,193,1303,1110
4871,1,0,18,0,-18
4872,1,1,272,2745,2473
4873,1,1,1014,1329,315
4874,1,0,25,0,-25
4875,1,1,535,1506,971
4876,0,0,163,0,-163
4877,1,1,315,1250,935
4878,0,0,14,0,-14
4879,1,1,116,1490,1374
4880,1,1,279,1856,1577
4881,0,0,4,0,-4
4882,1,1,101,1215,1114
4883,1,0,90,0,-90
4884,1,0,67,0,-67
4885,0,0,46,0,-46
4886,1,1,318,1308,990
4887,0,0,79,0,-79
4888,0,0,31,0,-31
4889,0,0,22,0,-22
4890,0,0,1,0,-1
4891,0,0,11,0,-11
4892,1,1,1093,1587,494
4893,1,0,35,0,-35
4894,1,1,199,1670,1471
4895,0,0,57,0,-57
4896,1,1,146,1380,1234
4897,1,1,64,1804,1740
4898,0,0,27,0,-27
4899,1,1,543,2639,2096
4900,1,1,506,1289,783
4901,0,0,48,0,-48
4902,1,0,67,0,-67
4903,1,1,762,1292,530
4904,1,1,521,1287,766
4905,1,0,41,0,-41
4906,0,0,76,0,-76
4907,1,0,54,0,-54
4908,0,0,5,0,-5
4909,1,0,33,0,-33
4910,1,1,385,1358,973
4911,0,0,9,0,-9
4912,1,0,45,0,-45
4913,1,1,702,1280,578
4914,1,0,7,0,-7
4915,0,0,2,0,-2
4916,1,0,65,0,-65
4917,1,1,71,1305,1234
4918,0,0,60,0,-60
4919,0,0,40,0,-40
4920,1,0,3,0,-3
4921,1,0,1,0,-1
4922,1,0,11,0,-11
4923,0,0,27,0,-27
4924,1,0,25,0,-25
4925,0,0,14,0,-14
4926,1,1,924,1287,363
4927,1,0,0,0,0
4928,1,0,34,0,-34
4929,0,0,54,0,-54
4930,1,1,326,1293,967
4931,1,0,146,0,-146
4932,1,0,11,0,-11
4933,1,0,25,0,-25
4934,0,0,50,0,-50
4935,1,1,1014,1577,563
4936,1,1,89,1233,1144
4937,1,0,4,0,-4
4938,1,0,0,0,0
4939,0,0,28,0,-28
4940,0,0,45,0,-45
4941,0,0,3,0,-3
4942,0,0,70,0,-70
4943,1,0,6,0,-6
4944,1,0,5,0,-5
4945,0,0,40,0,-40
4946,0,0,26,0,-26
4947,1,0,55,0,-55
4948,1,1,704,1412,708
4949,0,0,28,0,-28
4950,0,0,13,0,-13
4951,1,0,7,0,-7
4952,0,0,31,0,-31
4953,1,1,586,1312,726
4954,0,0,135,0,-135
4955,1,0,7,0,-7
4956,1,1,236,1238,1002
4957,0,0,97,0,-97
4958,0,0,7,0,-7
4959,1,0,16,0,-16
4960,1,1,687,1492,805
4961,0,0,7,0,-7
4962,0,0,51,0,-51
4963,1,0,24,0,-24
4964,1,1,476,2046,1570
4965,0,0,77,0,-77
4966,0,0,11,0,-11
4967,0,0,27,0,-27
4968,1,0,145,0,-145
4969,0,0,13,0,-13
4970,0,0,24,0,-24
4971,0,0,83,0,-83
4972,1,0,33,0,-33
4973,1,0,22,0,-22
4974,0,0,43,0,-43
4975,1,1,197,1317,1120
4976,1,1,684,3561,2877
4977,0,0,12,0,-12
4978,1,1,1199,1292,93
4979,1,1,445,1242,797
4980,1,0,87,0,-87
4981,1,0,47,0,-47
4982,0,0,36,0,-36
4983,1,0,3,0,-3
4984,1,1,1026,1544,518
4985,1,0,15,0,-15
4986,1,0,93,0,-93
4987,0,0,122,0,-122
4988,1,1,814,1304,490
4989,1,1,232,1227,995
4990,1,1,118,2173,2055
4991,0,0,13,0,-13
4992,1,1,683,1361,678
4993,1,1,514,2141,1627
4994,0,0,81,0,-81
4995,1,0,1,0,-1
4996,1,0,40,0,-40
4997,0,0,160,0,-160
4998,0,0,23,0,-23
4999,0,0,49,0,-49
5000,0,0,21,0,-21
5001,0,0,39,0,-39
5002,0,0,126,0,-126
5003,0,0,47,0,-47
5004,1,1,265,1416,1151
5005,0,0,4,0,-4
5006,1,0,6,0,-6
5007,1,1,552,1374,822
5008,0,0,41,0,-41
5009,0,0,1,0,-1
5010,1,0,3,0,-3
5011,0,0,36,0,-36
5012,1,0,214,0,-214
5013,0,0,51,0,-51
5014,1,0,10,0,-10
5015,1,1,141,2482,2341
5016,0,0,49,0,-49
5017,1,0,10,0,-10
5018,0,0,48,0,-48
5019,0,0,108,0,-108
5020,1,1,1848,1872,24
5021,1,0,30,0,-30
5022,1,1,214,1359,1145
5023,1,1,498,1215,717
5024,1,1,608,1213,605
5025,1,0,176,0,-176
5026,0,0,24,0,-24
5027,0,0,12,0,-12
5028,0,0,4,0,-4
5029,1,1,125,1550,1425
5030,1,0,95,0,-95
5031,0,0,72,0,-72
5032,0,0,21,0,-21
5033,1,0,25,0,-25
5034,1,0,3,0,-3
5035,1,1,2015,1266,-749
5036,1,1,748,1984,1236
5037,1,1,401,1501,1100
5038,1,0,9,0,-9
5039,1,0,59,0,-59
5040,1,0,92,0,-92
5041,0,0,4,0,-4
5042,1,1,882,1313,431
5043,1,0,15,0,-15
5044,1,1,18,1303,1285
5045,0,0,63,0,-63
5046,1,1,39,1381,1342
5047,0,0,68,0,-68
5048,1,0,37,0,-37
5049,1,0,25,0,-25
5050,0,0,64,0,-64
5051,0,0,12,0,-12
5052,1,1,584,2121,1537
5053,1,0,74,0,-74
5054,1,1,1555,1438,-117
5055,0,0,57,0,-57
5056,1,1,383,1392,1009
5057,0,0,27,0,-27
5058,0,0,29,0,-29
5059,0,0,1,0,-1
5060,0,0,0,0,0
5061,1,1,483,1666,1183
5062,0,0,134,0,-134
5063,0,0,41,0,-41
5064,1,1,1383,1493,110
5065,0,0,28,0,-28
5066,0,0,6,0,-6
5067,1,1,548,1247,699
5068,1,1,1608,1443,-165
5069,1,0,92,0,-92
5070,1,0,104,0,-104
5071,0,0,11,0,-11
5072,1,1,1153,1286,133
5073,0,0,16,0,-16
5074,1,1,150,1298,1148
5075,1,1,82,2494,2412
5076,1,0,75,0,-75
5077,0,0,28,0,-28
5078,0,0,28,0,-28
5079,1,0,7,0,-7
5080,0,0,65,0,-65
5081,1,0,13,0,-13
5082,0,0,31,0,-31
5083,1,1,755,1276,521
5084,1,1,1199,1226,27
5085,1,1,143,1229,1086
5086,1,1,576,1707,1131
5087,0,0,46,0,-46
5088,1,1,203,1942,1739
5089,0,0,25,0,-25
5090,0,0,47,0,-47
5091,1,0,63,0,-63
5092,1,1,158,1405,1247
5093,0,0,59,0,-59
5094,1,0,26,0,-26
5095,1,1,289,1243,954
5096,1,1,304,1335,1031
5097,0,0,5,0,-5
5098,1,0,13,0,-13
5099,0,0,63,0,-63
5100,1,1,374,1343,969
5101,0,0,34,0,-34
5102,0,0,9,0,-9
5103,0,0,72,0,-72
5104,1,1,677,1263,586
5105,0,0,34,0,-34
5106,0,0,40,0,-40
5107,0,0,18,0,-18
5108,1,1,103,1262,1159
5109,0,0,75,0,-75
5110,1,0,39,0,-39
5111,1,0,22,0,-22
5112,0,0,1,0,-1
5113,1,1,95,1382,1287
5114,0,0,16,0,-16
5115,0,0,34,0,-34
5116,1,1,167,1389,1222
5117,0,0,67,0,-67
5118,0,0,24,0,-24
5119,1,1,561,2057,1496
5120,1,0,32,0,-32
5121,1,0,68,0,-68
5122,0,0,10,0,-10
5123,0,0,34,0,-34
5124,1,0,3,0,-3
5125,1,1,312,1225,913
5126,0,0,22,0,-22
5127,0,0,25,0,-25
5128,1,0,5,0,-5
5129,0,0,1,0,-1
5130,0,0,115,0,-115
5131,1,0,46,0,-46
5132,1,0,38,0,-38
5133,0,0,130,0,-130
5134,1,1,974,1828,854
5135,1,1,380,1528,1148
5136,0,0,6,0,-6
5137,0,0,18,0,-18
5138,0,0,15,0,-15
5139,1,1,1476,3248,1772
5140,0,0,38,0,-38
5141,1,1,117,1777,1660
5142,1,0,16,0,-16
5143,0,0,7,0,-7
5144,1,1,674,1532,858
5145,1,0,12,0,-12
5146,1,0,5,0,-5
5147,1,1,368,1262,894
5148,1,0,6,0,-6
5149,1,0,9,0,-9
5150,0,0,1,0,-1
5151,0,0,6,0,-6
5152,1,1,937,1411,474
5153,0,0,3,0,-3
5154,1,1,1259,1205,-54
5155,0,0,29,0,-29
5156,1,0,27,0,-27
5157,1,0,16,0,-16
5158,1,1,789,1221,432
5159,0,0,10,0,-10
5160,0,0,46,0,-46
5161,1,0,10,0,-10
5162,1,0,20,0,-20
5163,1,0,16,0,-16
5164,0,0,32,0,-32
5165,1,0,5,0,-5
5166,0,0,39,0,-39
5167,1,0,42,0,-42
5168,0,0,55,0,-55
5169,0,0,30,0,-30
5170,0,0,57,0,-57
5171,0,0,48,0,-48
5172,1,1,191,1733,1542
5173,1,1,400,1216,816
5174,1,1,526,1354,828
5175,1,0,60,0,-60
5176,1,0,30,0,-30
5177,0,0,24,0,-24
5178,1,0,46,0,-46
5179,0,0,35,0,-35
5180,1,0,3,0,-3
5181,1,1,361,1727,1366
5182,1,1,119,1366,1247
5183,0,0,15,0,-15
5184,0,0,50,0,-50
5185,1,1,410,1333,923
5186,0,0,56,0,-56
5187,0,0,41,0,-41
5188,1,1,262,1769,1507
5189,0,0,14,0,-14
5190,0,0,92,0,-92
5191,1,1,185,2744,2559
5192,1,1,82,2028,1946
5193,0,0,49,0,-49
5194,0,0,81,0,-81
5195,1,0,12,0,-12
5196,0,0,33,0,-33
5197,1,0,5,0,-5
5198,1,0,8,0,-8
5199,1,1,159,4076,3917
5200,0,0,10,0,-10
5201,0,0,101,0,-101
5202,0,0,2,0,-2
5203,1,0,78,0,-78
5204,0,0,139,0,-139
5205,1,0,24,0,-24
5206,1,0,37,0,-37
5207,0,0,85,0,-85
5208,1,0,103,0,-103
5209,1,0,127,0,-127
5210,0,0,75,0,-75
5211,0,0,79,0,-79
5212,1,1,13,2824,2811
5213,0,0,53,0,-53
5214,1,0,50,0,-50
5215,1,0,20,0,-20
5216,0,0,83,0,-83
5217,0,0,3,0,-3
5218,1,1,252,1219,967
5219,0,0,108,0,-108
5220,0,0,97,0,-97
5221,0,0,65,0,-65
5222,1,0,95,0,-95
5223,1,0,52,0,-52
5224,0,0,27,0,-27
5225,0,0,105,0,-105
5226,0,0,57,0,-57
5227,1,1,288,1818,1530
5228,0,0,139,0,-139
5229,0,0,65,0,-65
5230,0,0,190,0,-190
5231,1,1,37,1431,1394
5232,1,0,24,0,-24
5233,1,1,814,1624,810
5234,1,1,1758,1328,-430
5235,1,0,12,0,-12
5236,1,0,12,0,-12
5237,1,0,47,0,-47
5238,1,1,81,1269,1188
5239,1,0,24,0,-24
5240,1,1,419,1467,1048
5241,1,1,431,1874,1443
5242,0,0,85,0,-85
5243,1,0,72,0,-72
5244,1,1,755,1218,463
5245,1,0,116,0,-116
5246,1,1,86,1533,1447
5247,0,0,15,0,-15
5248,1,1,1046,1244,198
5249,0,0,33,0,-33
5250,0,0,251,0,-251
5251,1,1,434,1445,1011
5252,0,0,27,0,-27
5253,1,0,109,0,-109
5254,1,1,319,1441,1122
5255,0,0,29,0,-29
5256,1,1,1697,1243,-454
5257,1,1,411,2106,1695
5258,1,1,874,1598,724
5259,1,0,15,0,-15
5260,1,1,259,1768,1509
5261,1,0,41,0,-41
5262,1,0,5,0,-5
5263,1,0,67,0,-67
5264,1,1,2200,1339,-861
5265,1,0,42,0,-42
5266,0,0,25,0,-25
5267,1,0,47,0,-47
5268,1,1,819,3729,2910
5269,1,1,360,1234,874
5270,0,0,13,0,-13
5271,1,1,239,1566,1327
5272,0,0,86,0,-86
5273,1,0,31,0,-31
5274,1,0,33,0,-33
5275,1,1,248,1429,1181
5276,1,1,111,1234,1123
5277,1,0,54,0,-54
5278,0,0,12,0,-12
5279,0,0,23,0,-23
5280,1,1,493,1232,739
5281,0,0,3,0,-3
5282,0,0,89,0,-89
5283,1,0,209,0,-209
5284,1,0,86,0,-86
5285,1,0,41,0,-41
5286,1,1,529,1760,1231
5287,1,0,2,0,-2
5288,1,1,398,1687,1289
5289,1,1,437,1219,782
5290,0,0,39,0,-39
5291,0,0,18,0,-18
5292,1,0,103,0,-103
5293,1,1,53,1314,1261
5294,0,0,21,0,-21
5295,1,0,68,0,-68
5296,0,0,28,0,-28
5297,1,0,61,0,-61
5298,1,1,70,1577,1507
5299,0,0,44,0,-44
5300,1,0,73,0,-73
5301,1,1,806,1620,814
5302,0,0,18,0,-18
5303,1,0,68,0,-68
5304,1,1,244,2005,1761
5305,1,0,34,0,-34
5306,0,0,43,0,-43
5307,0,0,77,0,-77
5308,0,0,93,0,-93
5309,0,0,8,0,-8
5310,0,0,17,0,-17
5311,1,0,1,0,-1
5312,1,1,262,1888,1626
5313,0,0,47,0,-47
5314,0,0,3,0,-3
5315,1,1,345,1387,1042
5316,1,1,139,1251,1112
5317,1,1,291,2160,1869
5318,1,1,76,1258,1182
5319,1,0,95,0,-95
5320,1,1,415,3244,2829
5321,1,0,29,0,-29
5322,1,1,505,1456,951
5323,1,0,64,0,-64
5324,0,0,1,0,-1
5325,0,0,86,0,-86
5326,1,0,74,0,-74
5327,0,0,140,0,-140
5328,1,0,14,0,-14
5329,1,0,12,0,-12
5330,0,0,70,0,-70
5331,1,1,1295,1494,199
5332,0,0,63,0,-63
5333,1,1,220,1466,1246
5334,0,0,13,0,-13
5335,0,0,14,0,-14
5336,0,0,103,0,-103
5337,1,0,63,0,-63
5338,1,1,1503,3082,1579
5339,1,0,6,0,-6
5340,1,1,653,1224,571
5341,0,0,49,0,-49
5342,0,0,18,0,-18
5343,0,0,127,0,-127
5344,1,0,41,0,-41
5345,1,0,56,0,-56
5346,1,0,48,0,-48
5347,1,0,13,0,-13
5348,0,0,53,0,-53
5349,0,0,112,0,-112
5350,1,0,12,0,-12
5351,1,1,508,1206,698
5352,1,1,383,1643,1260
5353,1,1,1769,1245,-524
5354,1,0,1,0,-1
5355,1,1,516,1271,755
5356,1,1,439,1522,1083
5357,0,0,31,0,-31
5358,0,0,21,0,-21
5359,0,0,1,0,-1
5360,0,0,58,0,-58
5361,1,1,250,1234,984
5362,1,1,313,1423,1110
5363,1,1,62,1697,1635
5364,0,0,67,0,-67
5365,0,0,27,0,-27
5366,1,1,37,1370,1333
5367,0,0,139,0,-139
5368,1,1,155,1201,1046
5369,0,0,24,0,-24
5370,1,1,223,1285,1062
5371,0,0,6,0,-6
5372,0,0,1,0,-1
5373,1,1,1146,1291,145
5374,1,1,1006,1632,626
5375,1,0,56,0,-56
5376,0,0,105,0,-105
5377,0,0,115,0,-115
5378,1,1,113,1423,1310
5379,1,1,179,1872,1693
5380,1,0,64,0,-64
5381,0,0,6,0,-6
5382,1,0,44,0,-44
5383,0,0,52,0,-52
5384,0,0,46,0,-46
5385,1,0,17,0,-17
5386,1,0,107,0,-107
5387,1,1,703,1409,706
5388,1,0,16,0,-16
5389,1,0,0,0,0
5390,1,0,69,0,-69
5391,0,0,86,0,-86
5392,0,0,21,0,-21
5393,0,0,70,0,-70
5394,1,0,1,0,-1
5395,0,0,71,0,-71
5396,1,0,15,0,-15
5397,1,0,50,0,-50
5398,0,0,18,0,-18
5399,1,0,38,0,-38
5400,1,1,884,1328,444
5401,1,1,495,1519,1024
5402,0,0,3,0,-3
5403,0,0,146,0,-146
5404,1,0,46,0,-46
5405,1,1,842,1889,1047
5406,1,1,368,2243,1875
5407,1,1,53,1546,1493
5408,1,0,203,0,-203
5409,0,0,163,0,-163
5410,1,1,77,2850,2773
5411,1,1,180,1636,1456
5412,1,0,15,0,-15
5413,0,0,14,0,-14
5414,1,0,41,0,-41
5415,1,0,42,0,-42
5416,1,0,17,0,-17
5417,0,0,38,0,-38
5418,0,0,1,0,-1
5419,1,1,719,1383,664
5420,0,0,23,0,-23
5421,1,1,446,1338,892
5422,0,0,17,0,-17
5423,0,0,46,0,-46
5424,1,0,25,0,-25
5425,0,0,35,0,-35
5426,0,0,32,0,-32
5427,1,1,480,1329,849
5428,0,0,24,0,-24
5429,0,0,8,0,-8
5430,1,0,40,0,-40
5431,1,1,78,1435,1357
5432,0,0,6,0,-6
5433,1,0,10,0,-10
5434,0,0,29,0,-29
5435,1,1,170,1388,1218
5436,1,1,179,2248,2069
5437,1,1,965,1388,423
5438,1,0,36,0,-36
5439,1,1,479,1338,859
5440,1,0,11,0,-11
5441,1,0,17,0,-17
5442,0,0,24,0,-24
5443,1,0,16,0,-16
5444,0,0,99,0,-99
5445,0,0,46,0,-46
5446,0,0,33,0,-33
5447,0,0,61,0,-61
5448,1,1,1288,1400,112
5449,1,1,698,3839,3141
5450,1,1,436,1223,787
5451,1,0,83,0,-83
5452,1,0,12,0,-12
5453,1,1,129,1394,1265
5454,0,0,26,0,-26
5455,1,1,988,1260,272
5456,1,1,624,1362,738
5457,0,0,2,0,-2
5458,1,0,226,0,-226
5459,1,1,574,1230,656
5460,0,0,14,0,-14
5461,1,1,326,1318,992
5462,0,0,32,0,-32
5463,1,1,293,1687,1394
5464,1,1,428,2524,2096
5465,1,1,546,1641,1095
5466,0,0,8,0,-8
5467,1,1,269,1404,1135
5468,0,0,23,0,-23
5469,0,0,75,0,-75
5470,0,0,2,0,-2
5471,0,0,16,0,-16
5472,0,0,0,0,0
5473,0,0,39,0,-39
5474,1,1,412,1219,807
5475,1,0,22,0,-22
5476,0,0,23,0,-23
5477,1,0,3,0,-3
5478,0,0,28,0,-28
5479,0,0,1,0,-1
5480,0,0,42,0,-42
5481,1,1,539,1311,772
5482,1,1,1779,1769,-10
5483,1,0,52,0,-52
5484,0,0,88,0,-88
5485,1,0,31,0,-31
5486,1,1,33,1543,1510
5487,0,0,7,0,-7
5488,0,0,1,0,-1
5489,1,1,142,2037,1895
5490,0,0,4,0,-4
5491,0,0,10,0,-10
5492,1,0,1,0,-1
5493,0,0,19,0,-19
5494,1,1,304,1487,1183
5495,0,0,0,0,0
5496,1,0,2,0,-2
5497,1,1,76,1609,1533
5498,0,0,120,0,-120
5499,0,0,40,0,-40
5500,0,0,14,0,-14
5501,1,0,22,0,-22
5502,0,0,94,0,-94
5503,1,0,58,0,-58
5504,0,0,8,0,-8
5505,0,0,46,0,-46
5506,0,0,14,0,-14
5507,1,0,50,0,-50
5508,0,0,47,0,-47
5509,0,0,3,0,-3
5510,1,0,23,0,-23
5511,0,0,137,0,-137
5512,1,1,161,1479,1318
5513,1,0,7,0,-7
5514,1,0,98,0,-98
5515,0,0,43,0,-43
5516,0,0,14,0,-14
5517,0,0,19,0,-19
5518,1,1,716,1201,485
5519,0,0,0,0,0
5520,1,1,82,1274,1192
5521,0,0,66,0,-66
5522,1,1,33,1264,1231
5523,1,0,75,0,-75
5524,0,0,19,0,-19
5525,0,0,39,0,-39
5526,1,0,66,0,-66
5527,1,1,406,1406,1000
5528,1,1,555,1237,682
5529,0,0,130,0,-130
5530,0,0,121,0,-121
5531,0,0,76,0,-76
5532,1,0,65,0,-65
5533,0,0,55,0,-55
5534,0,0,175,0,-175
5535,1,0,20,0,-20
5536,1,0,16,0,-16
5537,1,0,39,0,-39
5538,1,0,12,0,-12
5539,1,0,20,0,-20
5540,1,0,28,0,-28
5541,1,1,123,2090,1967
5542,0,0,9,0,-9
5543,0,0,94,0,-94
5544,0,0,41,0,-41
5545,1,1,143,1562,1419
5546,1,0,42,0,-42
5547,1,1,171,1302,1131
5548,1,1,178,2057,1879
5549,0,0,107,0,-107
5550,1,0,45,0,-45
5551,0,0,69,0,-69
5552,1,0,18,0,-18
5553,0,0,6,0,-6
5554,1,0,127,0,-127
5555,0,0,3,0,-3
5556,1,1,1394,1328,-66
5557,0,0,26,0,-26
5558,1,1,196,1261,1065
5559,1,1,143,1363,1220
5560,0,0,67,0,-67
5561,1,1,361,2148,1787
5562,0,0,6,0,-6
5563,1,1,583,1432,849
5564,0,0,51,0,-51
5565,0,0,70,0,-70
5566,1,1,534,1367,833
5567,1,0,25,0,-25
5568,0,0,67,0,-67
5569,0,0,19,0,-19
5570,1,0,234,0,-234
5571,1,1,201,1239,1038
5572,1,1,620,1412,792
5573,1,0,101,0,-101
5574,1,1,373,1280,907
5575,1,1,1218,3053,1835
5576,0,0,42,0,-42
5577,1,0,67,0,-67
5578,0,0,33,0,-33
5579,1,1,121,1378,1257
5580,1,1,172,2158,1986
5581,0,0,12,0,-12
5582,1,0,54,0,-54
5583,0,0,34,0,-34
5584,1,0,13,0,-13
5585,1,0,4,0,-4
5586,0,0,80,0,-80
5587,1,0,54,0,-54
5588,1,0,44,0,-44
5589,1,1,94,2269,2175
5590,1,1,253,1224,971
5591,0,0,9,0,-9
5592,1,0,8,0,-8
5593,1,0,59,0,-59
5594,1,1,352,1629,1277
5595,1,1,205,1636,1431
5596,0,0,92,0,-92
5597,0,0,32,0,-32
5598,1,1,241,1277,1036
5599,1,1,618,1224,606
5600,0,0,63,0,-63
5601,1,0,22,0,-22
5602,1,1,360,1774,1414
5603,1,0,48,0,-48
5604,1,0,46,0,-46
5605,1,1,645,2092,1447
5606,0,0,74,0,-74
5607,0,0,8,0,-8
5608,1,1,2638,1234,-1404
5609,1,0,3,0,-3
5610,1,0,5,0,-5
5611,1,0,28,0,-28
5612,0,0,140,0,-140
5613,0,0,51,0,-51
5614,1,1,187,1251,1064
5615,0,0,3,0,-3
5616,0,0,35,0,-35
5617,0,0,10,0,-10
5618,1,1,642,1628,986
5619,1,1,699,1291,592
5620,1,1,882,1258,376
5621,1,1,1075,2426,1351
5622,1,0,64,0,-64
5623,1,0,64,0,-64
5624,1,1,163,3276,3113
5625,0,0,46,0,-46
5626,1,0,17,0,-17
5627,1,1,601,1531,930
5628,0,0,6,0,-6
5629,0,0,137,0,-137
5630,1,1,87,1782,1695
5631,1,0,40,0,-40
5632,0,0,20,0,-20
5633,1,1,62,1322,1260
5634,1,1,55,1883,1828
5635,1,0,17,0,-17
5636,1,1,646,1223,577
5637,1,0,10,0,-10
5638,1,1,60,1235,1175
5639,1,0,118,0,-118
5640,1,1,324,1647,1323
5641,1,0,51,0,-51
5642,1,1,770,1241,471
5643,1,1,235,1539,1304
5644,0,0,57,0,-57
5645,0,0,117,0,-117
5646,0,0,20,0,-20
5647,0,0,22,0,-22
5648,1,1,1251,1643,392
5649,1,0,2,0,-2
5650,1,0,10,0,-10
5651,1,1,148,1227,1079
5652,0,0,140,0,-140
5653,1,1,136,1825,1689
5654,0,0,32,0,-32
5655,1,1,475,1662,1187
5656,0,0,35,0,-35
5657,0,0,155,0,-155
5658,1,0,19,0,-19
5659,1,0,11,0,-11
5660,1,0,2,0,-2
5661,1,0,70,0,-70
5662,1,0,1,0,-1
5663,1,1,1650,1248,-402
5664,1,0,7,0,-7
5665,0,0,7,0,-7
5666,0,0,93,0,-93
5667,0,0,29,0,-29
5668,0,0,52,0,-52
5669,0,0,76,0,-76
5670,0,0,94,0,-94
5671,1,0,34,0,-34
5672,0,0,136,0,-136
5673,1,1,343,1281,938
5674,1,1,167,1366,1199
5675,1,1,285,1601,1316
5676,1,0,25,0,-25
5677,1,1,2316,1398,-918
5678,1,0,37,0,-37
5679,0,0,101,0,-101
5680,1,0,21,0,-21
5681,1,1,303,1674,1371
5682,0,0,6,0,-6
5683,0,0,58,0,-58
5684,1,0,7,0,-7
5685,1,0,62,0,-62
5686,0,0,11,0,-11
5687,1,0,31,0,-31
5688,1,0,50,0,-50
5689,1,0,20,0,-20
5690,1,1,790,1805,1015
5691,1,0,115,0,-115
5692,1,1,226,1454,1228
5693,1,1,65,1282,1217
5694,0,0,34,0,-34
5695,1,0,108,0,-108
5696,1,0,47,0,-47
5697,1,0,36,0,-36
5698,0,0,33,0,-33
5699,1,0,87,0,-87
5700,1,1,487,1651,1164
5701,1,0,12,0,-12
5702,1,1,239,1287,1048
5703,0,0,66,0,-66
5704,1,0,19,0,-19
5705,1,0,0,0,0
5706,1,0,13,0,-13
5707,0,0,99,0,-99
5708,1,0,78,0,-78
5709,0,0,38,0,-38
5710,1,0,80,0,-80
5711,1,1,1086,1695,609
5712,1,0,18,0,-18
5713,0,0,10,0,-10
5714,0,0,55,0,-55
5715,0,0,96,0,-96
5716,1,1,2942,1331,-1611
5717,0,0,1,0,-1
5718,1,0,67,0,-67
5719,0,0,78,0,-78
5720,1,0,9,0,-9
5721,0,0,4,0,-4
5722,1,1,319,1657,1338
5723,1,1,258,1598,1340
5724,0,0,19,0,-19
5725,1,1,408,1391,983
5726,0,0,2,0,-2
5727,1,1,199,1413,1214
5728,0,0,13,0,-13
5729,1,0,31,0,-31
5730,1,0,0,0,0
5731,1,1,518,1269,751
5732,1,0,8,0,-8
5733,0,0,14,0,-14
5734,1,0,81,0,-81
5735,0,0,11,0,-11
5736,1,1,129,1333,1204
5737,0,0,1,0,-1
5738,0,0,19,0,-19
5739,1,1,194,1244,1050
5740,0,0,46,0,-46
5741,0,0,53,0,-53
5742,1,1,869,1602,733
5743,1,1,162,1333,1171
5744,0,0,12,0,-12
5745,1,0,126,0,-126
5746,0,0,108,0,-108
5747,1,0,6,0,-6
5748,0,0,78,0,-78
5749,1,1,245,1335,1090
5750,0,0,22,0,-22
5751,0,0,20,0,-20
5752,0,0,87,0,-87
5753,1,1,23,1346,1323
5754,0,0,10,0,-10
5755,0,0,2,0,-2
5756,0,0,26,0,-26
5757,0,0,11,0,-11
5758,0,0,3,0,-3
5759,1,0,14,0,-14
5760,1,0,7,0,-7
5761,0,0,13,0,-13
5762,1,1,155,3768,3613
5763,1,0,26,0,-26
5764,1,1,591,1484,893
5765,1,0,62,0,-62
5766,0,0,106,0,-106
5767,0,0,52,0,-52
5768,1,1,906,1436,530
5769,0,0,149,0,-149
5770,1,0,12,0,-12
5771,1,1,394,1238,844
5772,0,0,99,0,-99
5773,0,0,56,0,-56
5774,1,1,260,1422,1162
5775,1,1,389,1613,1224
5776,0,0,22,0,-22
5777,1,0,78,0,-78
5778,1,0,8,0,-8
5779,1,0,106,0,-106
5780,1,1,343,2229,1886
5781,1,0,16,0,-16
5782,1,1,1334,1404,70
5783,1,1,628,1224,596
5784,1,0,141,0,-141
5785,1,1,597,2003,1406
5786,1,1,2900,1261,-1639
5787,0,0,38,0,-38
5788,0,0,8,0,-8
5789,1,0,122,0,-122
5790,1,0,187,0,-187
5791,0,0,32,0,-32
5792,0,0,30,0,-30
5793,1,1,914,1353,439
5794,1,1,1653,1222,-431
5795,1,0,143,0,-143
5796,0,0,41,0,-41
5797,0,0,2,0,-2
5798,1,0,32,0,-32
5799,1,0,24,0,-24
5800,0,0,69,0,-69
5801,1,0,60,0,-60
5802,0,0,147,0,-147
5803,0,0,113,0,-113
5804,1,0,72,0,-72
5805,1,1,302,2030,1728
5806,0,0,3,0,-3
5807,1,1,242,1227,985
5808,1,0,304,0,-304
5809,1,1,139,1706,1567
5810,0,0,39,0,-39
5811,0,0,37,0,-37
5812,0,0,59,0,-59
5813,1,0,17,0,-17
5814,1,0,38,0,-38
5815,1,0,36,0,-36
5816,1,0,19,0,-19
5817,1,0,22,0,-22
5818,0,0,86,0,-86
5819,1,1,588,1897,1309
5820,1,0,63,0,-63
5821,1,1,847,1514,667
5822,0,0,12,0,-12
5823,1,1,132,1979,1847
5824,1,1,580,1398,818
5825,1,0,43,0,-43
5826,0,0,8,0,-8
5827,0,0,92,0,-92
5828,0,0,1,0,-1
5829,1,1,190,1356,1166
5830,1,0,1,0,-1
5831,0,0,75,0,-75
5832,1,1,729,1524,795
5833,1,1,1118,1589,471
5834,0,0,2,0,-2
5835,1,0,118,0,-118
5836,0,0,12,0,-12
5837,1,0,6,0,-6
5838,0,0,37,0,-37
5839,0,0,29,0,-29
5840,0,0,16,0,-16
5841,1,0,48,0,-48
5842,0,0,34,0,-34
5843,1,1,716,1377,661
5844,0,0,92,0,-92
5845,1,0,81,0,-81
5846,0,0,27,0,-27
5847,1,0,50,0,-50
5848,0,0,23,0,-23
5849,1,0,65,0,-65
5850,0,0,6,0,-6
5851,0,0,10,0,-10
5852,0,0,34,0,-34
5853,1,0,113,0,-113
5854,1,0,35,0,-35
5855,1,1,354,1629,1275
5856,0,0,15,0,-15
5857,0,0,62,0,-62
5858,1,1,326,2983,2657
5859,1,0,46,0,-46
5860,1,1,201,1426,1225
5861,0,0,1,0,-1
5862,1,0,13,0,-13
5863,1,0,17,0,-17
5864,1,0,1,0,-1
5865,1,1,415,1311,896
5866,0,0,4,0,-4
5867,1,0,35,0,-35
5868,0,0,110,0,-110
5869,1,0,18,0,-18
5870,0,0,15,0,-15
5871,1,0,51,0,-51
5872,1,1,310,1321,1011
5873,1,1,998,1522,524
5874,1,0,8,0,-8
5875,0,0,53,0,-53
5876,1,1,238,1311,1073
5877,0,0,26,0,-26
5878,0,0,181,0,-181
5879,1,0,13,0,-13
5880,1,0,1,0,-1
5881,1,0,1,0,-1
5882,0,0,16,0,-16
5883,0,0,8,0,-8
5884,0,0,3,0,-3
5885,1,0,8,0,-8
5886,1,1,268,1543,1275
5887,1,0,31,0,-31
5888,1,0,9,0,-9
5889,1,0,166,0,-166
5890,1,0,24,0,-24
5891,1,1,153,1248,1095
5892,1,1,123,1601,1478
5893,1,1,1980,1216,-764
5894,0,0,56,0,-56
5895,1,0,20,0,-20
5896,1,1,76,1227,1151
5897,1,0,14,0,-14
5898,1,0,10,0,-10
5899,0,0,54,0,-54
5900,0,0,18,0,-18
5901,0,0,75,0,-75
5902,0,0,117,0,-117
5903,0,0,15,0,-15
5904,1,0,0,0,0
5905,1,1,476,1208,732
5906,0,0,23,0,-23
5907,1,1,211,1907,1696
5908,1,0,6,0,-6
5909,1,1,471,1886,1415
5910,1,0,130,0,-130
5911,1,0,77,0,-77
5912,0,0,53,0,-53
5913,1,0,61,0,-61
5914,1,0,37,0,-37
5915,0,0,41,0,-41
5916,1,1,397,1226,829
5917,0,0,55,0,-55
5918,0,0,26,0,-26
5919,0,0,14,0,-14
5920,0,0,89,0,-89
5921,1,0,23,0,-23
5922,0,0,18,0,-18
5923,1,1,1142,1695,553
5924,1,1,565,1857,1292
5925,1,1,311,1652,1341
5926,0,0,70,0,-70
5927,0,0,18,0,-18
5928,0,0,390,0,-390
5929,0,0,66,0,-66
5930,0,0,3,0,-3
5931,0,0,21,0,-21
5932,0,0,95,0,-95
5933,1,0,46,0,-46
5934,1,1,38,1321,1283
5935,1,0,4,0,-4
5936,0,0,1,0,-1
5937,1,0,43,0,-43
5938,1,1,732,1645,913
5939,0,0,4,0,-4
5940,1,0,6,0,-6
5941,1,1,185,1386,1201
5942,1,1,475,1210,735
5943,0,0,14,0,-14
5944,1,0,3,0,-3
5945,1,0,6,0,-6
5946,1,0,10,0,-10
5947,1,0,38,0,-38
5948,1,0,269,0,-269
5949,0,0,102,0,-102
5950,0,0,0,0,0
5951,1,0,20,0,-20
5952,0,0,55,0,-55
5953,1,1,298,1420,1122
5954,0,0,104,0,-104
5955,1,1,885,1544,659
5956,1,1,165,1645,1480
5957,0,0,67,0,-67
5958,1,1,651,1302,651
5959,1,0,42,0,-42
5960,0,0,39,0,-39
5961,1,1,1001,1383,382
5962,1,0,52,0,-52
5963,1,1,492,1213,721
5964,1,0,85,0,-85
5965,0,0,35,0,-35
5966,1,1,142,1668,1526
5967,0,0,1,0,-1
5968,1,0,3,0,-3
5969,1,0,6,0,-6
5970,1,1,498,1546,1048
5971,1,1,1742,1436,-306
5972,1,1,504,1250,746
5973,1,0,116,0,-116
5974,1,0,19,0,-19
5975,1,1,918,1249,331
5976,1,1,401,1353,952
5977,1,0,47,0,-47
5978,1,0,19,0,-19
5979,1,0,60,0,-60
5980,1,0,17,0,-17
5981,0,0,0,0,0
5982,1,0,10,0,-10
5983,1,0,140,0,-140
5984,1,0,22,0,-22
5985,0,0,8,0,-8
5986,0,0,45,0,-45
5987,0,0,238,0,-238
5988,0,0,0,0,0
5989,0,0,4,0,-4
5990,0,0,46,0,-46
5991,1,0,25,0,-25
5992,1,0,143,0,-143
5993,1,1,1201,1281,80
5994,0,0,2,0,-2
5995,1,0,13,0,-13
5996,1,1,1312,1479,167
5997,1,1,204,1489,1285
5998,0,0,23,0,-23
5999,1,1,646,1488,842
6000,1,0,37,0,-37
6001,0,0,49,0,-49
6002,0,0,64,0,-64
6003,0,0,36,0,-36
6004,0,0,9,0,-9
6005,1,0,80,0,-80
6006,1,1,536,1288,752
6007,0,0,2,0,-2
6008,0,0,102,0,-102
6009,1,0,43,0,-43
6010,0,0,93,0,-93
6011,1,0,37,0,-37
6012,0,0,0,0,0
6013,0,0,9,0,-9
6014,0,0,48,0,-48
6015,1,0,34,0,-34
6016,0,0,95,0,-95
6017,0,0,23,0,-23
6018,1,0,8,0,-8
6019,1,1,1126,2378,1252
6020,1,1,2425,1529,-896
6021,0,0,5,0,-5
6022,1,0,13,0,-13
6023,1,0,118,0,-118
6024,1,0,38,0,-38
6025,0,0,13,0,-13
6026,1,1,224,1320,1096
6027,0,0,15,0,-15
6028,0,0,20,0,-20
6029,0,0,235,0,-235
6030,0,0,126,0,-126
6031,1,1,814,1645,831
6032,1,1,925,3159,2234
6033,0,0,150,0,-150
6034,1,0,70,0,-70
6035,1,1,763,1432,669
6036,1,1,305,1448,1143
6037,0,0,89,0,-89
6038,1,1,185,1313,1128
6039,1,1,1070,1608,538
6040,1,1,471,1391,920
6041,1,1,272,1206,934
6042,1,0,18,0,-18
6043,1,1,813,1840,1027
6044,0,0,92,0,-92
6045,1,1,76,1270,1194
6046,0,0,138,0,-138
6047,1,1,1599,1907,308
6048,1,0,26,0,-26
6049,1,1,1345,1971,626
6050,1,1,436,2397,1961
6051,1,1,201,5429,5228
6052,1,1,164,4643,4479
6053,0,0,19,0,-19
6054,1,1,234,1491,1257
6055,0,0,97,0,-97
6056,0,0,4,0,-4
6057,0,0,46,0,-46
6058,1,1,137,1275,1138
6059,0,0,111,0,-111
6060,0,0,14,0,-14
6061,1,0,41,0,-41
6062,1,0,9,0,-9
6063,0,0,27,0,-27
6064,1,1,960,1707,747
6065,1,1,976,2788,1812
6066,1,1,507,1467,960
6067,1,0,9,0,-9
6068,0,0,165,0,-165
6069,1,0,29,0,-29
6070,0,0,3,0,-3
6071,0,0,52,0,-52
6072,1,0,1,0,-1
6073,0,0,65,0,-65
6074,1,0,21,0,-21
6075,1,1,254,1971,1717
6076,1,0,31,0,-31
6077,0,0,19,0,-19
6078,0,0,45,0,-45
6079,0,0,19,0,-19
6080,1,1,656,1234,578
6081,0,0,23,0,-23
6082,1,1,516,1529,1013
6083,1,1,419,1577,1158
6084,1,1,11,3138,3127
6085,1,0,84,0,-84
6086,1,1,542,1277,735
6087,0,0,27,0,-27
6088,0,0,80,0,-80
6089,1,1,955,1253,298
6090,1,1,512,1212,700
6091,0,0,172,0,-172
6092,0,0,55,0,-55
6093,1,1,142,1390,1248
6094,0,0,6,0,-6
6095,1,1,353,1524,1171
6096,0,0,156,0,-156
6097,1,1,1115,2986,1871
6098,1,1,938,1775,837
6099,1,0,3,0,-3
6100,1,0,4,0,-4
6101,1,0,54,0,-54
6102,0,0,52,0,-52
6103,1,1,419,1225,806
6104,1,0,15,0,-15
6105,1,1,823,1242,419
6106,0,0,14,0,-14
6107,0,0,20,0,-20
6108,0,0,114,0,-114
6109,1,1,636,1229,593
6110,1,1,119,1444,1325
6111,0,0,54,0,-54
6112,1,1,213,1309,1096
6113,0,0,100,0,-100
6114,0,0,78,0,-78
6115,0,0,36,0,-36
6116,0,0,65,0,-65
6117,1,0,7,0,-7
6118,1,0,3,0,-3
6119,1,0,9,0,-9
6120,1,1,988,1333,345
6121,0,0,159,0,-159
6122,0,0,136,0,-136
6123,1,1,347,1217,870
6124,0,0,105,0,-105
6125,1,0,28,0,-28
6126,1,0,75,0,-75
6127,1,1,62,1205,1143
6128,1,1,66,1397,1331
6129,1,0,177,0,-177
6130,0,0,8,0,-8
6131,1,1,62,1411,1349
6132,1,1,310,1226,916
6133,0,0,26,0,-26
6134,1,0,110,0,-110
6135,1,1,520,1215,695
6136,1,1,183,1263,1080
6137,0,0,14,0,-14
6138,1,0,13,0,-13
6139,1,1,2288,1244,-1044
6140,0,0,32,0,-32
6141,1,0,4,0,-4
6142,1,1,291,1461,1170
6143,1,1,558,1299,741
6144,1,0,22,0,-22
6145,1,1,1233,1222,-11
6146,1,0,62,0,-62
6147,1,0,73,0,-73
6148,1,1,498,1299,801
6149,1,1,1182,1211,29
6150,1,0,18,0,-18
6151,0,0,29,0,-29
6152,0,0,74,0,-74
6153,1,0,40,0,-40
6154,1,1,1157,1226,69
6155,0,0,96,0,-96
6156,0,0,39,0,-39
6157,1,1,2240,2535,295
6158,1,0,33,0,-33
6159,1,1,122,1334,1212
6160,1,0,27,0,-27
6161,0,0,34,0,-34
6162,0,0,4,0,-4
6163,1,1,110,2144,2034
6164,1,0,51,0,-51
6165,1,1,874,1509,635
6166,0,0,57,0,-57
6167,0,0,34,0,-34
6168,1,1,1085,1260,175
6169,0,0,37,0,-37
6170,0,0,107,0,-107
6171,1,1,49,1542,1493
6172,0,0,240,0,-240
6173,1,0,115,0,-115
6174,1,0,18,0,-18
6175,1,1,1566,1947,381
6176,1,0,76,0,-76
6177,0,0,22,0,-22
6178,1,1,1954,1218,-736
6179,1,0,225,0,-225
6180,1,0,36,0,-36
6181,0,0,52,0,-52
6182,0,0,1,0,-1
6183,1,0,31,0,-31
6184,1,1,340,1424,1084
6185,1,0,60,0,-60
6186,1,0,33,0,-33
6187,0,0,69,0,-69
6188,1,0,75,0,-75
6189,0,0,62,0,-62
6190,1,1,1290,1870,580
6191,0,0,28,0,-28
6192,0,0,111,0,-111
6193,0,0,39,0,-39
6194,0,0,9,0,-9
6195,1,1,138,1589,1451
6196,0,0,27,0,-27
6197,1,1,120,2691,2571
6198,0,0,8,0,-8
6199,1,1,387,1954,1567
6200,1,0,82,0,-82
6201,1,0,38,0,-38
6202,1,1,91,1498,1407
6203,1,1,191,1206,1015
6204,1,0,20,0,-20
6205,0,0,56,0,-56
6206,1,0,27,0,-27
6207,1,1,151,1240,1089
6208,1,1,24,1205,1181
6209,0,0,30,0,-30
6210,0,0,57,0,-57
6211,1,1,923,1246,323
6212,0,0,46,0,-46
6213,1,1,583,1305,722
6214,1,0,89,0,-89
6215,0,0,86,0,-86
6216,1,0,28,0,-28
6217,1,0,57,0,-57
6218,1,0,51,0,-51
6219,1,1,280,1294,1014
6220,0,0,15,0,-15
6221,1,1,432,1274,842
6222,0,0,24,0,-24
6223,1,1,433,1442,1009
6224,0,0,9,0,-9
6225,1,1,215,1542,1327
6226,0,0,35,0,-35
6227,1,1,539,1300,761
6228,1,0,15,0,-15
6229,1,1,955,1418,463
6230,1,1,583,1517,934
6231,1,0,45,0,-45
6232,1,1,676,1378,702
6233,0,0,26,0,-26
6234,1,0,49,0,-49
6235,1,1,814,2280,1466
6236,1,0,20,0,-20
6237,1,1,1249,1334,85
6238,1,1,180,1350,1170
6239,0,0,20,0,-20
6240,0,0,11,0,-11
6241,1,1,408,1367,959
6242,1,1,68,1578,1510
6243,0,0,28,0,-28
6244,1,1,809,1330,521
6245,1,1,267,1724,1457
6246,1,1,708,1205,497
6247,1,1,119,1609,1490
6248,1,0,55,0,-55
6249,1,1,296,1589,1293
6250,1,0,11,0,-11
6251,1,0,14,0,-14
6252,0,0,65,0,-65
6253,1,0,7,0,-7
6254,1,0,41,0,-41
6255,0,0,7,0,-7
6256,0,0,20,0,-20
6257,1,1,589,1207,618
6258,1,0,31,0,-31
6259,0,0,237,0,-237
6260,1,0,46,0,-46
6261,1,1,179,1541,1362
6262,1,1,433,1277,844
6263,0,0,5,0,-5
6264,0,0,9,0,-9
6265,1,1,135,1208,1073
6266,1,1,336,1255,919
6267,1,1,73,1209,1136
6268,0,0,50,0,-50
6269,1,1,1113,1829,716
6270,0,0,18,0,-18
6271,1,0,61,0,-61
6272,0,0,66,0,-66
6273,1,0,22,0,-22
6274,0,0,152,0,-152
6275,1,1,764,1333,569
6276,0,0,73,0,-73
6277,0,0,169,0,-169
6278,0,0,19,0,-19
6279,0,0,73,0,-73
6280,1,1,106,1270,1164
6281,0,0,12,0,-12
6282,1,0,60,0,-60
6283,1,0,69,0,-69
6284,1,0,25,0,-25
6285,0,0,10,0,-10
6286,0,0,46,0,-46
6287,0,0,31,0,-31
6288,1,0,15,0,-15
6289,1,1,65,1242,1177
6290,1,0,33,0,-33
6291,1,1,1261,2432,1171
6292,0,0,47,0,-47
6293,1,0,1,0,-1
6294,1,0,127,0,-127
6295,1,1,313,1411,1098
6296,1,1,427,2196,1769
6297,0,0,57,0,-57
6298,1,1,200,1346,1146
6299,1,1,242,1335,1093
6300,1,0,144,0,-144
6301,1,0,8,0,-8
6302,1,1,334,1297,963
6303,0,0,21,0,-21
6304,0,0,10,0,-10
6305,0,0,115,0,-115
6306,1,0,28,0,-28
6307,1,1,709,1764,1055
6308,1,0,11,0,-11
6309,1,1,316,3120,2804
6310,1,0,21,0,-21
6311,1,0,0,0,0
6312,0,0,11,0,-11
6313,1,1,136,1201,1065
6314,1,1,482,2148,1666
6315,1,0,22,0,-22
6316,0,0,25,0,-25
6317,0,0,85,0,-85
6318,1,0,85,0,-85
6319,0,0,4,0,-4
6320,1,0,19,0,-19
6321,0,0,31,0,-31
6322,1,0,209,0,-209
6323,1,0,72,0,-72
6324,1,0,0,0,0
6325,1,0,14,0,-14
6326,0,0,0,0,0
6327,0,0,2,0,-2
6328,1,0,20,0,-20
6329,1,1,517,1910,1393
6330,0,0,64,0,-64
6331,1,1,132,1434,1302
6332,0,0,50,0,-50
6333,1,0,202,0,-202
6334,1,0,36,0,-36
6335,1,1,702,1319,617
6336,1,1,398,1275,877
6337,1,1,192,1220,1028
6338,0,0,59,0,-59
6339,1,0,10,0,-10
6340,1,0,21,0,-21
6341,1,0,30,0,-30
6342,0,0,65,0,-65
6343,1,1,218,1320,1102
6344,1,1,81,1397,1316
6345,0,0,13,0,-13
6346,0,0,139,0,-139
6347,1,1,332,2129,1797
6348,0,0,31,0,-31
6349,0,0,16,0,-16
6350,1,0,10,0,-10
6351,0,0,10,0,-10
6352,0,0,69,0,-69
6353,1,1,165,1215,1050
6354,1,1,911,1219,308
6355,1,0,22,0,-22
6356,0,0,52,0,-52
6357,1,1,620,1364,744
6358,1,1,52,1284,1232
6359,0,0,20,0,-20
6360,0,0,34,0,-34
6361,1,0,65,0,-65
6362,1,1,256,1788,1532
6363,1,1,387,1210,823
6364,1,1,369,1265,896
6365,1,0,6,0,-6
6366,0,0,7,0,-7
6367,0,0,105,0,-105
6368,1,0,37,0,-37
6369,0,0,43,0,-43
6370,1,0,7,0,-7
6371,1,0,3,0,-3
6372,1,0,36,0,-36
6373,1,1,929,1219,290
6374,0,0,111,0,-111
6375,0,0,4,0,-4
6376,1,0,23,0,-23
6377,0,0,43,0,-43
6378,1,0,39,0,-39
6379,0,0,178,0,-178
6380,1,1,800,1783,983
6381,0,0,100,0,-100
6382,1,0,59,0,-59
6383,0,0,36,0,-36
6384,0,0,29,0,-29
6385,0,0,20,0,-20
6386,1,0,4,0,-4
6387,0,0,22,0,-22
6388,1,0,44,0,-44
6389,1,1,1468,1275,-193
6390,1,1,309,1336,1027
6391,0,0,130,0,-130
6392,1,1,1099,1292,193
6393,0,0,180,0,-180
6394,0,0,72,0,-72
6395,1,0,42,0,-42
6396,1,0,20,0,-20
6397,1,0,60,0,-60
6398,0,0,66,0,-66
6399,1,1,521,1312,791
6400,1,1,1583,1301,-282
6401,0,0,1,0,-1
6402,1,0,0,0,0
6403,1,0,50,0,-50
6404,1,1,183,1356,1173
6405,0,0,108,0,-108
6406,0,0,69,0,-69
6407,1,0,45,0,-45
6408,1,0,22,0,-22
6409,1,0,6,0,-6
6410,1,0,156,0,-156
6411,1,0,97,0,-97
6412,1,1,91,1260,1169
6413,1,1,142,1329,1187
6414,1,0,43,0,-43
6415,1,1,177,1383,1206
6416,1,1,385,1343,958
6417,1,0,43,0,-43
6418,1,0,49,0,-49
6419,0,0,89,0,-89
6420,1,1,111,1530,1419
6421,1,0,30,0,-30
6422,1,0,28,0,-28
6423,1,0,76,0,-76
6424,0,0,99,0,-99
6425,1,1,281,2107,1826
6426,0,0,18,0,-18
6427,0,0,4,0,-4
6428,1,0,21,0,-21
6429,1,1,561,1684,1123
6430,1,1,608,1670,1062
6431,1,0,121,0,-121
6432,1,1,30,1456,1426
6433,0,0,24,0,-24
6434,1,1,960,1243,283
6435,1,1,884,1211,327
6436,0,0,94,0,-94
6437,1,0,47,0,-47
6438,1,0,1,0,-1
6439,0,0,15,0,-15
6440,1,1,131,1370,1239
6441,0,0,22,0,-22
6442,1,1,347,1490,1143
6443,1,1,1051,1384,333
6444,1,0,5,0,-5
6445,0,0,1,0,-1
6446,0,0,67,0,-67
6447,1,0,212,0,-212
6448,0,0,34,0,-34
6449,1,0,190,0,-190
6450,1,1,413,2351,1938
6451,0,0,1,0,-1
6452,1,0,20,0,-20
6453,0,0,11,0,-11
6454,0,0,1,0,-1
6455,1,1,566,1486,920
6456,1,0,99,0,-99
6457,1,0,16,0,-16
6458,0,0,7,0,-7
6459,0,0,90,0,-90
6460,0,0,26,0,-26
6461,1,0,85,0,-85
6462,1,1,732,1522,790
6463,1,0,35,0,-35
6464,0,0,9,0,-9
6465,1,1,356,1360,1004
6466,0,0,14,0,-14
6467,0,0,53,0,-53
6468,1,1,445,1307,862
6469,1,0,19,0,-19
6470,1,0,57,0,-57
6471,1,0,46,0,-46
6472,0,0,124,0,-124
6473,0,0,23,0,-23
6474,1,0,18,0,-18
6475,0,0,28,0,-28
6476,0,0,39,0,-39
6477,0,0,4,0,-4
6478,1,1,1571,1805,234
6479,0,0,101,0,-101
6480,0,0,6,0,-6
6481,1,1,58,1679,1621
6482,1,0,59,0,-59
6483,1,1,127,1558,1431
6484,0,0,41,0,-41
6485,1,1,1375,1246,-129
6486,0,0,52,0,-52
6487,1,0,39,0,-39
6488,1,1,212,1791,1579
6489,0,0,4,0,-4
6490,1,0,5,0,-5
6491,0,0,67,0,-67
6492,1,0,16,0,-16
6493,1,0,39,0,-39
6494,0,0,18,0,-18
6495,0,0,45,0,-45
6496,1,0,20,0,-20
6497,1,1,1770,1597,-173
6498,1,0,95,0,-95
6499,1,0,5,0,-5
6500,0,0,49,0,-49
6501,1,0,25,0,-25
6502,1,1,776,1667,891
6503,1,0,90,0,-90
6504,1,1,780,9014,8234
6505,0,0,1,0,-1
6506,0,0,49,0,-49
6507,1,0,37,0,-37
6508,0,0,14,0,-14
6509,1,0,28,0,-28
6510,1,0,176,0,-176
6511,1,0,30,0,-30
6512,1,1,329,1656,1327
6513,0,0,53,0,-53
6514,1,1,113,1430,1317
6515,0,0,38,0,-38
6516,1,0,39,0,-39
6517,1,1,547,1920,1373
6518,1,1,226,1321,1095
6519,1,0,2,0,-2
6520,1,1,820,1225,405
6521,1,0,17,0,-17
6522,1,1,715,1558,843
6523,1,1,527,1420,893
6524,1,1,101,1289,1188
6525,1,1,447,1231,784
6526,0,0,8,0,-8
6527,1,1,849,1482,633
6528,0,0,40,0,-40
6529,0,0,74,0,-74
6530,0,0,85,0,-85
6531,1,1,266,1366,1100
6532,1,1,385,1279,894
6533,1,1,613,1457,844
6534,1,0,38,0,-38
6535,1,0,21,0,-21
6536,1,0,26,0,-26
6537,1,1,305,1267,962
6538,1,0,78,0,-78
6539,1,1,200,2016,1816
6540,1,1,1536,1945,409
6541,1,0,16,0,-16
6542,1,0,130,0,-130
6543,1,1,811,1628,817
6544,1,1,567,1708,1141
6545,1,1,682,2221,1539
6546,1,0,10,0,-10
6547,1,1,1063,1208,145
6548,1,1,542,1420,878
6549,1,1,320,1784,1464
6550,0,0,78,0,-78
6551,1,1,905,2253,1348
6552,0,0,85,0,-85
6553,0,0,84,0,-84
6554,0,0,32,0,-32
6555,1,1,513,1394,881
6556,1,1,460,1303,843
6557,0,0,20,0,-20
6558,0,0,76,0,-76
6559,1,1,213,1386,1173
6560,0,0,17,0,-17
6561,1,1,1441,1248,-193
6562,0,0,17,0,-17
6563,1,1,610,1257,647
6564,1,0,168,0,-168
6565,1,0,4,0,-4
6566,1,0,6,0,-6
6567,0,0,7,0,-7
6568,1,1,642,1219,577
6569,1,0,7,0,-7
6570,0,0,67,0,-67
6571,0,0,25,0,-25
6572,0,0,43,0,-43
6573,1,0,42,0,-42
6574,0,0,64,0,-64
6575,1,0,24,0,-24
6576,1,1,962,1531,569
6577,1,0,36,0,-36
6578,1,1,714,1857,1143
6579,1,0,19,0,-19
6580,1,0,51,0,-51
6581,0,0,1,0,-1
6582,0,0,12,0,-12
6583,0,0,7,0,-7
6584,0,0,9,0,-9
6585,1,1,282,1541,1259
6586,1,0,8,0,-8
6587,1,0,70,0,-70
6588,0,0,22,0,-22
6589,1,1,1367,1538,171
6590,1,1,808,2144,1336
6591,1,0,11,0,-11
6592,1,1,510,2302,1792
6593,0,0,63,0,-63
6594,1,0,34,0,-34
6595,0,0,23,0,-23
6596,1,1,739,2127,1388
6597,1,0,88,0,-88
6598,0,0,15,0,-15
6599,0,0,26,0,-26
6600,1,1,482,1413,931
6601,1,1,75,1508,1433
6602,0,0,58,0,-58
6603,1,1,89,1211,1122
6604,1,1,303,1230,927
6605,1,0,17,0,-17
6606,1,1,126,1687,1561
6607,1,1,781,1374,593
6608,1,1,176,1488,1312
6609,1,0,4,0,-4
6610,0,0,9,0,-9
6611,1,0,23,0,-23
6612,0,0,46,0,-46
6613,1,0,32,0,-32
6614,1,1,3140,1776,-1364
6615,1,1,299,1798,1499
6616,1,0,208,0,-208
6617,1,1,475,1520,1045
6618,1,0,100,0,-100
6619,1,0,153,0,-153
6620,0,0,6,0,-6
6621,1,0,37,0,-37
6622,0,0,34,0,-34
6623,1,1,791,3294,2503
6624,0,0,5,0,-5
6625,1,1,168,1204,1036
6626,1,0,36,0,-36
6627,1,0,11,0,-11
6628,1,1,580,2091,1511
6629,1,0,69,0,-69
6630,1,0,124,0,-124
6631,0,0,70,0,-70
6632,0,0,22,0,-22
6633,1,0,27,0,-27
6634,0,0,49,0,-49
6635,0,0,32,0,-32
6636,1,1,450,2392,1942
6637,1,1,50,1932,1882
6638,0,0,29,0,-29
6639,1,0,7,0,-7
6640,1,1,402,1330,928
6641,1,0,66,0,-66
6642,0,0,41,0,-41
6643,0,0,23,0,-23
6644,1,0,39,0,-39
6645,0,0,245,0,-245
6646,1,1,230,1285,1055
6647,1,1,343,1270,927
6648,0,0,8,0,-8
6649,0,0,16,0,-16
6650,1,0,48,0,-48
6651,0,0,215,0,-215
6652,1,1,761,2368,1607
6653,0,0,13,0,-13
6654,1,1,1702,1204,-498
6655,1,0,1,0,-1
6656,1,0,22,0,-22
6657,0,0,27,0,-27
6658,0,0,45,0,-45
6659,1,0,16,0,-16
6660,0,0,24,0,-24
6661,1,1,612,1389,777
6662,1,1,213,1232,1019
6663,1,1,700,1246,546
6664,0,0,27,0,-27
6665,0,0,11,0,-11
6666,1,0,84,0,-84
6667,1,0,94,0,-94
6668,0,0,32,0,-32
6669,0,0,36,0,-36
6670,1,1,600,1316,716
6671,0,0,88,0,-88
6672,0,0,5,0,-5
6673,0,0,21,0,-21
6674,0,0,59,0,-59
6675,1,0,17,0,-17
6676,1,1,521,1265,744
6677,1,0,4,0,-4
6678,0,0,78,0,-78
6679,0,0,75,0,-75
6680,1,0,31,0,-31
6681,0,0,64,0,-64
6682,1,1,59,1394,1335
6683,1,0,125,0,-125
6684,1,0,48,0,-48
6685,1,1,2325,1689,-636
6686,1,1,1836,1205,-631
6687,0,0,8,0,-8
6688,1,0,8,0,-8
6689,0,0,87,0,-87
6690,1,0,61,0,-61
6691,1,0,90,0,-90
6692,0,0,9,0,-9
6693,0,0,26,0,-26
6694,0,0,59,0,-59
6695,0,0,11,0,-11
6696,0,0,6,0,-6
6697,1,1,862,1472,610
6698,1,1,208,1284,1076
6699,1,0,45,0,-45
6700,1,0,18,0,-18
6701,1,0,128,0,-128
6702,1,0,22,0,-22
6703,0,0,150,0,-150
6704,0,0,39,0,-39
6705,0,0,21,0,-21
6706,0,0,22,0,-22
6707,1,1,315,1251,936
6708,1,0,19,0,-19
6709,0,0,23,0,-23
6710,1,0,0,0,0
6711,1,1,618,1563,945
6712,1,1,823,1878,1055
6713,1,0,71,0,-71
6714,1,1,204,1682,1478
6715,1,0,20,0,-20
6716,1,0,0,0,0
6717,1,0,110,0,-110
6718,1,1,459,1383,924
6719,0,0,29,0,-29
6720,1,1,672,1578,906
6721,1,1,1079,1280,201
6722,1,1,110,1300,1190
6723,1,1,1571,1810,239
6724,1,0,121,0,-121
6725,1,1,1404,1229,-175
6726,0,0,85,0,-85
6727,1,1,303,1320,1017
6728,0,0,44,0,-44
6729,1,0,13,0,-13
6730,0,0,43,0,-43
6731,1,1,944,1572,628
6732,0,0,118,0,-118
6733,1,0,13,0,-13
6734,1,1,297,1274,977
6735,1,1,975,1789,814
6736,0,0,1,0,-1
6737,1,0,25,0,-25
6738,1,1,806,1893,1087
6739,0,0,22,0,-22
6740,0,0,94,0,-94
6741,1,0,57,0,-57
6742,1,0,134,0,-134
6743,1,1,783,1206,423
6744,0,0,27,0,-27
6745,0,0,18,0,-18
6746,1,0,91,0,-91
6747,0,0,42,0,-42
6748,1,1,42,1209,1167
6749,0,0,4,0,-4
6750,1,0,19,0,-19
6751,0,0,47,0,-47
6752,1,0,90,0,-90
6753,0,0,95,0,-95
6754,0,0,1,0,-1
6755,1,0,19,0,-19
6756,0,0,23,0,-23
6757,1,0,77,0,-77
6758,1,0,29,0,-29
6759,1,1,948,2181,1233
6760,1,1,164,1229,1065
6761,0,0,278,0,-278
6762,1,1,1453,1224,-229
6763,0,0,16,0,-16
6764,0,0,15,0,-15
6765,0,0,3,0,-3
6766,1,1,334,1935,1601
6767,1,0,42,0,-42
6768,1,0,84,0,-84
6769,1,1,91,4636,4545
6770,1,1,881,1471,590
6771,0,0,19,0,-19
6772,1,0,70,0,-70
6773,0,0,29,0,-29
6774,1,0,16,0,-16
6775,1,0,83,0,-83
6776,0,0,14,0,-14
6777,0,0,53,0,-53
6778,1,1,1205,1345,140
6779,1,0,143,0,-143
6780,1,0,16,0,-16
6781,0,0,23,0,-23
6782,1,1,602,3658,3056
6783,1,0,11,0,-11
6784,0,0,21,0,-21
6785,1,1,359,1229,870
6786,1,1,518,1271,753
6787,1,1,471,1368,897
6788,0,0,0,0,0
6789,1,1,109,1356,1247
6790,0,0,1,0,-1
6791,0,0,32,0,-32
6792,0,0,96,0,-96
6793,1,0,42,0,-42
6794,0,0,2,0,-2
6795,1,1,770,2909,2139
6796,1,0,65,0,-65
6797,0,0,40,0,-40
6798,1,1,119,1211,1092
6799,1,0,4,0,-4
6800,1,0,51,0,-51
6801,1,0,0,0,0
6802,1,1,483,1545,1062
6803,1,1,962,1530,568
6804,1,1,522,1523,1001
6805,1,1,52,1952,1900
6806,1,1,440,1762,1322
6807,1,0,119,0,-119
6808,1,1,298,1845,1547
6809,1,1,1154,1212,58
6810,1,0,20,0,-20
6811,1,0,25,0,-25
6812,0,0,18,0,-18
6813,0,0,82,0,-82
6814,1,0,18,0,-18
6815,1,1,517,1527,1010
6816,1,1,62,1694,1632
6817,1,1,204,1632,1428
6818,0,0,40,0,-40
6819,0,0,66,0,-66
6820,1,0,79,0,-79
6821,1,0,22,0,-22
6822,0,0,3,0,-3
6823,1,1,602,1675,1073
6824,1,1,983,1353,370
6825,0,0,126,0,-126
6826,0,0,7,0,-7
6827,1,1,164,1515,1351
6828,1,1,379,1239,860
6829,1,1,255,1280,1025
6830,0,0,116,0,-116
6831,1,1,270,1421,1151
6832,0,0,91,0,-91
6833,0,0,40,0,-40
6834,0,0,2,0,-2
6835,1,0,117,0,-117
6836,1,1,65,2299,2234
6837,0,0,111,0,-111
6838,1,1,119,1223,1104
6839,1,0,18,0,-18
6840,1,1,60,4562,4502
6841,0,0,194,0,-194
6842,1,1,440,1315,875
6843,0,0,62,0,-62
6844,0,0,32,0,-32
6845,1,1,93,1396,1303
6846,0,0,26,0,-26
6847,0,0,86,0,-86
6848,1,0,48,0,-48
6849,0,0,92,0,-92
6850,1,1,357,1243,886
6851,0,0,175,0,-175
6852,0,0,14,0,-14
6853,0,0,7,0,-7
6854,1,1,445,1592,1147
6855,0,0,69,0,-69
6856,0,0,2,0,-2
6857,0,0,55,0,-55
6858,1,0,138,0,-138
6859,1,1,307,1721,1414
6860,0,0,37,0,-37
6861,1,0,12,0,-12
6862,1,1,350,1406,1056
6863,0,0,93,0,-93
6864,1,0,26,0,-26
6865,1,1,341,1689,1348
6866,1,1,16,1340,1324
6867,0,0,38,0,-38
6868,1,0,16,0,-16
6869,1,0,35,0,-35
6870,1,1,932,1291,359
6871,1,0,54,0,-54
6872,0,0,108,0,-108
6873,0,0,78,0,-78
6874,0,0,37,0,-37
6875,0,0,48,0,-48
6876,0,0,0,0,0
6877,0,0,47,0,-47
6878,1,0,19,0,-19
6879,0,0,0,0,0
6880,1,0,38,0,-38
6881,0,0,39,0,-39
6882,1,0,15,0,-15
6883,1,1,40,1519,1479
6884,1,0,203,0,-203
6885,0,0,34,0,-34
6886,1,0,81,0,-81
6887,1,0,6,0,-6
6888,1,0,52,0,-52
6889,1,0,82,0,-82
6890,1,1,317,1215,898
6891,0,0,52,0,-52
6892,0,0,4,0,-4
6893,1,1,1094,1424,330
6894,1,1,772,1242,470
6895,1,1,690,2833,2143
6896,0,0,49,0,-49
6897,1,1,382,1329,947
6898,1,0,18,0,-18
6899,0,0,47,0,-47
6900,1,1,764,1431,667
6901,1,0,44,0,-44
6902,1,1,44,1681,1637
6903,1,0,0,0,0
6904,0,0,92,0,-92
6905,1,1,593,1831,1238
6906,1,1,1836,1212,-624
6907,1,1,290,1222,932
6908,0,0,73,0,-73
6909,1,0,19,0,-19
6910,0,0,9,0,-9
6911,1,0,26,0,-26
6912,0,0,43,0,-43
6913,1,1,64,1501,1437
6914,0,0,5,0,-5
6915,0,0,26,0,-26
6916,1,1,2418,1977,-441
6917,1,1,179,1534,1355
6918,1,1,991,1638,647
6919,0,0,86,0,-86
6920,1,1,250,1235,985
6921,0,0,161,0,-161
6922,0,0,3,0,-3
6923,0,0,5,0,-5
6924,0,0,53,0,-53
6925,0,0,65,0,-65
6926,1,1,1436,1372,-64
6927,1,0,167,0,-167
6928,1,1,246,1309,1063
6929,0,0,17,0,-17
6930,1,0,53,0,-53
6931,1,1,505,1239,734
6932,1,0,47,0,-47
6933,1,0,141,0,-141
6934,1,1,486,1273,787
6935,0,0,19,0,-19
6936,1,0,190,0,-190
6937,0,0,25,0,-25
6938,1,1,302,1388,1086
6939,1,1,413,1370,957
6940,1,1,1645,1558,-87
6941,0,0,39,0,-39
6942,0,0,17,0,-17
6943,0,0,0,0,0
6944,1,1,382,1217,835
6945,1,1,113,1269,1156
6946,0,0,2,0,-2
6947,1,1,915,1397,482
6948,1,0,158,0,-158
6949,1,1,264,1411,1147
6950,0,0,106,0,-106
6951,1,1,1023,1357,334
6952,1,0,48,0,-48
6953,1,0,14,0,-14
6954,1,0,1,0,-1
6955,0,0,123,0,-123
6956,0,0,16,0,-16
6957,1,1,278,1664,1386
6958,1,0,22,0,-22
6959,0,0,114,0,-114
6960,0,0,2,0,-2
6961,1,1,114,2330,2216
6962,0,0,21,0,-21
6963,1,0,68,0,-68
6964,1,1,718,2124,1406
6965,0,0,27,0,-27
6966,0,0,85,0,-85
6967,1,1,419,1405,986
6968,0,0,92,0,-92
6969,1,1,294,1331,1037
6970,0,0,16,0,-16
6971,0,0,2,0,-2
6972,1,1,332,1730,1398
6973,0,0,27,0,-27
6974,0,0,18,0,-18
6975,1,0,41,0,-41
6976,1,1,533,1600,1067
6977,1,1,499,1208,709
6978,0,0,126,0,-126
6979,0,0,16,0,-16
6980,1,1,138,1299,1161
6981,1,0,71,0,-71
6982,1,1,1580,1226,-354
6983,1,1,904,1356,452
6984,1,1,127,1562,1435
6985,1,1,395,1260,865
6986,1,0,8,0,-8
6987,1,1,901,1517,616
6988,1,1,1071,1217,146
6989,1,1,493,1392,899
6990,0,0,8,0,-8
6991,0,0,8,0,-8
6992,0,0,201,0,-201
6993,1,0,16,0,-16
6994,1,1,390,1387,997
6995,1,0,12,0,-12
6996,1,1,721,1595,874
6997,1,1,548,1260,712
6998,1,0,40,0,-40
6999,1,1,157,1407,1250
7000,0,0,39,0,-39
7001,1,1,132,2189,2057
7002,1,1,183,1200,1017
7003,0,0,42,0,-42
7004,1,0,7,0,-7
7005,0,0,55,0,-55
7006,1,0,6,0,-6
7007,1,0,81,0,-81
7008,1,0,2,0,-2
7009,0,0,3,0,-3
7010,0,0,2,0,-2
7011,1,0,47,0,-47
7012,1,0,13,0,-13
7013,0,0,12,0,-12
7014,0,0,112,0,-112
7015,1,0,64,0,-64
7016,1,1,495,1243,748
7017,1,1,397,1248,851
7018,1,1,80,1425,1345
7019,1,0,73,0,-73
7020,0,0,14,0,-14
7021,1,0,1,0,-1
7022,1,1,1386,1271,-115
7023,1,1,160,3027,2867
7024,0,0,36,0,-36
7025,1,0,25,0,-25
7026,1,1,303,1997,1694
7027,0,0,9,0,-9
7028,1,0,12,0,-12
7029,1,0,93,0,-93
7030,0,0,23,0,-23
7031,1,1,114,2595,2481
7032,1,1,241,1534,1293
7033,1,1,199,1361,1162
7034,1,1,102,1399,1297
7035,0,0,131,0,-131
7036,1,0,28,0,-28
7037,1,0,6,0,-6
7038,0,0,17,0,-17
7039,0,0,43,0,-43
7040,1,0,29,0,-29
7041,1,1,56,1366,1310
7042,1,0,82,0,-82
7043,1,0,33,0,-33
7044,1,1,258,1230,972
7045,1,0,2,0,-2
7046,1,0,27,0,-27
7047,0,0,20,0,-20
7048,0,0,14,0,-14
7049,1,0,8,0,-8
7050,0,0,71,0,-71
7051,0,0,131,0,-131
7052,1,1,176,1575,1399
7053,1,1,1572,3010,1438
7054,0,0,48,0,-48
7055,0,0,22,0,-22
7056,1,0,86,0,-86
7057,0,0,258,0,-258
7058,1,0,20,0,-20
7059,1,1,903,1728,825
7060,0,0,46,0,-46
7061,1,1,124,1582,1458
7062,0,0,10,0,-10
7063,0,0,6,0,-6
7064,1,1,2253,1212,-1041
7065,0,0,35,0,-35
7066,1,1,180,1284,1104
7067,1,1,160,1473,1313
7068,0,0,9,0,-9
7069,1,1,379,1343,964
7070,1,1,316,2169,1853
7071,1,1,285,1248,963
7072,1,1,69,1566,1497
7073,1,0,0,0,0
7074,1,0,28,0,-28
7075,0,0,61,0,-61
7076,1,1,236,1325,1089
7077,1,1,38,1391,1353
7078,1,1,603,1280,677
7079,0,0,50,0,-50
7080,1,1,903,1321,418
7081,1,0,15,0,-15
7082,1,1,1254,5319,4065
7083,0,0,2,0,-2
7084,1,0,55,0,-55
7085,0,0,9,0,-9
7086,1,1,572,1224,652
7087,1,0,47,0,-47
7088,0,0,9,0,-9
7089,1,0,61,0,-61
7090,1,1,974,1283,309
7091,1,0,10,0,-10
7092,0,0,90,0,-90
7093,1,0,75,0,-75
7094,1,0,38,0,-38
7095,0,0,45,0,-45
7096,0,0,63,0,-63
7097,1,0,24,0,-24
7098,1,1,160,1257,1097
7099,1,0,13,0,-13
7100,0,0,23,0,-23
7101,1,1,183,1402,1219
7102,0,0,22,0,-22
7103,1,1,90,1405,1315
7104,1,1,667,1304,637
7105,1,0,25,0,-25
7106,0,0,8,0,-8
7107,0,0,45,0,-45
7108,0,0,70,0,-70
7109,1,1,26,1374,1348
7110,1,1,750,1298,548
7111,0,0,20,0,-20
7112,0,0,23,0,-23
7113,0,0,212,0,-212
7114,1,0,11,0,-11
7115,0,0,15,0,-15
7116,1,0,33,0,-33
7117,0,0,130,0,-130
7118,1,0,45,0,-45
7119,1,0,8,0,-8
7120,0,0,4,0,-4
7121,1,0,2,0,-2
7122,1,0,57,0,-57
7123,1,1,645,1255,610
7124,1,1,698,1612,914
7125,0,0,183,0,-183
7126,1,1,1026,2134,1108
7127,0,0,37,0,-37
7128,1,0,76,0,-76
7129,0,0,2,0,-2
7130,0,0,171,0,-171
7131,1,0,55,0,-55
7132,1,1,493,1228,735
7133,1,1,75,1259,1184
7134,1,1,1659,1443,-216
7135,0,0,10,0,-10
7136,0,0,215,0,-215
7137,1,1,62,1303,1241
7138,0,0,9,0,-9
7139,1,1,126,1624,1498
7140,1,1,518,2218,1700
7141,0,0,66,0,-66
7142,1,1,287,1387,1100
7143,0,0,83,0,-83
7144,1,0,6,0,-6
7145,0,0,10,0,-10
7146,0,0,1,0,-1
7147,0,0,17,0,-17
7148,1,0,113,0,-113
7149,0,0,127,0,-127
7150,1,1,1471,1258,-213
7151,1,1,204,1262,1058
7152,0,0,15,0,-15
7153,0,0,19,0,-19
7154,0,0,22,0,-22
7155,1,1,307,3609,3302
7156,1,0,76,0,-76
7157,1,1,420,1456,1036
7158,1,0,173,0,-173
7159,1,0,8,0,-8
7160,1,0,22,0,-22
7161,1,0,3,0,-3
7162,0,0,107,0,-107
7163,1,0,26,0,-26
7164,1,1,861,1443,582
7165,0,0,7,0,-7
7166,1,0,29,0,-29
7167,0,0,7,0,-7
7168,1,0,79,0,-79
7169,1,0,25,0,-25
7170,1,1,726,1245,519
7171,1,0,260,0,-260
7172,0,0,55,0,-55
7173,1,0,16,0,-16
7174,1,0,0,0,0
7175,1,0,4,0,-4
7176,1,0,79,0,-79
7177,1,1,247,1548,1301
7178,1,1,265,1211,946
7179,0,0,202,0,-202
7180,1,1,292,2168,1876
7181,0,0,74,0,-74
7182,1,1,21,1307,1286
7183,1,1,59,2021,1962
7184,0,0,151,0,-151
7185,1,1,162,2904,2742
7186,0,0,69,0,-69
7187,0,0,123,0,-123
7188,1,0,25,0,-25
7189,1,0,6,0,-6
7190,1,0,30,0,-30
7191,1,0,10,0,-10
7192,0,0,112,0,-112
7193,0,0,73,0,-73
7194,0,0,8,0,-8
7195,1,0,43,0,-43
7196,0,0,46,0,-46
7197,0,0,22,0,-22
7198,1,1,704,1402,698
7199,0,0,99,0,-99
7200,1,0,105,0,-105
7201,0,0,49,0,-49
7202,1,1,595,1263,668
7203,1,0,19,0,-19
7204,1,1,85,1213,1128
7205,1,1,150,2009,1859
7206,0,0,54,0,-54
7207,0,0,5,0,-5
7208,1,0,1,0,-1
7209,0,0,24,0,-24
7210,0,0,172,0,-172
7211,1,0,16,0,-16
7212,0,0,21,0,-21
7213,0,0,15,0,-15
7214,0,0,13,0,-13
7215,0,0,1,0,-1
7216,1,1,251,1637,1386
7217,0,0,38,0,-38
7218,1,1,693,1237,544
7219,1,1,476,3687,3211
7220,1,0,72,0,-72
7221,0,0,27,0,-27
7222,1,0,32,0,-32
7223,0,0,240,0,-240
7224,1,1,1302,2407,1105
7225,1,0,74,0,-74
7226,0,0,20,0,-20
7227,1,1,1046,1300,254
7228,0,0,22,0,-22
7229,1,0,29,0,-29
7230,1,1,920,1246,326
7231,0,0,150,0,-150
7232,0,0,32,0,-32
7233,0,0,9,0,-9
7234,0,0,7,0,-7
7235,0,0,4,0,-4
7236,0,0,2,0,-2
7237,1,0,83,0,-83
7238,1,0,2,0,-2
7239,1,0,26,0,-26
7240,1,0,83,0,-83
7241,0,0,78,0,-78
7242,0,0,62,0,-62
7243,0,0,27,0,-27
7244,0,0,3,0,-3
7245,1,0,13,0,-13
7246,0,0,8,0,-8
7247,0,0,73,0,-73
7248,1,0,2,0,-2
7249,1,1,591,1875,1284
7250,1,1,24,1398,1374
7251,0,0,55,0,-55
7252,1,0,155,0,-155
7253,1,0,64,0,-64
7254,1,0,42,0,-42
7255,0,0,32,0,-32
7256,1,1,583,1345,762
7257,1,1,771,1700,929
7258,1,1,282,1421,1139
7259,0,0,129,0,-129
7260,1,0,5,0,-5
7261,1,1,1704,2187,483
7262,0,0,15,0,-15
7263,0,0,24,0,-24
7264,1,0,37,0,-37
7265,0,0,55,0,-55
7266,0,0,49,0,-49
7267,1,1,237,1220,983
7268,1,0,19,0,-19
7269,0,0,145,0,-145
7270,1,0,13,0,-13
7271,1,0,27,0,-27
7272,1,0,202,0,-202
7273,1,0,47,0,-47
7274,1,1,1759,1774,15
7275,1,0,73,0,-73
7276,0,0,122,0,-122
7277,0,0,6,0,-6
7278,0,0,114,0,-114
7279,0,0,103,0,-103
7280,0,0,1,0,-1
7281,0,0,26,0,-26
7282,1,1,512,1620,1108
7283,1,1,973,1269,296
7284,0,0,29,0,-29
7285,1,0,23,0,-23
7286,1,0,65,0,-65
7287,1,0,0,0,0
7288,0,0,21,0,-21
7289,0,0,68,0,-68
7290,0,0,29,0,-29
7291,1,1,131,1432,1301
7292,0,0,100,0,-100
7293,1,1,71,1595,1524
7294,1,1,239,1924,1685
7295,1,0,53,0,-53
7296,1,1,752,1212,460
7297,0,0,47,0,-47
7298,1,0,4,0,-4
7299,0,0,44,0,-44
7300,1,0,41,0,-41
7301,0,0,15,0,-15
7302,1,1,1557,1323,-234
7303,1,0,140,0,-140
7304,1,0,23,0,-23
7305,1,1,1577,1253,-324
7306,0,0,80,0,-80
7307,0,0,46,0,-46
7308,1,1,505,1811,1306
7309,1,0,26,0,-26
7310,0,0,13,0,-13
7311,0,0,38,0,-38
7312,1,1,917,2139,1222
7313,1,1,807,1223,416
7314,0,0,181,0,-181
7315,0,0,19,0,-19
7316,1,1,196,1515,1319
7317,0,0,76,0,-76
7318,0,0,188,0,-188
7319,1,0,44,0,-44
7320,1,1,1209,1237,28
7321,1,0,45,0,-45
7322,0,0,12,0,-12
7323,1,1,722,1316,594
7324,1,0,79,0,-79
7325,0,0,11,0,-11
7326,0,0,11,0,-11
7327,1,0,13,0,-13
7328,1,0,42,0,-42
7329,0,0,0,0,0
7330,1,1,360,1380,1020
7331,1,0,24,0,-24
7332,1,0,45,0,-45
7333,1,1,736,1347,611
7334,1,1,119,1231,1112
7335,0,0,1,0,-1
7336,1,0,25,0,-25
7337,0,0,45,0,-45
7338,0,0,4,0,-4
7339,1,1,808,1481,673
7340,1,0,27,0,-27
7341,1,0,65,0,-65
7342,1,0,31,0,-31
7343,0,0,62,0,-62
7344,1,1,1016,1297,281
7345,0,0,80,0,-80
7346,1,0,64,0,-64
7347,0,0,41,0,-41
7348,0,0,0,0,0
7349,1,1,182,1572,1390
7350,1,0,21,0,-21
7351,0,0,80,0,-80
7352,1,0,10,0,-10
7353,0,0,45,0,-45
7354,0,0,45,0,-45
7355,1,0,94,0,-94
7356,1,0,8,0,-8
7357,1,1,144,1419,1275
7358,1,0,43,0,-43
7359,0,0,22,0,-22
7360,0,0,15,0,-15
7361,1,0,39,0,-39
7362,1,1,53,1805,1752
7363,0,0,20,0,-20
7364,0,0,49,0,-49
7365,1,1,27,1251,1224
7366,0,0,126,0,-126
7367,0,0,27,0,-27
7368,0,0,53,0,-53
7369,1,1,823,1491,668
7370,0,0,104,0,-104
7371,0,0,38,0,-38
7372,1,0,169,0,-169
7373,0,0,9,0,-9
7374,0,0,25,0,-25
7375,1,0,64,0,-64
7376,0,0,122,0,-122
7377,0,0,130,0,-130
7378,1,0,30,0,-30
7379,1,1,171,1467,1296
7380,1,0,14,0,-14
7381,1,0,53,0,-53
7382,0,0,15,0,-15
7383,1,1,313,1803,1490
7384,1,1,1674,2566,892
7385,1,1,1680,1360,-320
7386,1,1,291,1400,1109
7387,0,0,22,0,-22
7388,0,0,158,0,-158
7389,1,1,1055,1625,570
7390,0,0,90,0,-90
7391,1,0,62,0,-62
7392,0,0,67,0,-67
7393,1,1,719,1285,566
7394,1,0,39,0,-39
7395,0,0,59,0,-59
7396,1,1,416,1284,868
7397,0,0,1,0,-1
7398,1,1,315,1561,1246
7399,0,0,19,0,-19
7400,0,0,30,0,-30
7401,0,0,7,0,-7
7402,1,0,17,0,-17
7403,1,0,9,0,-9
7404,1,1,180,1360,1180
7405,0,0,181,0,-181
7406,1,0,82,0,-82
7407,0,0,25,0,-25
7408,1,1,419,1365,946
7409,1,1,256,2038,1782
7410,0,0,57,0,-57
7411,1,0,1,0,-1
7412,1,1,765,3536,2771
7413,0,0,19,0,-19
7414,0,0,95,0,-95
7415,1,0,70,0,-70
7416,1,0,194,0,-194
7417,0,0,24,0,-24
7418,1,1,142,2164,2022
7419,1,0,31,0,-31
7420,1,1,1305,1343,38
7421,1,0,19,0,-19
7422,1,0,46,0,-46
7423,1,0,22,0,-22
7424,1,0,120,0,-120
7425,1,0,45,0,-45
7426,1,1,822,1527,705
7427,1,1,175,1229,1054
7428,0,0,30,0,-30
7429,1,0,22,0,-22
7430,0,0,134,0,-134
7431,1,1,1725,1425,-300
7432,0,0,20,0,-20
7433,0,0,61,0,-61
7434,1,1,101,1305,1204
7435,0,0,83,0,-83
7436,0,0,9,0,-9
7437,0,0,121,0,-121
7438,0,0,63,0,-63
7439,0,0,13,0,-13
7440,0,0,41,0,-41
7441,1,0,206,0,-206
7442,0,0,4,0,-4
7443,0,0,69,0,-69
7444,1,1,366,1300,934
7445,1,0,124,0,-124
7446,1,1,615,1314,699
7447,0,0,142,0,-142
7448,1,0,1,0,-1
7449,1,0,120,0,-120
7450,0,0,21,0,-21
7451,0,0,106,0,-106
7452,1,0,173,0,-173
7453,1,0,84,0,-84
7454,0,0,21,0,-21
7455,0,0,40,0,-40
7456,1,1,987,1383,396
7457,1,1,318,1338,1020
7458,0,0,23,0,-23
7459,1,1,1409,1428,19
7460,1,1,301,1877,1576
7461,0,0,43,0,-43
7462,1,1,350,1480,1130
7463,1,1,216,1952,1736
7464,0,0,44,0,-44
7465,1,0,94,0,-94
7466,1,1,233,1210,977
7467,0,0,161,0,-161
7468,0,0,84,0,-84
7469,0,0,1,0,-1
7470,0,0,34,0,-34
7471,1,0,5,0,-5
7472,1,0,14,0,-14
7473,1,1,662,1344,682
7474,0,0,4,0,-4
7475,1,1,285,1268,983
7476,0,0,32,0,-32
7477,1,0,11,0,-11
7478,1,1,316,1573,1257
7479,1,0,54,0,-54
7480,0,0,262,0,-262
7481,0,0,13,0,-13
7482,1,0,99,0,-99
7483,1,1,50,1282,1232
7484,0,0,19,0,-19
7485,0,0,49,0,-49
7486,0,0,23,0,-23
7487,1,1,503,1276,773
7488,0,0,83,0,-83
7489,1,1,1238,1243,5
7490,1,0,27,0,-27
7491,1,0,70,0,-70
7492,0,0,62,0,-62
7493,1,1,756,1266,510
7494,1,0,29,0,-29
7495,1,1,250,1362,1112
7496,0,0,22,0,-22
7497,0,0,33,0,-33
7498,1,1,787,1208,421
7499,1,0,56,0,-56
7500,1,1,1285,1887,602
7501,0,0,50,0,-50
7502,1,1,561,1284,723
7503,1,0,15,0,-15
7504,1,0,11,0,-11
7505,1,0,34,0,-34
7506,0,0,9,0,-9
7507,1,0,53,0,-53
7508,1,1,150,1659,1509
7509,1,1,761,1507,746
7510,1,1,55,1304,1249
7511,0,0,87,0,-87
7512,0,0,185,0,-185
7513,0,0,41,0,-41
7514,1,0,203,0,-203
7515,1,0,10,0,-10
7516,1,1,540,1304,764
7517,0,0,7,0,-7
7518,1,0,43,0,-43
7519,1,1,1230,1396,166
7520,0,0,19,0,-19
7521,0,0,67,0,-67
7522,0,0,4,0,-4
7523,0,0,93,0,-93
7524,0,0,1,0,-1
7525,1,0,1,0,-1
7526,1,0,29,0,-29
7527,0,0,160,0,-160
7528,0,0,4,0,-4
7529,0,0,2,0,-2
7530,1,1,219,1416,1197
7531,1,0,10,0,-10
7532,0,0,109,0,-109
7533,1,1,541,1522,981
7534,1,1,1771,1231,-540
7535,1,0,38,0,-38
7536,1,1,129,2738,2609
7537,1,0,144,0,-144
7538,1,1,397,1380,983
7539,1,0,45,0,-45
7540,1,0,74,0,-74
7541,0,0,1,0,-1
7542,0,0,9,0,-9
7543,1,0,2,0,-2
7544,0,0,16,0,-16
7545,0,0,17,0,-17
7546,0,0,121,0,-121
7547,0,0,35,0,-35
7548,0,0,174,0,-174
7549,0,0,37,0,-37
7550,1,1,436,1605,1169
7551,1,0,61,0,-61
7552,1,0,59,0,-59
7553,1,0,11,0,-11
7554,1,0,26,0,-26
7555,1,1,122,1794,1672
7556,0,0,5,0,-5
7557,1,1,183,1523,1340
7558,1,1,323,2455,2132
7559,0,0,24,0,-24
7560,1,0,122,0,-122
7561,1,1,1421,1579,158
7562,0,0,96,0,-96
7563,0,0,11,0,-11
7564,0,0,137,0,-137
7565,1,0,0,0,0
7566,1,1,50,1494,1444
7567,0,0,51,0,-51
7568,0,0,2,0,-2
7569,1,1,247,1825,1578
7570,0,0,70,0,-70
7571,0,0,3,0,-3
7572,1,0,18,0,-18
7573,0,0,46,0,-46
7574,0,0,146,0,-146
7575,1,0,5,0,-5
7576,0,0,35,0,-35
7577,0,0,114,0,-114
7578,1,1,515,1244,729
7579,1,0,8,0,-8
7580,1,1,203,1349,1146
7581,0,0,65,0,-65
7582,0,0,9,0,-9
7583,1,0,9,0,-9
7584,1,0,3,0,-3
7585,1,0,12,0,-12
7586,1,0,17,0,-17
7587,0,0,26,0,-26
7588,1,0,148,0,-148
7589,1,0,11,0,-11
7590,0,0,143,0,-143
7591,1,1,34,1247,1213
7592,0,0,39,0,-39
7593,1,0,9,0,-9
7594,1,0,2,0,-2
7595,1,1,469,1282,813
7596,1,1,245,1375,1130
7597,1,0,47,0,-47
7598,1,0,6,0,-6
7599,0,0,7,0,-7
7600,1,0,53,0,-53
7601,0,0,21,0,-21
7602,0,0,15,0,-15
7603,0,0,17,0,-17
7604,0,0,4,0,-4
7605,1,1,255,1230,975
7606,1,1,262,1405,1143
7607,1,0,16,0,-16
7608,1,1,1392,1837,445
7609,1,1,170,1421,1251
7610,1,1,442,1467,1025
7611,1,0,55,0,-55
7612,0,0,19,0,-19
7613,0,0,82,0,-82
7614,1,0,64,0,-64
7615,0,0,42,0,-42
7616,1,0,26,0,-26
7617,0,0,32,0,-32
7618,1,1,240,1612,1372
7619,0,0,3,0,-3
7620,0,0,3,0,-3
7621,0,0,85,0,-85
7622,1,1,204,1806,1602
7623,1,0,23,0,-23
7624,1,1,1161,1390,229
7625,0,0,65,0,-65
7626,0,0,23,0,-23
7627,0,0,101,0,-101
7628,1,1,505,2663,2158
7629,1,1,703,1296,593
7630,1,0,4,0,-4
7631,0,0,27,0,-27
7632,0,0,22,0,-22
7633,0,0,30,0,-30
7634,1,1,641,1686,1045
7635,0,0,44,0,-44
7636,1,1,1092,1286,194
7637,1,1,147,1225,1078
7638,1,1,49,1484,1435
7639,1,0,22,0,-22
7640,0,0,21,0,-21
7641,1,0,13,0,-13
7642,0,0,2,0,-2
7643,0,0,55,0,-55
7644,1,1,47,1328,1281
7645,0,0,65,0,-65
7646,1,1,245,2796,2551
7647,1,1,91,1388,1297
7648,1,1,573,1348,775
7649,1,1,500,1326,826
7650,0,0,27,0,-27
7651,1,1,785,1212,427
7652,0,0,30,0,-30
7653,1,0,53,0,-53
7654,1,0,20,0,-20
7655,1,0,4,0,-4
7656,0,0,26,0,-26
7657,1,1,64,2340,2276
7658,0,0,55,0,-55
7659,1,1,529,1387,858
7660,0,0,15,0,-15
7661,0,0,11,0,-11
7662,1,0,22,0,-22
7663,1,1,127,1232,1105
7664,1,0,4,0,-4
7665,0,0,116,0,-116
7666,0,0,5,0,-5
7667,0,0,177,0,-177
7668,0,0,28,0,-28
7669,1,0,45,0,-45
7670,0,0,33,0,-33
7671,1,0,19,0,-19
7672,1,0,47,0,-47
7673,1,0,8,0,-8
7674,1,0,8,0,-8
7675,1,0,30,0,-30
7676,1,0,0,0,0
7677,1,1,728,1619,891
7678,1,0,13,0,-13
7679,1,1,701,1264,563
7680,1,1,1592,1590,-2
7681,0,0,35,0,-35
7682,1,1,168,2056,1888
7683,1,0,31,0,-31
7684,1,0,48,0,-48
7685,1,0,3,0,-3
7686,1,0,95,0,-95
7687,0,0,17,0,-17
7688,1,1,184,2057,1873
7689,0,0,121,0,-121
7690,1,1,163,1267,1104
7691,1,0,32,0,-32
7692,1,0,42,0,-42
7693,1,1,626,2210,1584
7694,1,1,138,1408,1270
7695,1,1,13,2265,2252
7696,0,0,75,0,-75
7697,1,0,51,0,-51
7698,1,1,141,1206,1065
7699,0,0,119,0,-119
7700,1,0,71,0,-71
7701,0,0,5,0,-5
7702,0,0,1,0,-1
7703,1,1,384,1783,1399
7704,1,0,127,0,-127
7705,1,0,49,0,-49
7706,0,0,36,0,-36
7707,1,1,29,1259,1230
7708,1,1,617,1916,1299
7709,1,0,122,0,-122
7710,1,0,21,0,-21
7711,0,0,27,0,-27
7712,1,1,500,1547,1047
7713,0,0,15,0,-15
7714,0,0,107,0,-107
7715,1,0,114,0,-114
7716,1,1,1104,1618,514
7717,0,0,253,0,-253
7718,0,0,13,0,-13
7719,1,1,89,2015,1926
7720,1,1,681,1768,1087
7721,0,0,33,0,-33
7722,1,1,66,4673,4607
7723,0,0,14,0,-14
7724,0,0,62,0,-62
7725,0,0,95,0,-95
7726,0,0,49,0,-49
7727,1,0,89,0,-89
7728,1,0,3,0,-3
7729,1,1,72,1303,1231
7730,1,0,13,0,-13
7731,0,0,3,0,-3
7732,1,1,328,2970,2642
7733,0,0,44,0,-44
7734,0,0,61,0,-61
7735,1,1,11,1332,1321
7736,1,0,40,0,-40
7737,1,1,573,1557,984
7738,1,1,1482,1246,-236
7739,1,0,9,0,-9
7740,0,0,36,0,-36
7741,0,0,62,0,-62
7742,1,0,92,0,-92
7743,1,0,68,0,-68
7744,0,0,9,0,-9
7745,0,0,41,0,-41
7746,1,0,16,0,-16
7747,1,1,578,1755,1177
7748,1,0,6,0,-6
7749,1,0,4,0,-4
7750,1,0,52,0,-52
7751,1,1,473,1262,789
7752,0,0,84,0,-84
7753,0,0,8,0,-8
7754,1,0,203,0,-203
7755,0,0,32,0,-32
7756,1,1,1168,1332,164
7757,0,0,6,0,-6
7758,1,1,362,1792,1430
7759,1,0,4,0,-4
7760,1,1,543,2345,1802
7761,1,0,6,0,-6
7762,0,0,143,0,-143
7763,0,0,4,0,-4
7764,1,0,3,0,-3
7765,0,0,14,0,-14
7766,0,0,155,0,-155
7767,1,0,5,0,-5
7768,0,0,65,0,-65
7769,1,0,53,0,-53
7770,1,0,0,0,0
7771,0,0,57,0,-57
7772,1,0,36,0,-36
7773,1,1,183,1738,1555
7774,1,1,210,1282,1072
7775,0,0,33,0,-33
7776,1,1,827,1878,1051
7777,1,1,315,1394,1079
7778,0,0,2,0,-2
7779,1,0,6,0,-6
7780,0,0,38,0,-38
7781,1,0,18,0,-18
7782,1,1,683,1343,660
7783,1,0,47,0,-47
7784,1,0,137,0,-137
7785,0,0,43,0,-43
7786,0,0,189,0,-189
7787,1,0,92,0,-92
7788,0,0,13,0,-13
7789,1,0,24,0,-24
7790,0,0,50,0,-50
7791,1,0,24,0,-24
7792,1,1,206,2148,1942
7793,1,1,223,2141,1918
7794,1,0,51,0,-51
7795,1,1,338,2670,2332
7796,1,0,57,0,-57
7797,1,1,395,1249,854
7798,1,1,182,1209,1027
7799,1,0,2,0,-2
7800,0,0,16,0,-16
7801,1,0,9,0,-9
7802,1,1,192,1287,1095
7803,1,0,54,0,-54
7804,0,0,28,0,-28
7805,1,0,3,0,-3
7806,1,1,383,1487,1104
7807,0,0,31,0,-31
7808,0,0,10,0,-10
7809,0,0,0,0,0
7810,0,0,71,0,-71
7811,1,1,885,2130,1245
7812,1,1,234,1433,1199
7813,0,0,462,0,-462
7814,0,0,19,0,-19
7815,1,0,85,0,-85
7816,1,0,100,0,-100
7817,1,1,110,1232,1122
7818,1,1,88,2685,2597
7819,0,0,13,0,-13
7820,0,0,113,0,-113
7821,1,1,309,1685,1376
7822,0,0,39,0,-39
7823,0,0,72,0,-72
7824,0,0,35,0,-35
7825,0,0,35,0,-35
7826,0,0,136,0,-136
7827,1,1,272,1362,1090
7828,1,1,557,1382,825
7829,0,0,17,0,-17
7830,0,0,20,0,-20
7831,1,0,62,0,-62
7832,0,0,6,0,-6
7833,0,0,68,0,-68
7834,0,0,26,0,-26
7835,1,0,107,0,-107
7836,0,0,39,0,-39
7837,1,1,326,1324,998
7838,0,0,35,0,-35
7839,1,0,30,0,-30
7840,1,1,132,1263,1131
7841,0,0,72,0,-72
7842,0,0,27,0,-27
7843,1,1,68,1876,1808
7844,0,0,5,0,-5
7845,0,0,1,0,-1
7846,1,0,41,0,-41
7847,0,0,210,0,-210
7848,1,1,774,1317,543
7849,0,0,41,0,-41
7850,1,1,210,1830,1620
7851,1,1,291,1243,952
7852,0,0,33,0,-33
7853,1,1,373,1384,1011
7854,1,1,57,1514,1457
7855,1,1,278,1894,1616
7856,0,0,1,0,-1
7857,0,0,61,0,-61
7858,1,0,4,0,-4
7859,1,1,1419,1769,350
7860,1,0,11,0,-11
7861,0,0,49,0,-49
7862,0,0,125,0,-125
7863,1,0,79,0,-79
7864,1,0,33,0,-33
7865,1,0,69,0,-69
7866,1,0,22,0,-22
7867,1,1,1272,1412,140
7868,0,0,16,0,-16
7869,1,0,24,0,-24
7870,1,0,93,0,-93
7871,1,1,393,1356,963
7872,1,1,912,1295,383
7873,1,1,87,2248,2161
7874,0,0,35,0,-35
7875,1,1,956,1263,307
7876,1,0,31,0,-31
7877,1,1,272,1635,1363
7878,0,0,80,0,-80
7879,0,0,40,0,-40
7880,0,0,80,0,-80
7881,1,0,46,0,-46
7882,0,0,26,0,-26
7883,1,1,409,1394,985
7884,0,0,41,0,-41
7885,1,1,1633,1413,-220
7886,1,0,15,0,-15
7887,1,1,354,1462,1108
7888,1,1,870,2160,1290
7889,0,0,13,0,-13
7890,0,0,127,0,-127
7891,0,0,43,0,-43
7892,1,0,48,0,-48
7893,1,0,20,0,-20
7894,1,0,3,0,-3
7895,1,1,418,1275,857
7896,1,1,662,1324,662
7897,0,0,37,0,-37
7898,1,0,48,0,-48
7899,1,0,2,0,-2
7900,0,0,25,0,-25
7901,0,0,20,0,-20
7902,1,0,18,0,-18
7903,0,0,7,0,-7
7904,0,0,103,0,-103
7905,1,0,128,0,-128
7906,1,0,0,0,0
7907,1,1,952,1678,726
7908,1,0,32,0,-32
7909,1,1,1030,1438,408
7910,1,1,2239,1302,-937
7911,1,1,192,1699,1507
7912,0,0,11,0,-11
7913,1,0,12,0,-12
7914,0,0,17,0,-17
7915,0,0,96,0,-96
7916,1,0,216,0,-216
7917,1,0,4,0,-4
7918,0,0,28,0,-28
7919,1,1,106,1232,1126
7920,0,0,137,0,-137
7921,0,0,122,0,-122
7922,1,1,130,1259,1129
7923,0,0,14,0,-14
7924,1,0,37,0,-37
7925,1,0,65,0,-65
7926,1,0,2,0,-2
7927,1,1,106,1351,1245
7928,0,0,6,0,-6
7929,1,1,231,1306,1075
7930,1,1,978,2060,1082
7931,1,0,50,0,-50
7932,1,1,101,1510,1409
7933,1,0,6,0,-6
7934,1,1,493,1298,805
7935,1,1,554,1298,744
7936,1,1,2130,1232,-898
7937,1,1,286,1808,1522
7938,1,0,0,0,0
7939,1,0,21,0,-21
7940,1,0,11,0,-11
7941,0,0,43,0,-43
7942,0,0,3,0,-3
7943,1,0,6,0,-6
7944,0,0,17,0,-17
7945,1,1,812,2488,1676
7946,0,0,59,0,-59
7947,1,0,30,0,-30
7948,0,0,13,0,-13
7949,1,1,435,1203,768
7950,1,0,56,0,-56
7951,1,0,27,0,-27
7952,0,0,1,0,-1
7953,0,0,88,0,-88
7954,0,0,55,0,-55
7955,1,1,838,1411,573
7956,0,0,90,0,-90
7957,0,0,37,0,-37
7958,1,1,786,2457,1671
7959,1,1,413,1400,987
7960,1,1,31,1679,1648
7961,0,0,2,0,-2
7962,1,0,59,0,-59
7963,1,0,61,0,-61
7964,1,1,1249,1398,149
7965,1,0,40,0,-40
7966,1,1,99,1460,1361
7967,1,0,49,0,-49
7968,0,0,31,0,-31
7969,1,0,30,0,-30
7970,1,0,13,0,-13
7971,1,0,7,0,-7
7972,1,1,436,1218,782
7973,0,0,55,0,-55
7974,1,1,1173,1526,353
7975,1,1,1147,1337,190
7976,1,0,1,0,-1
7977,0,0,88,0,-88
7978,0,0,0,0,0
7979,1,0,14,0,-14
7980,1,1,1045,2058,1013
7981,1,0,32,0,-32
7982,1,0,2,0,-2
7983,1,1,617,1263,646
7984,1,1,1353,1260,-93
7985,0,0,80,0,-80
7986,0,0,22,0,-22
7987,1,1,254,1286,1032
7988,1,1,259,1629,1370
7989,1,1,258,2409,2151
7990,1,1,625,2313,1688
7991,0,0,60,0,-60
7992,1,0,42,0,-42
7993,0,0,56,0,-56
7994,1,0,75,0,-75
7995,0,0,29,0,-29
7996,1,1,177,1674,1497
7997,1,1,760,2020,1260
7998,1,0,65,0,-65
7999,1,0,42,0,-42
8000,1,0,18,0,-18
8001,0,0,88,0,-88
8002,0,0,155,0,-155
8003,1,1,1367,1243,-124
8004,0,0,5,0,-5
8005,0,0,75,0,-75
8006,0,0,27,0,-27
8007,0,0,3,0,-3
8008,0,0,6,0,-6
8009,1,0,120,0,-120
8010,1,0,16,0,-16
8011,0,0,213,0,-213
8012,0,0,3,0,-3
8013,1,1,205,1205,1000
8014,1,1,431,1328,897
8015,1,1,418,1492,1074
8016,1,0,54,0,-54
8017,0,0,39,0,-39
8018,1,0,19,0,-19
8019,0,0,45,0,-45
8020,0,0,36,0,-36
8021,1,0,77,0,-77
8022,1,1,433,1276,843
8023,1,1,802,2048,1246
8024,1,1,991,1351,360
8025,0,0,34,0,-34
8026,0,0,49,0,-49
8027,1,1,169,1314,1145
8028,1,0,12,0,-12
8029,0,0,15,0,-15
8030,0,0,16,0,-16
8031,1,1,452,1220,768
8032,1,1,678,1433,755
8033,1,1,246,1459,1213
8034,0,0,24,0,-24
8035,1,1,93,1689,1596
8036,0,0,5,0,-5
8037,0,0,0,0,0
8038,1,1,778,1638,860
8039,0,0,9,0,-9
8040,0,0,0,0,0
8041,0,0,73,0,-73
8042,0,0,17,0,-17
8043,1,1,20,1416,1396
8044,1,1,354,1387,1033
8045,1,0,5,0,-5
8046,0,0,23,0,-23
8047,0,0,56,0,-56
8048,1,0,22,0,-22
8049,0,0,96,0,-96
8050,1,0,96,0,-96
8051,0,0,63,0,-63
8052,1,0,210,0,-210
8053,0,0,8,0,-8
8054,1,0,46,0,-46
8055,0,0,40,0,-40
8056,1,0,73,0,-73
8057,0,0,58,0,-58
8058,0,0,7,0,-7
8059,0,0,119,0,-119
8060,1,1,225,1458,1233
8061,0,0,1,0,-1
8062,1,1,170,1395,1225
8063,0,0,10,0,-10
8064,1,1,873,1355,482
8065,0,0,10,0,-10
8066,0,0,62,0,-62
8067,1,0,60,0,-60
8068,0,0,29,0,-29
8069,1,0,86,0,-86
8070,0,0,87,0,-87
8071,1,0,137,0,-137
8072,0,0,86,0,-86
8073,0,0,31,0,-31
8074,1,0,115,0,-115
8075,1,1,287,2577,2290
8076,1,1,525,1467,942
8077,1,1,223,1221,998
8078,0,0,41,0,-41
8079,1,0,4,0,-4
8080,0,0,88,0,-88
8081,1,1,244,1473,1229
8082,1,1,374,1271,897
8083,1,1,162,1421,1259
8084,1,1,1570,1381,-189
8085,0,0,129,0,-129
8086,0,0,161,0,-161
8087,1,1,1231,1896,665
8088,1,1,893,1310,417
8089,0,0,29,0,-29
8090,1,1,104,1234,1130
8091,0,0,115,0,-115
8092,1,1,301,2086,1785
8093,0,0,23,0,-23
8094,1,0,4,0,-4
8095,1,0,36,0,-36
8096,1,1,404,2043,1639
8097,0,0,98,0,-98
8098,1,0,15,0,-15
8099,1,1,51,1325,1274
8100,1,1,489,1750,1261
8101,0,0,22,0,-22
8102,1,1,273,1307,1034
8103,1,1,522,1235,713
8104,1,0,132,0,-132
8105,0,0,52,0,-52
8106,0,0,5,0,-5
8107,1,0,43,0,-43
8108,0,0,37,0,-37
8109,0,0,32,0,-32
8110,1,0,61,0,-61
8111,1,1,170,1616,1446
8112,1,1,425,1222,797
8113,1,0,16,0,-16
8114,1,0,164,0,-164
8115,1,1,297,1498,1201
8116,0,0,63,0,-63
8117,1,0,49,0,-49
8118,1,1,697,1391,694
8119,0,0,18,0,-18
8120,1,1,252,2057,1805
8121,1,0,31,0,-31
8122,1,0,16,0,-16
8123,1,0,27,0,-27
8124,0,0,261,0,-261
8125,1,1,398,1661,1263
8126,0,0,1,0,-1
8127,1,1,80,1995,1915
8128,1,1,1947,1690,-257
8129,0,0,7,0,-7
8130,0,0,10,0,-10
8131,1,1,644,1391,747
8132,1,1,1060,1555,495
8133,0,0,88,0,-88
8134,1,0,43,0,-43
8135,1,0,8,0,-8
8136,1,1,137,1780,1643
8137,0,0,2,0,-2
8138,1,1,1176,1530,354
8139,1,1,65,1430,1365
8140,1,1,106,1260,1154
8141,1,1,573,1359,786
8142,1,0,13,0,-13
8143,0,0,38,0,-38
8144,1,1,1095,1348,253
8145,0,0,29,0,-29
8146,1,1,667,1665,998
8147,0,0,5,0,-5
8148,1,1,117,1378,1261
8149,0,0,0,0,0
8150,1,0,48,0,-48
8151,1,0,4,0,-4
8152,0,0,3,0,-3
8153,0,0,32,0,-32
8154,1,1,638,1200,562
8155,1,1,369,1335,966
8156,1,0,53,0,-53
8157,0,0,43,0,-43
8158,1,0,24,0,-24
8159,0,0,105,0,-105
8160,1,1,271,1244,973
8161,1,0,0,0,0
8162,0,0,81,0,-81
8163,0,0,6,0,-6
8164,0,0,40,0,-40
8165,1,1,1256,1353,97
8166,0,0,183,0,-183
8167,0,0,1,0,-1
8168,1,0,10,0,-10
8169,1,0,31,0,-31
8170,1,1,531,1920,1389
8171,0,0,13,0,-13
8172,1,0,62,0,-62
8173,0,0,20,0,-20
8174,0,0,5,0,-5
8175,0,0,16,0,-16
8176,1,0,195,0,-195
8177,1,1,551,1413,862
8178,1,0,1,0,-1
8179,0,0,48,0,-48
8180,0,0,5,0,-5
8181,1,1,166,1434,1268
8182,0,0,27,0,-27
8183,0,0,38,0,-38
8184,1,0,26,0,-26
8185,1,1,174,1269,1095
8186,1,0,16,0,-16
8187,1,0,90,0,-90
8188,1,0,110,0,-110
8189,0,0,10,0,-10
8190,1,0,11,0,-11
8191,1,0,13,0,-13
8192,0,0,25,0,-25
8193,1,0,29,0,-29
8194,1,0,12,0,-12
8195,1,0,13,0,-13
8196,1,0,45,0,-45
8197,1,1,961,1252,291
8198,0,0,192,0,-192
8199,1,1,78,1512,1434
8200,1,0,16,0,-16
8201,0,0,27,0,-27
8202,1,1,1076,1525,449
8203,0,0,16,0,-16
8204,1,0,59,0,-59
8205,1,1,132,1507,1375
8206,1,1,310,1283,973
8207,0,0,26,0,-26
8208,0,0,1,0,-1
8209,1,1,116,1965,1849
8210,1,0,38,0,-38
8211,0,0,73,0,-73
8212,1,1,273,1913,1640
8213,0,0,5,0,-5
8214,1,0,88,0,-88
8215,0,0,81,0,-81
8216,0,0,26,0,-26
8217,0,0,97,0,-97
8218,1,1,455,1538,1083
8219,0,0,156,0,-156
8220,0,0,87,0,-87
8221,1,1,741,1326,585
8222,1,1,410,1461,1051
8223,1,1,1617,2617,1000
8224,1,1,1366,1500,134
8225,1,1,379,1207,828
8226,1,0,112,0,-112
8227,1,0,46,0,-46
8228,0,0,37,0,-37
8229,1,1,568,1248,680
8230,0,0,6,0,-6
8231,0,0,2,0,-2
8232,1,1,93,1342,1249
8233,0,0,34,0,-34
8234,0,0,6,0,-6
8235,0,0,28,0,-28
8236,0,0,0,0,0
8237,1,0,40,0,-40
8238,1,1,424,1538,1114
8239,1,1,59,1605,1546
8240,0,0,29,0,-29
8241,1,0,14,0,-14
8242,1,1,418,1346,928
8243,1,1,1216,1319,103
8244,1,0,50,0,-50
8245,1,0,30,0,-30
8246,1,1,169,1217,1048
8247,1,0,4,0,-4
8248,1,0,55,0,-55
8249,1,0,110,0,-110
8250,0,0,35,0,-35
8251,1,0,14,0,-14
8252,1,0,26,0,-26
8253,1,0,27,0,-27
8254,0,0,9,0,-9
8255,0,0,46,0,-46
8256,0,0,12,0,-12
8257,1,1,98,1844,1746
8258,1,1,253,1497,1244
8259,0,0,8,0,-8
8260,1,0,193,0,-193
8261,1,0,2,0,-2
8262,1,1,264,2834,2570
8263,1,0,12,0,-12
8264,1,0,27,0,-27
8265,0,0,21,0,-21
8266,1,1,274,1218,944
8267,1,0,108,0,-108
8268,1,0,126,0,-126
8269,1,1,1661,1861,200
8270,0,0,148,0,-148
8271,1,1,639,1222,583
8272,1,0,71,0,-71
8273,0,0,9,0,-9
8274,0,0,136,0,-136
8275,1,0,20,0,-20
8276,1,0,20,0,-20
8277,0,0,66,0,-66
8278,0,0,43,0,-43
8279,0,0,29,0,-29
8280,0,0,31,0,-31
8281,1,1,1995,1873,-122
8282,1,0,92,0,-92
8283,1,0,22,0,-22
8284,1,1,271,1637,1366
8285,0,0,24,0,-24
8286,1,1,636,1240,604
8287,1,0,8,0,-8
8288,0,0,12,0,-12
8289,0,0,57,0,-57
8290,0,0,1,0,-1
8291,1,1,646,1228,582
8292,1,1,513,1831,1318
8293,0,0,55,0,-55
8294,0,0,26,0,-26
8295,1,1,956,2051,1095
8296,0,0,133,0,-133
8297,1,0,90,0,-90
8298,0,0,15,0,-15
8299,1,0,24,0,-24
8300,0,0,31,0,-31
8301,1,0,59,0,-59
8302,1,0,63,0,-63
8303,0,0,0,0,0
8304,1,0,8,0,-8
8305,1,0,40,0,-40
8306,1,0,37,0,-37
8307,1,1,344,1510,1166
8308,0,0,65,0,-65
8309,0,0,55,0,-55
8310,0,0,24,0,-24
8311,1,0,1,0,-1
8312,1,0,54,0,-54
8313,1,1,110,2858,2748
8314,1,1,336,1418,1082
8315,0,0,112,0,-112
8316,0,0,25,0,-25
8317,1,0,60,0,-60
8318,0,0,135,0,-135
8319,1,1,747,1273,526
8320,0,0,80,0,-80
8321,1,1,680,1725,1045
8322,1,0,3,0,-3
8323,0,0,107,0,-107
8324,1,1,116,1263,1147
8325,1,0,0,0,0
8326,0,0,20,0,-20
8327,0,0,43,0,-43
8328,1,0,14,0,-14
8329,1,1,565,1518,953
8330,0,0,25,0,-25
8331,1,1,239,1361,1122
8332,1,0,28,0,-28
8333,0,0,28,0,-28
8334,0,0,97,0,-97
8335,1,1,165,1477,1312
8336,1,0,160,0,-160
8337,1,1,827,1310,483
8338,1,1,957,1363,406
8339,1,0,1,0,-1
8340,1,0,66,0,-66
8341,0,0,69,0,-69
8342,1,1,121,1210,1089
8343,1,1,1821,1275,-546
8344,1,1,218,1212,994
8345,0,0,129,0,-129
8346,1,1,292,1914,1622
8347,1,0,32,0,-32
8348,0,0,6,0,-6
8349,1,0,29,0,-29
8350,1,0,1,0,-1
8351,1,0,19,0,-19
8352,1,0,37,0,-37
8353,1,0,77,0,-77
8354,0,0,135,0,-135
8355,1,0,96,0,-96
8356,0,0,76,0,-76
8357,1,1,517,1365,848
8358,1,0,256,0,-256
8359,1,0,39,0,-39
8360,0,0,4,0,-4
8361,0,0,0,0,0
8362,1,1,174,1481,1307
8363,0,0,21,0,-21
8364,1,0,76,0,-76
8365,1,0,66,0,-66
8366,0,0,33,0,-33
8367,1,0,27,0,-27
8368,0,0,13,0,-13
8369,0,0,128,0,-128
8370,1,1,1110,1203,93
8371,0,0,64,0,-64
8372,0,0,3,0,-3
8373,0,0,12,0,-12
8374,1,0,15,0,-15
8375,1,0,46,0,-46
8376,1,1,1066,1742,676
8377,1,1,810,1885,1075
8378,1,0,87,0,-87
8379,1,1,669,1417,748
8380,0,0,17,0,-17
8381,1,0,30,0,-30
8382,0,0,51,0,-51
8383,1,1,1086,2201,1115
8384,1,0,106,0,-106
8385,0,0,10,0,-10
8386,0,0,16,0,-16
8387,1,1,409,1233,824
8388,0,0,36,0,-36
8389,1,0,56,0,-56
8390,0,0,5,0,-5
8391,0,0,82,0,-82
8392,1,1,267,1480,1213
8393,1,0,63,0,-63
8394,1,0,3,0,-3
8395,0,0,33,0,-33
8396,1,1,391,1242,851
8397,0,0,9,0,-9
8398,0,0,4,0,-4
8399,0,0,85,0,-85
8400,0,0,67,0,-67
8401,0,0,11,0,-11
8402,0,0,51,0,-51
8403,1,1,1182,2084,902
8404,1,0,10,0,-10
8405,1,0,89,0,-89
8406,1,1,388,1517,1129
8407,1,0,208,0,-208
8408,0,0,23,0,-23
8409,0,0,53,0,-53
8410,0,0,17,0,-17
8411,1,1,63,1395,1332
8412,1,1,194,1971,1777
8413,1,0,21,0,-21
8414,0,0,3,0,-3
8415,0,0,91,0,-91
8416,0,0,11,0,-11
8417,1,1,245,1647,1402
8418,1,0,40,0,-40
8419,0,0,28,0,-28
8420,0,0,11,0,-11
8421,0,0,43,0,-43
8422,1,0,58,0,-58
8423,1,1,675,1211,536
8424,1,1,602,1241,639
8425,1,0,1,0,-1
8426,1,0,33,0,-33
8427,1,0,97,0,-97
8428,1,0,24,0,-24
8429,0,0,17,0,-17
8430,1,1,447,1220,773
8431,0,0,71,0,-71
8432,1,1,758,1253,495
8433,1,0,75,0,-75
8434,0,0,109,0,-109
8435,1,0,38,0,-38
8436,0,0,37,0,-37
8437,1,0,30,0,-30
8438,1,0,13,0,-13
8439,1,1,310,1329,1019
8440,0,0,87,0,-87
8441,0,0,87,0,-87
8442,0,0,59,0,-59
8443,0,0,121,0,-121
8444,1,1,110,1225,1115
8445,1,0,11,0,-11
8446,1,1,186,2346,2160
8447,0,0,234,0,-234
8448,0,0,52,0,-52
8449,0,0,57,0,-57
8450,0,0,284,0,-284
8451,1,1,100,1767,1667
8452,1,1,170,1443,1273
8453,1,0,0,0,0
8454,0,0,20,0,-20
8455,1,1,152,1784,1632
8456,1,1,571,1331,760
8457,1,1,732,1724,992
8458,1,0,29,0,-29
8459,1,0,33,0,-33
8460,1,1,2735,1521,-1214
8461,0,0,5,0,-5
8462,1,0,49,0,-49
8463,1,1,272,1415,1143
8464,1,0,68,0,-68
8465,1,0,37,0,-37
8466,0,0,63,0,-63
8467,1,0,68,0,-68
8468,1,1,810,1260,450
8469,1,1,277,2220,1943
8470,1,0,42,0,-42
8471,1,0,3,0,-3
8472,0,0,13,0,-13
8473,0,0,13,0,-13
8474,0,0,237,0,-237
8475,1,0,100,0,-100
8476,1,0,5,0,-5
8477,1,0,10,0,-10
8478,1,1,740,1247,507
8479,0,0,5,0,-5
8480,1,0,70,0,-70
8481,0,0,45,0,-45
8482,0,0,79,0,-79
8483,0,0,13,0,-13
8484,1,0,20,0,-20
8485,1,1,151,1222,1071
8486,0,0,18,0,-18
8487,1,1,379,2057,1678
8488,1,0,64,0,-64
8489,0,0,143,0,-143
8490,0,0,31,0,-31
8491,0,0,34,0,-34
8492,0,0,17,0,-17
8493,1,1,1060,1481,421
8494,0,0,73,0,-73
8495,0,0,72,0,-72
8496,1,0,20,0,-20
8497,1,0,49,0,-49
8498,1,1,1655,1285,-370
8499,1,0,56,0,-56
8500,1,1,648,2238,1590
8501,0,0,75,0,-75
8502,1,0,9,0,-9
8503,1,1,489,1550,1061
8504,0,0,10,0,-10
8505,0,0,86,0,-86
8506,1,1,746,2407,1661
8507,0,0,2,0,-2
8508,1,0,8,0,-8
8509,1,0,8,0,-8
8510,1,1,31,1267,1236
8511,1,1,1335,1379,44
8512,0,0,28,0,-28
8513,1,1,402,1310,908
8514,1,1,694,1212,518
8515,0,0,9,0,-9
8516,1,1,343,1273,930
8517,1,0,25,0,-25
8518,1,1,92,1311,1219
8519,1,1,444,1260,816
8520,0,0,150,0,-150
8521,1,1,1757,1310,-447
8522,1,0,2,0,-2
8523,1,1,250,1591,1341
8524,1,0,18,0,-18
8525,1,0,34,0,-34
8526,0,0,82,0,-82
8527,1,1,306,1207,901
8528,1,0,123,0,-123
8529,0,0,65,0,-65
8530,0,0,52,0,-52
8531,1,0,28,0,-28
8532,0,0,1,0,-1
8533,1,1,33,1302,1269
8534,1,0,84,0,-84
8535,1,1,638,1211,573
8536,1,0,35,0,-35
8537,1,0,40,0,-40
8538,1,0,4,0,-4
8539,1,1,699,1328,629
8540,0,0,54,0,-54
8541,0,0,38,0,-38
8542,1,0,13,0,-13
8543,0,0,34,0,-34
8544,0,0,30,0,-30
8545,0,0,64,0,-64
8546,1,1,161,1321,1160
8547,0,0,59,0,-59
8548,0,0,6,0,-6
8549,1,0,20,0,-20
8550,1,0,3,0,-3
8551,0,0,30,0,-30
8552,1,1,549,1429,880
8553,0,0,37,0,-37
8554,1,1,952,1543,591
8555,1,0,45,0,-45
8556,0,0,67,0,-67
8557,0,0,1,0,-1
8558,0,0,10,0,-10
8559,1,0,25,0,-25
8560,1,1,357,1531,1174
8561,1,0,5,0,-5
8562,0,0,14,0,-14
8563,1,1,90,1249,1159
8564,0,0,7,0,-7
8565,0,0,42,0,-42
8566,1,1,620,1997,1377
8567,1,1,274,1285,1011
8568,1,1,2019,1357,-662
8569,1,0,70,0,-70
8570,1,0,78,0,-78
8571,1,0,138,0,-138
8572,1,1,364,1245,881
8573,0,0,77,0,-77
8574,1,1,648,1870,1222
8575,0,0,11,0,-11
8576,0,0,14,0,-14
8577,1,0,33,0,-33
8578,1,0,131,0,-131
8579,0,0,50,0,-50
8580,1,1,979,1278,299
8581,0,0,7,0,-7
8582,0,0,4,0,-4
8583,0,0,14,0,-14
8584,0,0,95,0,-95
8585,1,1,758,1528,770
8586,0,0,89,0,-89
8587,1,1,637,1349,712
8588,1,0,16,0,-16
8589,1,0,46,0,-46
8590,1,1,1198,1506,308
8591,1,1,275,1733,1458
8592,1,0,27,0,-27
8593,1,1,504,2750,2246
8594,0,0,15,0,-15
8595,1,1,7,1268,1261
8596,0,0,113,0,-113
8597,1,0,70,0,-70
8598,1,0,67,0,-67
8599,0,0,20,0,-20
8600,1,0,1,0,-1
8601,1,0,79,0,-79
8602,1,1,295,1563,1268
8603,0,0,62,0,-62
8604,1,1,235,1226,991
8605,1,0,2,0,-2
8606,0,0,74,0,-74
8607,0,0,105,0,-105
8608,1,1,441,1529,1088
8609,1,1,644,1721,1077
8610,0,0,9,0,-9
8611,1,0,49,0,-49
8612,1,1,229,1396,1167
8613,0,0,83,0,-83
8614,0,0,53,0,-53
8615,1,1,341,1250,909
8616,1,0,35,0,-35
8617,1,1,128,1315,1187
8618,1,0,10,0,-10
8619,1,0,12,0,-12
8620,1,0,39,0,-39
8621,0,0,5,0,-5
8622,1,1,39,1221,1182
8623,1,1,529,1205,676
8624,1,0,15,0,-15
8625,1,1,203,1200,997
8626,1,1,492,1742,1250
8627,0,0,16,0,-16
8628,0,0,135,0,-135
8629,0,0,123,0,-123
8630,1,0,77,0,-77
8631,0,0,8,0,-8
8632,0,0,1,0,-1
8633,1,0,35,0,-35
8634,1,0,7,0,-7
8635,0,0,27,0,-27
8636,1,0,18,0,-18
8637,1,0,12,0,-12
8638,0,0,16,0,-16
8639,1,0,0,0,0
8640,0,0,44,0,-44
8641,1,0,9,0,-9
8642,1,1,652,1518,866
8643,1,0,24,0,-24
8644,1,0,17,0,-17
8645,1,0,6,0,-6
8646,0,0,29,0,-29
8647,1,0,56,0,-56
8648,0,0,8,0,-8
8649,1,1,218,1322,1104
8650,0,0,0,0,0
8651,1,1,691,1562,871
8652,1,1,654,1264,610
8653,0,0,84,0,-84
8654,1,1,945,1359,414
8655,1,0,19,0,-19
8656,0,0,5,0,-5
8657,1,0,29,0,-29
8658,1,0,5,0,-5
8659,1,1,1093,1981,888
8660,1,0,85,0,-85
8661,1,0,28,0,-28
8662,0,0,61,0,-61
8663,0,0,24,0,-24
8664,0,0,33,0,-33
8665,1,1,509,1261,752
8666,1,1,220,1966,1746
8667,1,0,42,0,-42
8668,0,0,7,0,-7
8669,0,0,46,0,-46
8670,1,1,771,1599,828
8671,0,0,28,0,-28
8672,0,0,76,0,-76
8673,1,1,426,1474,1048
8674,1,0,4,0,-4
8675,0,0,1,0,-1
8676,0,0,22,0,-22
8677,0,0,3,0,-3
8678,0,0,75,0,-75
8679,0,0,62,0,-62
8680,1,0,10,0,-10
8681,1,0,90,0,-90
8682,1,1,1410,1440,30
8683,0,0,76,0,-76
8684,1,1,750,1571,821
8685,1,1,265,1247,982
8686,1,0,5,0,-5
8687,0,0,50,0,-50
8688,1,0,8,0,-8
8689,1,0,0,0,0
8690,0,0,16,0,-16
8691,0,0,69,0,-69
8692,1,1,218,1414,1196
8693,1,1,761,1206,445
8694,1,1,1028,1226,198
8695,1,0,68,0,-68
8696,1,0,67,0,-67
8697,0,0,10,0,-10
8698,1,0,25,0,-25
8699,1,1,1415,2009,594
8700,1,1,511,1220,709
8701,1,0,13,0,-13
8702,0,0,14,0,-14
8703,1,0,56,0,-56
8704,1,0,31,0,-31
8705,0,0,134,0,-134
8706,1,0,23,0,-23
8707,1,0,51,0,-51
8708,1,1,843,1287,444
8709,1,1,706,1316,610
8710,0,0,6,0,-6
8711,1,1,704,1275,571
8712,1,1,139,2638,2499
8713,1,1,364,1490,1126
8714,1,0,93,0,-93
8715,1,0,47,0,-47
8716,0,0,83,0,-83
8717,0,0,15,0,-15
8718,0,0,28,0,-28
8719,0,0,28,0,-28
8720,1,1,51,1530,1479
8721,1,1,499,2107,1608
8722,0,0,144,0,-144
8723,0,0,34,0,-34
8724,0,0,2,0,-2
8725,0,0,64,0,-64
8726,1,1,994,1211,217
8727,0,0,22,0,-22
8728,1,1,106,1941,1835
8729,1,0,114,0,-114
8730,0,0,113,0,-113
8731,1,1,972,1327,355
8732,1,1,384,1210,826
8733,1,1,495,1777,1282
8734,1,1,681,1301,620
8735,1,1,1094,2379,1285
8736,0,0,104,0,-104
8737,1,1,1645,1265,-380
8738,1,1,965,1327,362
8739,1,1,682,1402,720
8740,0,0,92,0,-92
8741,0,0,1,0,-1
8742,1,0,43,0,-43
8743,1,1,217,1235,1018
8744,1,1,853,1619,766
8745,0,0,58,0,-58
8746,1,0,26,0,-26
8747,1,1,1492,1282,-210
8748,1,0,59,0,-59
8749,0,0,54,0,-54
8750,1,1,926,1752,826
8751,1,1,247,2357,2110
8752,1,0,16,0,-16
8753,0,0,78,0,-78
8754,0,0,12,0,-12
8755,1,0,19,0,-19
8756,1,0,21,0,-21
8757,1,0,0,0,0
8758,1,1,973,1314,341
8759,1,0,14,0,-14
8760,1,1,773,2710,1937
8761,1,1,590,1212,622
8762,1,1,443,1347,904
8763,1,0,33,0,-33
8764,1,0,64,0,-64
8765,1,0,64,0,-64
8766,0,0,66,0,-66
8767,0,0,15,0,-15
8768,1,1,1277,1259,-18
8769,1,0,12,0,-12
8770,1,0,130,0,-130
8771,0,0,26,0,-26
8772,0,0,6,0,-6
8773,0,0,40,0,-40
8774,0,0,1,0,-1
8775,1,0,1,0,-1
8776,1,1,1148,1727,579
8777,1,1,477,1531,1054
8778,0,0,46,0,-46
8779,1,0,42,0,-42
8780,0,0,64,0,-64
8781,1,1,178,1223,1045
8782,1,1,1434,1752,318
8783,0,0,81,0,-81
8784,0,0,15,0,-15
8785,0,0,125,0,-125
8786,1,0,78,0,-78
8787,1,1,313,1881,1568
8788,1,0,40,0,-40
8789,0,0,17,0,-17
8790,1,0,54,0,-54
8791,1,0,5,0,-5
8792,1,1,346,1323,977
8793,1,0,66,0,-66
8794,0,0,24,0,-24
8795,0,0,0,0,0
8796,1,1,275,1455,1180
8797,1,0,8,0,-8
8798,1,0,118,0,-118
8799,0,0,31,0,-31
8800,0,0,68,0,-68
8801,1,0,2,0,-2
8802,1,1,712,1377,665
8803,0,0,115,0,-115
8804,0,0,4,0,-4
8805,1,1,436,1840,1404
8806,1,1,200,1428,1228
8807,1,1,90,1644,1554
8808,1,0,3,0,-3
8809,1,0,77,0,-77
8810,1,1,935,1315,380
8811,1,0,232,0,-232
8812,0,0,174,0,-174
8813,0,0,71,0,-71
8814,1,0,129,0,-129
8815,0,0,89,0,-89
8816,0,0,18,0,-18
8817,1,0,2,0,-2
8818,0,0,88,0,-88
8819,1,1,443,2355,1912
8820,1,0,16,0,-16
8821,1,0,41,0,-41
8822,0,0,72,0,-72
8823,0,0,17,0,-17
8824,0,0,119,0,-119
8825,1,0,125,0,-125
8826,1,1,189,1249,1060
8827,1,1,680,1514,834
8828,1,1,278,1302,1024
8829,1,0,43,0,-43
8830,1,1,217,1280,1063
8831,0,0,5,0,-5
8832,0,0,61,0,-61
8833,1,0,9,0,-9
8834,0,0,17,0,-17
8835,1,0,5,0,-5
8836,1,1,396,1324,928
8837,1,1,118,1254,1136
8838,0,0,30,0,-30
8839,1,1,1390,1417,27
8840,1,1,1265,1562,297
8841,1,0,31,0,-31
8842,1,1,547,1545,998
8843,0,0,11,0,-11
8844,1,0,103,0,-103
8845,0,0,3,0,-3
8846,1,0,44,0,-44
8847,1,0,1,0,-1
8848,1,0,35,0,-35
8849,1,0,28,0,-28
8850,0,0,24,0,-24
8851,1,1,556,1556,1000
8852,1,0,36,0,-36
8853,1,1,516,1554,1038
8854,0,0,61,0,-61
8855,0,0,22,0,-22
8856,0,0,38,0,-38
8857,0,0,296,0,-296
8858,0,0,14,0,-14
8859,1,0,173,0,-173
8860,1,1,86,1311,1225
8861,1,0,51,0,-51
8862,0,0,25,0,-25
8863,1,1,489,1248,759
8864,1,0,5,0,-5
8865,0,0,46,0,-46
8866,0,0,8,0,-8
8867,0,0,7,0,-7
8868,0,0,15,0,-15
8869,0,0,26,0,-26
8870,0,0,71,0,-71
8871,0,0,4,0,-4
8872,1,1,67,1273,1206
8873,1,1,480,1319,839
8874,0,0,45,0,-45
8875,1,1,145,1721,1576
8876,1,0,31,0,-31
8877,0,0,45,0,-45
8878,1,1,141,1755,1614
8879,1,0,38,0,-38
8880,1,0,12,0,-12
8881,0,0,143,0,-143
8882,1,0,15,0,-15
8883,1,1,437,1242,805
8884,1,1,542,1476,934
8885,1,1,360,1237,877
8886,0,0,64,0,-64
8887,1,1,861,1905,1044
8888,0,0,25,0,-25
8889,1,1,69,1510,1441
8890,1,1,484,2081,1597
8891,1,1,10,1812,1802
8892,1,0,115,0,-115
8893,1,0,4,0,-4
8894,1,0,56,0,-56
8895,1,0,45,0,-45
8896,0,0,12,0,-12
8897,0,0,23,0,-23
8898,1,0,12,0,-12
8899,1,1,992,1221,229
8900,0,0,82,0,-82
8901,0,0,3,0,-3
8902,0,0,60,0,-60
8903,1,1,113,1268,1155
8904,1,0,18,0,-18
8905,1,0,164,0,-164
8906,1,1,775,1230,455
8907,0,0,9,0,-9
8908,1,0,26,0,-26
8909,0,0,28,0,-28
8910,1,0,56,0,-56
8911,1,0,103,0,-103
8912,0,0,1,0,-1
8913,1,0,24,0,-24
8914,0,0,43,0,-43
8915,1,0,65,0,-65
8916,1,0,60,0,-60
8917,1,1,642,1570,928
8918,1,1,125,1450,1325
8919,0,0,35,0,-35
8920,1,1,548,1291,743
8921,1,0,36,0,-36
8922,0,0,72,0,-72
8923,0,0,68,0,-68
8924,0,0,106,0,-106
8925,1,1,1076,1327,251
8926,1,1,1444,1678,234
8927,1,0,172,0,-172
8928,1,0,33,0,-33
8929,1,0,4,0,-4
8930,0,0,32,0,-32
8931,1,0,49,0,-49
8932,1,1,1035,1518,483
8933,1,0,59,0,-59
8934,1,1,215,1574,1359
8935,1,0,9,0,-9
8936,0,0,117,0,-117
8937,1,1,96,1562,1466
8938,1,1,217,1401,1184
8939,1,1,558,1417,859
8940,1,0,17,0,-17
8941,0,0,32,0,-32
8942,0,0,65,0,-65
8943,0,0,111,0,-111
8944,1,0,46,0,-46
8945,1,0,20,0,-20
8946,0,0,35,0,-35
8947,1,0,58,0,-58
8948,1,0,3,0,-3
8949,1,0,55,0,-55
8950,0,0,15,0,-15
8951,0,0,7,0,-7
8952,1,1,131,1221,1090
8953,1,0,0,0,0
8954,1,1,102,1718,1616
8955,1,1,787,1244,457
8956,0,0,91,0,-91
8957,0,0,75,0,-75
8958,0,0,14,0,-14
8959,1,1,966,1638,672
8960,1,0,10,0,-10
8961,1,1,145,1323,1178
8962,0,0,5,0,-5
8963,1,0,33,0,-33
8964,0,0,15,0,-15
8965,1,1,209,1313,1104
8966,1,1,523,2456,1933
8967,1,1,222,1637,1415
8968,1,1,134,1673,1539
8969,1,0,169,0,-169
8970,1,0,188,0,-188
8971,1,1,266,2588,2322
8972,0,0,234,0,-234
8973,1,1,441,1234,793
8974,0,0,86,0,-86
8975,0,0,27,0,-27
8976,1,0,31,0,-31
8977,1,0,8,0,-8
8978,1,0,22,0,-22
8979,1,1,520,1370,850
8980,0,0,140,0,-140
8981,0,0,34,0,-34
8982,1,1,292,1233,941
8983,1,1,878,1712,834
8984,0,0,64,0,-64
8985,0,0,58,0,-58
8986,1,0,84,0,-84
8987,1,0,2,0,-2
8988,1,0,22,0,-22
8989,1,0,86,0,-86
8990,1,0,1,0,-1
8991,1,1,442,1320,878
8992,1,1,109,1275,1166
8993,1,0,39,0,-39
8994,1,1,571,1202,631
8995,0,0,18,0,-18
8996,1,0,25,0,-25
8997,1,0,51,0,-51
8998,1,1,2093,1368,-725
8999,1,0,95,0,-95
9000,0,0,61,0,-61
9001,0,0,40,0,-40
9002,0,0,15,0,-15
9003,0,0,44,0,-44
9004,1,0,15,0,-15
9005,1,1,274,3000,2726
9006,0,0,97,0,-97
9007,0,0,107,0,-107
9008,0,0,27,0,-27
9009,1,0,24,0,-24
9010,0,0,18,0,-18
9011,0,0,5,0,-5
9012,1,0,57,0,-57
9013,0,0,46,0,-46
9014,0,0,36,0,-36
9015,1,0,7,0,-7
9016,1,0,4,0,-4
9017,1,1,125,1585,1460
9018,1,0,3,0,-3
9019,1,0,2,0,-2
9020,0,0,29,0,-29
9021,0,0,155,0,-155
9022,1,0,8,0,-8
9023,0,0,12,0,-12
9024,1,0,97,0,-97
9025,1,1,861,1330,469
9026,0,0,92,0,-92
9027,1,1,76,2056,1980
9028,1,0,36,0,-36
9029,1,0,37,0,-37
9030,1,0,77,0,-77
9031,1,0,34,0,-34
9032,1,0,111,0,-111
9033,1,1,1766,1453,-313
9034,0,0,14,0,-14
9035,0,0,27,0,-27
9036,1,0,82,0,-82
9037,1,0,0,0,0
9038,1,0,38,0,-38
9039,1,0,0,0,0
9040,1,1,179,1351,1172
9041,0,0,117,0,-117
9042,1,1,972,1311,339
9043,1,0,39,0,-39
9044,0,0,65,0,-65
9045,0,0,90,0,-90
9046,0,0,101,0,-101
9047,1,1,196,1490,1294
9048,1,0,11,0,-11
9049,1,0,11,0,-11
9050,1,0,78,0,-78
9051,1,0,86,0,-86
9052,0,0,58,0,-58
9053,0,0,113,0,-113
9054,1,1,457,1591,1134
9055,1,1,297,2203,1906
9056,1,1,374,1827,1453
9057,0,0,4,0,-4
9058,1,0,78,0,-78
9059,0,0,57,0,-57
9060,1,0,75,0,-75
9061,0,0,116,0,-116
9062,1,0,19,0,-19
9063,1,1,125,1278,1153
9064,1,0,96,0,-96
9065,1,0,72,0,-72
9066,0,0,3,0,-3
9067,1,1,460,1353,893
9068,1,1,715,1579,864
9069,1,0,60,0,-60
9070,1,1,261,1322,1061
9071,0,0,90,0,-90
9072,1,1,41,1250,1209
9073,1,0,74,0,-74
9074,0,0,17,0,-17
9075,1,1,381,1529,1148
9076,1,1,237,1241,1004
9077,1,0,62,0,-62
9078,1,1,81,1516,1435
9079,1,0,70,0,-70
9080,0,0,1,0,-1
9081,1,1,1277,1325,48
9082,1,1,1600,1519,-81
9083,0,0,21,0,-21
9084,0,0,121,0,-121
9085,0,0,18,0,-18
9086,1,0,100,0,-100
9087,0,0,17,0,-17
9088,0,0,213,0,-213
9089,1,0,20,0,-20
9090,1,1,168,1274,1106
9091,0,0,16,0,-16
9092,1,1,702,1339,637
9093,0,0,38,0,-38
9094,1,0,37,0,-37
9095,1,1,974,1313,339
9096,1,0,27,0,-27
9097,1,1,185,1524,1339
9098,1,0,19,0,-19
9099,1,1,1704,1293,-411
9100,0,0,6,0,-6
9101,0,0,65,0,-65
9102,0,0,33,0,-33
9103,0,0,12,0,-12
9104,1,0,82,0,-82
9105,0,0,114,0,-114
9106,1,1,74,1353,1279
9107,1,1,88,1834,1746
9108,0,0,0,0,0
9109,1,0,30,0,-30
9110,1,0,151,0,-151
9111,0,0,42,0,-42
9112,0,0,13,0,-13
9113,0,0,59,0,-59
9114,0,0,48,0,-48
9115,1,1,71,1358,1287
9116,0,0,7,0,-7
9117,1,0,13,0,-13
9118,1,0,39,0,-39
9119,1,1,124,1340,1216
9120,0,0,41,0,-41
9121,1,0,2,0,-2
9122,1,1,229,1374,1145
9123,1,0,57,0,-57
9124,0,0,2,0,-2
9125,0,0,51,0,-51
9126,1,1,34,1336,1302
9127,1,1,477,1334,857
9128,1,0,5,0,-5
9129,1,1,849,1297,448
9130,1,1,1453,1349,-104
9131,1,1,405,1794,1389
9132,0,0,20,0,-20
9133,1,1,198,1943,1745
9134,1,1,192,1272,1080
9135,0,0,78,0,-78
9136,1,0,1,0,-1
9137,0,0,62,0,-62
9138,1,0,67,0,-67
9139,1,1,180,1265,1085
9140,0,0,11,0,-11
9141,0,0,23,0,-23
9142,1,1,235,1215,980
9143,1,1,279,1683,1404
9144,1,0,5,0,-5
9145,1,1,307,1446,1139
9146,1,0,92,0,-92
9147,0,0,24,0,-24
9148,0,0,35,0,-35
9149,1,1,361,1400,1039
9150,0,0,22,0,-22
9151,1,1,231,1530,1299
9152,0,0,40,0,-40
9153,0,0,63,0,-63
9154,0,0,75,0,-75
9155,1,0,18,0,-18
9156,1,1,313,1222,909
9157,1,1,408,1267,859
9158,1,1,1027,1404,377
9159,0,0,16,0,-16
9160,1,0,8,0,-8
9161,0,0,34,0,-34
9162,0,0,7,0,-7
9163,0,0,46,0,-46
9164,1,0,48,0,-48
9165,0,0,102,0,-102
9166,1,0,130,0,-130
9167,1,1,176,2048,1872
9168,0,0,32,0,-32
9169,1,1,387,3536,3149
9170,1,1,412,1375,963
9171,0,0,73,0,-73
9172,0,0,2,0,-2
9173,1,0,49,0,-49
9174,0,0,23,0,-23
9175,0,0,228,0,-228
9176,0,0,52,0,-52
9177,1,0,37,0,-37
9178,1,1,423,3128,2705
9179,1,1,146,1310,1164
9180,1,0,91,0,-91
9181,0,0,35,0,-35
9182,0,0,95,0,-95
9183,1,0,16,0,-16
9184,1,1,254,1229,975
9185,0,0,75,0,-75
9186,1,0,135,0,-135
9187,0,0,113,0,-113
9188,1,0,114,0,-114
9189,0,0,43,0,-43
9190,0,0,107,0,-107
9191,1,1,223,2336,2113
9192,0,0,38,0,-38
9193,1,1,335,1355,1020
9194,0,0,97,0,-97
9195,0,0,252,0,-252
9196,1,0,20,0,-20
9197,1,0,16,0,-16
9198,0,0,0,0,0
9199,1,0,19,0,-19
9200,1,1,18,1343,1325
9201,1,0,78,0,-78
9202,1,1,747,1311,564
9203,1,1,535,1450,915
9204,1,1,315,1436,1121
9205,0,0,47,0,-47
9206,1,0,55,0,-55
9207,0,0,317,0,-317
9208,1,0,20,0,-20
9209,1,0,72,0,-72
9210,1,0,21,0,-21
9211,1,0,1,0,-1
9212,1,1,196,1435,1239
9213,1,1,1421,1598,177
9214,0,0,16,0,-16
9215,1,0,1,0,-1
9216,1,0,64,0,-64
9217,0,0,1,0,-1
9218,1,1,357,1362,1005
9219,1,1,178,1324,1146
9220,0,0,41,0,-41
9221,1,0,43,0,-43
9222,1,0,23,0,-23
9223,0,0,118,0,-118
9224,1,1,191,1288,1097
9225,1,1,1127,2197,1070
9226,1,0,28,0,-28
9227,0,0,16,0,-16
9228,1,0,71,0,-71
9229,0,0,2,0,-2
9230,1,0,42,0,-42
9231,1,1,339,1254,915
9232,1,1,128,1276,1148
9233,0,0,5,0,-5
9234,1,1,273,1328,1055
9235,1,0,0,0,0
9236,1,0,16,0,-16
9237,1,1,1193,1378,185
9238,1,0,8,0,-8
9239,0,0,42,0,-42
9240,1,0,37,0,-37
9241,0,0,2,0,-2
9242,1,0,153,0,-153
9243,0,0,11,0,-11
9244,0,0,121,0,-121
9245,1,0,96,0,-96
9246,1,1,958,2501,1543
9247,1,1,536,1206,670
9248,1,1,406,1316,910
9249,1,1,93,1478,1385
9250,1,1,224,1275,1051
9251,1,1,2173,1715,-458
9252,0,0,22,0,-22
9253,1,0,69,0,-69
9254,1,1,1395,1485,90
9255,1,1,192,1526,1334
9256,1,1,293,1375,1082
9257,1,1,335,1370,1035
9258,1,0,83,0,-83
9259,1,0,216,0,-216
9260,1,0,22,0,-22
9261,1,1,692,1283,591
9262,1,0,1,0,-1
9263,1,1,520,1260,740
9264,1,1,283,1522,1239
9265,1,1,309,1244,935
9266,1,0,42,0,-42
9267,1,0,24,0,-24
9268,1,0,44,0,-44
9269,1,0,43,0,-43
9270,0,0,2,0,-2
9271,0,0,9,0,-9
9272,1,1,356,1439,1083
9273,0,0,42,0,-42
9274,0,0,0,0,0
9275,0,0,8,0,-8
9276,1,1,443,1317,874
9277,0,0,33,0,-33
9278,1,0,14,0,-14
9279,0,0,7,0,-7
9280,1,1,120,1360,1240
9281,1,1,549,1221,672
9282,1,0,6,0,-6
9283,0,0,34,0,-34
9284,1,0,80,0,-80
9285,1,1,621,1468,847
9286,0,0,5,0,-5
9287,1,1,578,1268,690
9288,1,0,51,0,-51
9289,0,0,113,0,-113
9290,0,0,11,0,-11
9291,1,1,229,1245,1016
9292,1,0,47,0,-47
9293,0,0,49,0,-49
9294,1,0,182,0,-182
9295,0,0,52,0,-52
9296,1,0,50,0,-50
9297,1,1,477,1732,1255
9298,1,1,264,1685,1421
9299,0,0,75,0,-75
9300,1,0,20,0,-20
9301,1,1,190,1361,1171
9302,1,1,253,1416,1163
9303,1,1,706,4360,3654
9304,1,0,9,0,-9
9305,0,0,7,0,-7
9306,1,0,3,0,-3
9307,1,1,661,1205,544
9308,1,1,711,1422,711
9309,1,1,525,1449,924
9310,1,0,199,0,-199
9311,1,0,38,0,-38
9312,0,0,42,0,-42
9313,1,1,64,2490,2426
9314,1,1,243,1258,1015
9315,0,0,59,0,-59
9316,0,0,7,0,-7
9317,1,1,428,1377,949
9318,1,1,620,1440,820
9319,0,0,9,0,-9
9320,0,0,5,0,-5
9321,0,0,191,0,-191
9322,1,0,46,0,-46
9323,1,1,1337,1335,-2
9324,0,0,81,0,-81
9325,1,1,826,2100,1274
9326,0,0,240,0,-240
9327,1,1,175,1366,1191
9328,0,0,81,0,-81
9329,1,1,540,1217,677
9330,1,0,174,0,-174
9331,1,1,1680,2401,721
9332,0,0,37,0,-37
9333,1,1,167,1346,1179
9334,1,0,8,0,-8
9335,0,0,5,0,-5
9336,0,0,70,0,-70
9337,1,1,88,1743,1655
9338,0,0,8,0,-8
9339,1,1,1682,1482,-200
9340,1,1,198,1520,1322
9341,1,0,8,0,-8
9342,0,0,27,0,-27
9343,1,1,577,1940,1363
9344,1,1,153,1863,1710
9345,1,0,4,0,-4
9346,0,0,86,0,-86
9347,1,0,22,0,-22
9348,0,0,16,0,-16
9349,1,1,104,1551,1447
9350,1,1,961,1427,466
9351,1,0,17,0,-17
9352,1,0,1,0,-1
9353,1,0,11,0,-11
9354,0,0,3,0,-3
9355,1,0,139,0,-139
9356,1,1,896,1223,327
9357,0,0,28,0,-28
9358,1,0,21,0,-21
9359,1,0,49,0,-49
9360,1,1,402,1205,803
9361,0,0,23,0,-23
9362,1,1,473,1355,882
9363,1,1,303,1294,991
9364,1,0,29,0,-29
9365,0,0,80,0,-80
9366,0,0,32,0,-32
9367,0,0,30,0,-30
9368,1,0,12,0,-12
9369,0,0,8,0,-8
9370,0,0,89,0,-89
9371,0,0,230,0,-230
9372,1,0,12,0,-12
9373,1,0,20,0,-20
9374,1,1,162,1241,1079
9375,1,0,18,0,-18
9376,0,0,62,0,-62
9377,1,0,32,0,-32
9378,0,0,31,0,-31
9379,1,0,66,0,-66
9380,0,0,41,0,-41
9381,1,1,538,1245,707
9382,0,0,4,0,-4
9383,0,0,2,0,-2
9384,1,0,29,0,-29
9385,0,0,40,0,-40
9386,1,1,478,2825,2347
9387,1,1,655,1286,631
9388,1,1,254,1651,1397
9389,1,1,237,1678,1441
9390,1,1,314,1223,909
9391,0,0,17,0,-17
9392,0,0,0,0,0
9393,1,0,57,0,-57
9394,0,0,47,0,-47
9395,1,1,154,1466,1312
9396,0,0,5,0,-5
9397,0,0,47,0,-47
9398,1,0,4,0,-4
9399,1,0,44,0,-44
9400,0,0,21,0,-21
9401,1,1,1098,1404,306
9402,1,0,96,0,-96
9403,0,0,63,0,-63
9404,0,0,185,0,-185
9405,0,0,105,0,-105
9406,1,1,914,1318,404
9407,1,1,196,1610,1414
9408,1,0,8,0,-8
9409,1,1,388,1499,1111
9410,0,0,6,0,-6
9411,0,0,22,0,-22
9412,1,1,196,2205,2009
9413,0,0,14,0,-14
9414,0,0,71,0,-71
9415,1,0,124,0,-124
9416,0,0,22,0,-22
9417,0,0,35,0,-35
9418,1,1,1144,3045,1901
9419,1,0,138,0,-138
9420,1,0,119,0,-119
9421,1,1,172,1468,1296
9422,0,0,64,0,-64
9423,0,0,10,0,-10
9424,1,0,78,0,-78
9425,1,1,99,1225,1126
9426,1,1,340,1532,1192
9427,0,0,143,0,-143
9428,0,0,40,0,-40
9429,1,0,13,0,-13
9430,1,1,86,1343,1257
9431,1,0,19,0,-19
9432,1,0,30,0,-30
9433,1,0,53,0,-53
9434,1,0,11,0,-11
9435,0,0,23,0,-23
9436,1,0,2,0,-2
9437,1,1,309,1275,966
9438,1,0,11,0,-11
9439,1,0,87,0,-87
9440,1,1,182,2296,2114
9441,0,0,92,0,-92
9442,1,0,56,0,-56
9443,1,0,10,0,-10
9444,1,0,46,0,-46
9445,0,0,109,0,-109
9446,1,0,40,0,-40
9447,0,0,34,0,-34
9448,1,1,209,1272,1063
9449,1,1,270,1320,1050
9450,1,1,71,1267,1196
9451,1,0,102,0,-102
9452,0,0,97,0,-97
9453,0,0,28,0,-28
9454,0,0,36,0,-36
9455,1,0,51,0,-51
9456,1,0,59,0,-59
9457,0,0,70,0,-70
9458,1,0,89,0,-89
9459,1,1,702,1767,1065
9460,1,1,261,1677,1416
9461,1,0,81,0,-81
9462,0,0,22,0,-22
9463,1,0,38,0,-38
9464,1,1,258,1363,1105
9465,0,0,107,0,-107
9466,1,0,83,0,-83
9467,1,0,80,0,-80
9468,0,0,71,0,-71
9469,1,1,612,1592,980
9470,1,0,0,0,0
9471,1,0,40,0,-40
9472,1,1,966,3137,2171
9473,0,0,113,0,-113
9474,1,0,86,0,-86
9475,0,0,107,0,-107
9476,0,0,1,0,-1
9477,1,0,7,0,-7
9478,1,1,1345,1281,-64
9479,0,0,234,0,-234
9480,1,0,10,0,-10
9481,1,1,100,1671,1571
9482,1,0,67,0,-67
9483,0,0,22,0,-22
9484,1,0,35,0,-35
9485,1,0,14,0,-14
9486,0,0,88,0,-88
9487,1,1,783,1601,818
9488,1,1,232,1554,1322
9489,0,0,74,0,-74
9490,0,0,24,0,-24
9491,1,0,16,0,-16
9492,0,0,5,0,-5
9493,1,0,30,0,-30
9494,1,1,75,2586,2511
9495,1,1,481,2326,1845
9496,0,0,19,0,-19
9497,1,1,730,1325,595
9498,1,0,24,0,-24
9499,0,0,113,0,-113
9500,0,0,9,0,-9
9501,1,1,564,1436,872
9502,0,0,3,0,-3
9503,1,0,21,0,-21
9504,1,0,16,0,-16
9505,1,1,439,2041,1602
9506,0,0,39,0,-39
9507,1,0,56,0,-56
9508,1,0,5,0,-5
9509,0,0,10,0,-10
9510,1,0,33,0,-33
9511,1,1,844,1553,709
9512,0,0,35,0,-35
9513,1,1,426,1254,828
9514,0,0,50,0,-50
9515,1,1,53,1772,1719
9516,0,0,7,0,-7
9517,1,0,21,0,-21
9518,1,0,6,0,-6
9519,0,0,36,0,-36
9520,0,0,28,0,-28
9521,0,0,63,0,-63
9522,0,0,4,0,-4
9523,1,0,86,0,-86
9524,1,0,9,0,-9
9525,1,0,36,0,-36
9526,1,0,67,0,-67
9527,1,0,42,0,-42
9528,1,1,865,1226,361
9529,0,0,42,0,-42
9530,0,0,80,0,-80
9531,1,1,966,1424,458
9532,1,1,198,1293,1095
9533,1,1,1304,1567,263
9534,0,0,24,0,-24
9535,1,0,1,0,-1
9536,1,1,372,2006,1634
9537,1,0,19,0,-19
9538,0,0,5,0,-5
9539,0,0,22,0,-22
9540,1,1,260,1858,1598
9541,0,0,0,0,0
9542,1,0,134,0,-134
9543,0,0,49,0,-49
9544,0,0,131,0,-131
9545,0,0,150,0,-150
9546,0,0,53,0,-53
9547,1,0,114,0,-114
9548,0,0,12,0,-12
9549,1,1,255,1361,1106
9550,1,0,114,0,-114
9551,1,1,1212,4446,3234
9552,1,1,253,1257,1004
9553,1,1,95,2483,2388
9554,1,0,26,0,-26
9555,0,0,63,0,-63
9556,1,0,155,0,-155
9557,1,1,322,1649,1327
9558,1,0,22,0,-22
9559,0,0,39,0,-39
9560,1,1,380,1313,933
9561,1,1,294,1268,974
9562,1,1,430,1506,1076
9563,1,0,28,0,-28
9564,1,1,313,1355,1042
9565,0,0,99,0,-99
9566,0,0,83,0,-83
9567,1,0,98,0,-98
9568,0,0,67,0,-67
9569,0,0,99,0,-99
9570,0,0,56,0,-56
9571,1,1,139,1305,1166
9572,1,1,85,2368,2283
9573,1,1,1500,1214,-286
9574,0,0,30,0,-30
9575,0,0,23,0,-23
9576,1,1,157,1244,1087
9577,1,1,1492,1764,272
9578,1,0,10,0,-10
9579,1,1,290,2086,1796
9580,0,0,1,0,-1
9581,1,1,556,1424,868
9582,0,0,58,0,-58
9583,0,0,127,0,-127
9584,1,0,51,0,-51
9585,1,1,276,1747,1471
9586,0,0,28,0,-28
9587,1,1,277,1783,1506
9588,0,0,8,0,-8
9589,0,0,20,0,-20
9590,0,0,13,0,-13
9591,1,0,99,0,-99
9592,1,1,116,1930,1814
9593,0,0,15,0,-15
9594,0,0,142,0,-142
9595,0,0,77,0,-77
9596,1,0,95,0,-95
9597,1,0,122,0,-122
9598,1,0,84,0,-84
9599,0,0,10,0,-10
9600,1,1,1421,1953,532
9601,0,0,7,0,-7
9602,0,0,127,0,-127
9603,1,0,97,0,-97
9604,0,0,66,0,-66
9605,1,0,30,0,-30
9606,0,0,10,0,-10
9607,1,0,93,0,-93
9608,1,1,592,1377,785
9609,0,0,8,0,-8
9610,1,1,471,1773,1302
9611,0,0,4,0,-4
9612,1,0,9,0,-9
9613,1,1,148,1950,1802
9614,1,0,114,0,-114
9615,1,0,3,0,-3
9616,1,0,75,0,-75
9617,0,0,32,0,-32
9618,1,0,50,0,-50
9619,0,0,22,0,-22
9620,0,0,2,0,-2
9621,0,0,4,0,-4
9622,1,1,521,2058,1537
9623,0,0,19,0,-19
9624,1,1,297,1288,991
9625,0,0,6,0,-6
9626,1,0,34,0,-34
9627,0,0,72,0,-72
9628,0,0,49,0,-49
9629,1,0,9,0,-9
9630,1,1,52,1651,1599
9631,1,0,61,0,-61
9632,1,0,147,0,-147
9633,1,0,27,0,-27
9634,0,0,94,0,-94
9635,1,1,156,1421,1265
9636,0,0,2,0,-2
9637,0,0,2,0,-2
9638,1,0,35,0,-35
9639,1,1,360,1343,983
9640,0,0,3,0,-3
9641,1,1,727,1327,600
9642,0,0,8,0,-8
9643,0,0,33,0,-33
9644,0,0,16,0,-16
9645,0,0,8,0,-8
9646,1,0,13,0,-13
9647,1,1,544,1274,730
9648,0,0,54,0,-54
9649,1,1,532,3055,2523
9650,1,1,203,1237,1034
9651,1,1,88,1510,1422
9652,0,0,50,0,-50
9653,1,1,248,1293,1045
9654,1,0,7,0,-7
9655,1,0,27,0,-27
9656,1,1,303,1428,1125
9657,1,1,1689,2027,338
9658,1,0,71,0,-71
9659,0,0,13,0,-13
9660,1,1,229,1404,1175
9661,0,0,58,0,-58
9662,1,0,59,0,-59
9663,1,0,1,0,-1
9664,1,1,1331,1203,-128
9665,1,1,759,1237,478
9666,1,0,18,0,-18
9667,1,1,57,1598,1541
9668,1,0,62,0,-62
9669,1,1,604,1601,997
9670,1,0,8,0,-8
9671,1,1,84,1289,1205
9672,1,0,4,0,-4
9673,0,0,41,0,-41
9674,0,0,157,0,-157
9675,1,1,339,1587,1248
9676,0,0,22,0,-22
9677,0,0,11,0,-11
9678,0,0,31,0,-31
9679,0,0,7,0,-7
9680,1,0,63,0,-63
9681,0,0,51,0,-51
9682,1,0,8,0,-8
9683,1,1,353,1452,1099
9684,1,0,24,0,-24
9685,1,0,69,0,-69
9686,0,0,78,0,-78
9687,1,1,825,2694,1869
9688,1,0,94,0,-94
9689,1,1,84,2682,2598
9690,0,0,4,0,-4
9691,1,1,182,1465,1283
9692,0,0,46,0,-46
9693,0,0,74,0,-74
9694,0,0,96,0,-96
9695,1,0,40,0,-40
9696,1,0,0,0,0
9697,0,0,21,0,-21
9698,0,0,39,0,-39
9699,0,0,1,0,-1
9700,1,0,77,0,-77
9701,0,0,179,0,-179
9702,1,1,1640,1281,-359
9703,1,1,1190,1562,372
9704,1,0,5,0,-5
9705,1,0,7,0,-7
9706,1,0,50,0,-50
9707,1,0,46,0,-46
9708,1,0,46,0,-46
9709,0,0,65,0,-65
9710,0,0,30,0,-30
9711,0,0,12,0,-12
9712,0,0,100,0,-100
9713,1,0,83,0,-83
9714,1,0,16,0,-16
9715,0,0,63,0,-63
9716,1,1,1162,2074,912
9717,0,0,18,0,-18
9718,0,0,16,0,-16
9719,0,0,20,0,-20
9720,0,0,70,0,-70
9721,1,0,45,0,-45
9722,0,0,20,0,-20
9723,1,0,23,0,-23
9724,0,0,41,0,-41
9725,0,0,54,0,-54
9726,1,1,49,1377,1328
9727,1,1,1998,1318,-680
9728,1,0,28,0,-28
9729,0,0,38,0,-38
9730,0,0,34,0,-34
9731,0,0,14,0,-14
9732,0,0,15,0,-15
9733,0,0,109,0,-109
9734,0,0,103,0,-103
9735,1,0,85,0,-85
9736,0,0,39,0,-39
9737,0,0,16,0,-16
9738,1,0,164,0,-164
9739,1,0,32,0,-32
9740,1,0,131,0,-131
9741,1,0,0,0,0
9742,0,0,20,0,-20
9743,1,1,304,1216,912
9744,1,0,23,0,-23
9745,1,1,193,1581,1388
9746,0,0,21,0,-21
9747,1,1,832,1228,396
9748,1,1,649,1315,666
9749,1,0,4,0,-4
9750,1,1,1535,1488,-47
9751,1,1,444,2874,2430
9752,1,1,461,1360,899
9753,0,0,11,0,-11
9754,0,0,47,0,-47
9755,1,1,944,1383,439
9756,1,1,233,2769,2536
9757,1,1,217,2517,2300
9758,1,0,130,0,-130
9759,0,0,34,0,-34
9760,1,1,714,2178,1464
9761,1,1,430,1316,886
9762,1,0,63,0,-63
9763,0,0,57,0,-57
9764,0,0,51,0,-51
9765,1,1,780,1255,475
9766,0,0,40,0,-40
9767,1,0,39,0,-39
9768,1,0,62,0,-62
9769,1,0,59,0,-59
9770,0,0,43,0,-43
9771,0,0,41,0,-41
9772,0,0,162,0,-162
9773,1,0,11,0,-11
9774,1,0,80,0,-80
9775,1,1,202,6801,6599
9776,1,0,5,0,-5
9777,1,1,468,1399,931
9778,0,0,104,0,-104
9779,1,0,6,0,-6
9780,0,0,0,0,0
9781,1,0,4,0,-4
9782,1,1,514,1296,782
9783,0,0,10,0,-10
9784,1,1,784,1442,658
9785,0,0,35,0,-35
9786,1,0,1,0,-1
9787,1,1,2739,1208,-1531
9788,1,0,124,0,-124
9789,1,1,309,1437,1128
9790,0,0,41,0,-41
9791,1,0,23,0,-23
9792,0,0,17,0,-17
9793,1,0,152,0,-152
9794,1,1,715,2406,1691
9795,1,1,290,1389,1099
9796,1,0,103,0,-103
9797,0,0,45,0,-45
9798,0,0,43,0,-43
9799,0,0,9,0,-9
9800,0,0,7,0,-7
9801,1,0,15,0,-15
9802,1,0,41,0,-41
9803,0,0,6,0,-6
9804,0,0,96,0,-96
9805,1,1,314,1354,1040
9806,1,0,12,0,-12
9807,1,0,135,0,-135
9808,1,1,223,1215,992
9809,0,0,108,0,-108
9810,1,1,545,1239,694
9811,1,0,4,0,-4
9812,1,0,27,0,-27
9813,1,1,509,1558,1049
9814,1,0,41,0,-41
9815,0,0,17,0,-17
9816,1,0,13,0,-13
9817,0,0,41,0,-41
9818,1,1,455,1233,778
9819,1,0,0,0,0
9820,0,0,68,0,-68
9821,1,0,1,0,-1
9822,0,0,64,0,-64
9823,1,1,154,1741,1587
9824,0,0,176,0,-176
9825,0,0,109,0,-109
9826,1,0,5,0,-5
9827,0,0,45,0,-45
9828,0,0,77,0,-77
9829,1,0,22,0,-22
9830,1,0,9,0,-9
9831,0,0,23,0,-23
9832,1,1,290,1303,1013
9833,0,0,77,0,-77
9834,0,0,4,0,-4
9835,1,1,974,1412,438
9836,0,0,20,0,-20
9837,0,0,14,0,-14
9838,1,0,34,0,-34
9839,1,0,78,0,-78
9840,0,0,53,0,-53
9841,0,0,29,0,-29
9842,1,1,1048,1665,617
9843,0,0,10,0,-10
9844,0,0,9,0,-9
9845,1,0,47,0,-47
9846,1,0,81,0,-81
9847,1,1,745,1269,524
9848,0,0,56,0,-56
9849,0,0,44,0,-44
9850,1,1,774,2349,1575
9851,1,0,43,0,-43
9852,0,0,105,0,-105
9853,1,0,26,0,-26
9854,0,0,31,0,-31
9855,0,0,90,0,-90
9856,0,0,15,0,-15
9857,1,0,17,0,-17
9858,1,0,27,0,-27
9859,1,1,174,1393,1219
9860,0,0,7,0,-7
9861,1,1,497,1296,799
9862,0,0,95,0,-95
9863,0,0,63,0,-63
9864,0,0,189,0,-189
9865,1,1,209,1541,1332
9866,0,0,12,0,-12
9867,0,0,5,0,-5
9868,1,0,40,0,-40
9869,1,0,9,0,-9
9870,1,1,28,1467,1439
9871,0,0,21,0,-21
9872,1,0,19,0,-19
9873,0,0,5,0,-5
9874,1,1,240,1275,1035
9875,0,0,36,0,-36
9876,0,0,187,0,-187
9877,1,0,64,0,-64
9878,1,0,19,0,-19
9879,0,0,100,0,-100
9880,0,0,136,0,-136
9881,0,0,37,0,-37
9882,0,0,2,0,-2
9883,0,0,33,0,-33
9884,1,0,28,0,-28
9885,1,1,826,1487,661
9886,1,1,1041,1602,561
9887,1,1,907,1212,305
9888,0,0,7,0,-7
9889,1,1,465,1215,750
9890,1,0,58,0,-58
9891,0,0,92,0,-92
9892,0,0,11,0,-11
9893,0,0,16,0,-16
9894,0,0,82,0,-82
9895,1,1,225,1266,1041
9896,1,1,612,1397,785
9897,0,0,0,0,0
9898,1,0,57,0,-57
9899,0,0,43,0,-43
9900,0,0,70,0,-70
9901,1,0,39,0,-39
9902,1,0,26,0,-26
9903,0,0,19,0,-19
9904,1,1,608,1266,658
9905,0,0,30,0,-30
9906,1,0,17,0,-17
9907,0,0,25,0,-25
9908,1,1,148,1224,1076
9909,1,0,17,0,-17
9910,1,1,418,1872,1454
9911,0,0,8,0,-8
9912,1,0,131,0,-131
9913,1,1,648,1398,750
9914,1,0,82,0,-82
9915,0,0,14,0,-14
9916,1,0,62,0,-62
9917,1,0,10,0,-10
9918,1,1,1740,1404,-336
9919,0,0,8,0,-8
9920,1,1,297,2013,1716
9921,0,0,84,0,-84
9922,1,1,683,1375,692
9923,0,0,139,0,-139
9924,1,1,994,1413,419
9925,1,0,12,0,-12
9926,1,1,154,1311,1157
9927,1,1,913,1224,311
9928,1,1,1808,1363,-445
9929,1,1,233,1272,1039
9930,1,0,22,0,-22
9931,1,0,48,0,-48
9932,1,0,4,0,-4
9933,1,1,98,1201,1103
9934,1,0,16,0,-16
9935,0,0,10,0,-10
9936,1,0,57,0,-57
9937,0,0,133,0,-133
9938,0,0,165,0,-165
9939,0,0,6,0,-6
9940,0,0,8,0,-8
9941,0,0,54,0,-54
9942,0,0,6,0,-6
9943,0,0,108,0,-108
9944,1,0,1,0,-1
9945,0,0,37,0,-37
9946,1,0,34,0,-34
9947,0,0,18,0,-18
9948,1,0,105,0,-105
9949,0,0,55,0,-55
9950,1,0,15,0,-15
9951,1,0,43,0,-43
9952,0,0,8,0,-8
9953,0,0,175,0,-175
9954,1,1,840,2892,2052
9955,1,1,861,1262,401
9956,1,0,11,0,-11
9957,1,1,205,1301,1096
9958,1,1,272,1576,1304
9959,1,0,33,0,-33
9960,1,0,60,0,-60
9961,1,0,3,0,-3
9962,1,0,11,0,-11
9963,1,0,35,0,-35
9964,0,0,70,0,-70
9965,0,0,31,0,-31
9966,0,0,10,0,-10
9967,1,1,455,1277,822
9968,1,0,37,0,-37
9969,1,1,1515,1821,306
9970,1,1,387,1328,941
9971,0,0,17,0,-17
9972,0,0,41,0,-41
9973,1,0,22,0,-22
9974,1,0,18,0,-18
9975,1,0,4,0,-4
9976,0,0,73,0,-73
9977,0,0,53,0,-53
9978,0,0,2,0,-2
9979,1,1,624,1264,640
9980,0,0,78,0,-78
9981,1,1,2178,1529,-649
9982,1,1,389,1362,973
9983,1,0,5,0,-5
9984,1,1,191,1433,1242
9985,1,1,75,1622,1547
9986,1,0,8,0,-8
9987,0,0,203,0,-203
9988,1,0,41,0,-41
9989,1,1,131,1233,1102
9990,0,0,171,0,-171
9991,1,1,137,1320,1183
9992,1,1,158,1969,1811
9993,1,1,580,1256,676
9994,0,0,42,0,-42
9995,0,0,22,0,-22
9996,1,1,208,1579,1371
9997,1,0,71,0,-71
9998,1,0,12,0,-12
9999,1,1,261,1264,1003
10000,0,0,204,0,-204
10001,0,0,31,0,-31
10002,1,1,609,1324,715
10003,0,0,95,0,-95
10004,1,0,14,0,-14
10005,1,0,5,0,-5
10006,1,1,826,1335,509
10007,1,1,579,1607,1028
10008,1,0,6,0,-6
10009,1,1,129,1298,1169
10010,1,0,15,0,-15
10011,1,0,14,0,-14
10012,0,0,45,0,-45
10013,1,1,358,2063,1705
10014,0,0,18,0,-18
10015,0,0,78,0,-78
10016,1,0,2,0,-2
10017,1,0,23,0,-23
10018,1,0,11,0,-11
10019,0,0,13,0,-13
10020,0,0,12,0,-12
10021,0,0,33,0,-33
10022,1,1,863,1395,532
10023,1,1,1090,1775,685
10024,1,0,61,0,-61
10025,1,0,43,0,-43
10026,0,0,3,0,-3
10027,1,1,914,1231,317
10028,0,0,28,0,-28
10029,0,0,18,0,-18
10030,1,1,837,1236,399
10031,1,0,29,0,-29
10032,1,1,1053,1266,213
10033,1,1,1253,1292,39
10034,0,0,63,0,-63
10035,1,1,285,1599,1314
10036,1,1,617,1990,1373
10037,1,0,43,0,-43
10038,1,0,43,0,-43
10039,1,0,31,0,-31
10040,0,0,39,0,-39
10041,1,1,1092,2927,1835
10042,1,1,703,1232,529
10043,1,0,47,0,-47
10044,0,0,106,0,-106
10045,0,0,10,0,-10
10046,0,0,32,0,-32
10047,1,0,30,0,-30
10048,1,0,85,0,-85
10049,0,0,85,0,-85
10050,1,0,52,0,-52
10051,1,1,623,1485,862
10052,0,0,62,0,-62
10053,1,1,157,1658,1501
10054,0,0,35,0,-35
10055,0,0,185,0,-185
10056,0,0,18,0,-18
10057,1,0,25,0,-25
10058,0,0,88,0,-88
10059,1,1,79,1488,1409
10060,1,0,47,0,-47
10061,0,0,193,0,-193
10062,1,1,663,1206,543
10063,1,0,107,0,-107
10064,0,0,73,0,-73
10065,1,0,8,0,-8
10066,0,0,120,0,-120
10067,0,0,14,0,-14
10068,0,0,35,0,-35
10069,1,1,1280,1292,12
10070,0,0,61,0,-61
10071,0,0,37,0,-37
10072,1,0,40,0,-40
10073,1,1,334,1369,1035
10074,1,1,656,1427,771
10075,0,0,112,0,-112
10076,1,1,294,1345,1051
10077,1,0,5,0,-5
10078,1,0,115,0,-115
10079,0,0,48,0,-48
10080,0,0,114,0,-114
10081,0,0,38,0,-38
10082,1,0,0,0,0
10083,1,0,21,0,-21
10084,0,0,68,0,-68
10085,1,1,137,6038,5901
10086,1,0,132,0,-132
10087,0,0,82,0,-82
10088,0,0,8,0,-8
10089,0,0,2,0,-2
10090,1,0,8,0,-8
10091,0,0,98,0,-98
10092,1,1,138,1380,1242
10093,1,1,385,1386,1001
10094,0,0,54,0,-54
10095,1,0,14,0,-14
10096,1,0,131,0,-131
10097,0,0,108,0,-108
10098,1,1,371,1791,1420
10099,1,1,314,1445,1131
10100,1,1,231,1413,1182
10101,1,1,618,1353,735
10102,1,1,1100,1327,227
10103,0,0,32,0,-32
10104,1,0,6,0,-6
10105,0,0,108,0,-108
10106,1,1,335,1640,1305
10107,0,0,13,0,-13
10108,1,1,87,1563,1476
10109,0,0,12,0,-12
10110,1,1,425,1262,837
10111,1,0,61,0,-61
10112,1,0,2,0,-2
10113,0,0,28,0,-28
10114,1,1,301,1744,1443
10115,1,1,753,2114,1361
10116,1,1,613,1356,743
10117,1,1,135,2248,2113
10118,1,1,1380,1703,323
10119,1,1,403,1370,967
10120,0,0,0,0,0
10121,0,0,85,0,-85
10122,1,0,34,0,-34
10123,1,1,755,1497,742
10124,0,0,69,0,-69
10125,0,0,13,0,-13
10126,1,1,1154,1684,530
10127,1,0,86,0,-86
10128,0,0,62,0,-62
10129,1,0,10,0,-10
10130,1,0,20,0,-20
10131,1,0,45,0,-45
10132,1,1,347,3128,2781
10133,1,0,35,0,-35
10134,0,0,74,0,-74
10135,1,0,25,0,-25
10136,1,1,406,3070,2664
10137,1,1,296,1450,1154
10138,1,1,2228,1487,-741
10139,0,0,11,0,-11
10140,1,1,236,1367,1131
10141,0,0,63,0,-63
10142,1,1,402,1553,1151
10143,0,0,6,0,-6
10144,0,0,64,0,-64
10145,0,0,43,0,-43
10146,1,0,70,0,-70
10147,1,1,189,2123,1934
10148,1,1,225,1281,1056
10149,1,0,18,0,-18
10150,1,1,72,1632,1560
10151,1,1,676,1804,1128
10152,1,1,412,1347,935
10153,0,0,50,0,-50
10154,1,0,11,0,-11
10155,1,0,14,0,-14
10156,1,1,803,1315,512
10157,1,1,479,1591,1112
10158,1,0,31,0,-31
10159,0,0,26,0,-26
10160,1,1,820,1229,409
10161,1,1,251,1309,1058
10162,0,0,7,0,-7
10163,0,0,30,0,-30
10164,1,1,12,1266,1254
10165,0,0,51,0,-51
10166,0,0,6,0,-6
10167,1,0,6,0,-6
10168,1,0,40,0,-40
10169,0,0,107,0,-107
10170,1,0,5,0,-5
10171,1,1,151,1709,1558
10172,1,0,6,0,-6
10173,1,1,541,1780,1239
10174,0,0,44,0,-44
10175,1,0,16,0,-16
10176,1,1,478,1274,796
10177,1,1,415,1311,896
10178,0,0,54,0,-54
10179,1,1,1113,1508,395
10180,1,0,15,0,-15
10181,1,0,88,0,-88
10182,0,0,99,0,-99
10183,0,0,21,0,-21
10184,0,0,7,0,-7
10185,0,0,118,0,-118
10186,1,1,408,1343,935
10187,0,0,82,0,-82
10188,0,0,20,0,-20
10189,0,0,136,0,-136
10190,1,1,283,1286,1003
10191,0,0,75,0,-75
10192,0,0,51,0,-51
10193,1,1,16,1929,1913
10194,1,1,205,1584,1379
10195,0,0,11,0,-11
10196,1,1,155,2312,2157
10197,1,0,45,0,-45
10198,1,1,949,1510,561
10199,1,0,6,0,-6
10200,1,0,35,0,-35
10201,0,0,121,0,-121
10202,1,0,33,0,-33
10203,0,0,142,0,-142
10204,1,0,193,0,-193
10205,0,0,6,0,-6
10206,0,0,35,0,-35
10207,1,1,574,2024,1450
10208,1,0,20,0,-20
10209,1,0,30,0,-30
10210,1,0,91,0,-91
10211,0,0,37,0,-37
10212,0,0,40,0,-40
10213,1,1,686,1460,774
10214,1,1,284,1212,928
10215,1,0,62,0,-62
10216,1,0,24,0,-24
10217,1,1,325,1350,1025
10218,1,0,33,0,-33
10219,0,0,262,0,-262
10220,0,0,64,0,-64
10221,1,0,92,0,-92
10222,1,0,6,0,-6
10223,1,0,98,0,-98
10224,1,1,1888,1355,-533
10225,1,0,83,0,-83
10226,1,1,1004,3073,2069
10227,0,0,90,0,-90
10228,0,0,0,0,0
10229,0,0,20,0,-20
10230,1,0,25,0,-25
10231,1,0,1,0,-1
10232,0,0,13,0,-13
10233,1,1,64,1412,1348
10234,1,1,251,1809,1558
10235,1,1,465,1293,828
10236,1,1,654,1238,584
10237,0,0,101,0,-101
10238,1,0,15,0,-15
10239,1,0,1,0,-1
10240,1,1,388,1867,1479
10241,1,1,215,1222,1007
10242,1,1,267,1254,987
10243,1,1,169,1441,1272
10244,0,0,53,0,-53
10245,1,0,42,0,-42
10246,1,0,56,0,-56
10247,0,0,223,0,-223
10248,1,1,370,1893,1523
10249,1,0,53,0,-53
10250,1,1,507,1297,790
10251,1,0,58,0,-58
10252,0,0,87,0,-87
10253,1,0,21,0,-21
10254,1,0,6,0,-6
10255,1,1,1037,1277,240
10256,1,0,40,0,-40
10257,1,0,9,0,-9
10258,1,1,893,1231,338
10259,1,1,142,1597,1455
10260,0,0,35,0,-35
10261,1,1,1315,1361,46
10262,1,1,649,1270,621
10263,1,1,135,2745,2610
10264,0,0,79,0,-79
10265,0,0,68,0,-68
10266,0,0,17,0,-17
10267,1,0,21,0,-21
10268,1,1,239,1271,1032
10269,1,1,926,1203,277
10270,0,0,17,0,-17
10271,0,0,60,0,-60
10272,0,0,39,0,-39
10273,1,0,44,0,-44
10274,1,0,24,0,-24
10275,0,0,7,0,-7
10276,0,0,52,0,-52
10277,1,0,48,0,-48
10278,1,0,6,0,-6
10279,1,1,186,1367,1181
10280,0,0,146,0,-146
10281,1,0,4,0,-4
10282,1,1,174,1331,1157
10283,1,1,371,1235,864
10284,1,0,147,0,-147
10285,1,0,44,0,-44
10286,0,0,4,0,-4
10287,0,0,65,0,-65
10288,0,0,0,0,0
10289,0,0,22,0,-22
10290,1,1,463,2006,1543
10291,0,0,61,0,-61
10292,1,0,35,0,-35
10293,0,0,50,0,-50
10294,0,0,17,0,-17
10295,0,0,216,0,-216
10296,1,0,42,0,-42
10297,1,1,21,2028,2007
10298,1,1,215,1307,1092
10299,1,0,7,0,-7
10300,0,0,2,0,-2
10301,1,0,19,0,-19
10302,0,0,7,0,-7
10303,0,0,9,0,-9
10304,0,0,11,0,-11
10305,1,1,300,1260,960
10306,1,1,772,1570,798
10307,0,0,26,0,-26
10308,0,0,5,0,-5
10309,1,1,531,1236,705
10310,1,0,127,0,-127
10311,0,0,58,0,-58
10312,1,1,238,1269,1031
10313,1,0,21,0,-21
10314,0,0,45,0,-45
10315,0,0,7,0,-7
10316,0,0,147,0,-147
10317,1,0,9,0,-9
10318,0,0,16,0,-16
10319,0,0,17,0,-17
10320,1,0,39,0,-39
10321,0,0,20,0,-20
10322,1,0,101,0,-101
10323,0,0,42,0,-42
10324,1,0,51,0,-51
10325,1,0,10,0,-10
10326,1,1,702,1266,564
10327,1,0,193,0,-193
10328,0,0,44,0,-44
10329,1,0,120,0,-120
10330,0,0,10,0,-10
10331,0,0,51,0,-51
10332,1,0,58,0,-58
10333,1,0,12,0,-12
10334,1,0,53,0,-53
10335,1,1,1500,1331,-169
10336,0,0,17,0,-17
10337,1,1,615,1352,737
10338,1,0,6,0,-6
10339,1,0,77,0,-77
10340,1,0,86,0,-86
10341,1,0,37,0,-37
10342,0,0,25,0,-25
10343,1,0,205,0,-205
10344,1,0,6,0,-6
10345,1,1,363,1762,1399
10346,0,0,15,0,-15
10347,0,0,42,0,-42
10348,0,0,18,0,-18
10349,1,1,433,1568,1135
10350,0,0,33,0,-33
10351,0,0,158,0,-158
10352,0,0,19,0,-19
10353,1,1,515,1898,1383
10354,1,1,93,1636,1543
10355,0,0,42,0,-42
10356,1,1,153,1395,1242
10357,0,0,16,0,-16
10358,0,0,40,0,-40
10359,0,0,47,0,-47
10360,1,0,23,0,-23
10361,1,0,34,0,-34
10362,0,0,33,0,-33
10363,1,0,17,0,-17
10364,1,0,47,0,-47
10365,1,0,37,0,-37
10366,0,0,42,0,-42
10367,1,0,52,0,-52
10368,1,1,1050,1427,377
10369,0,0,129,0,-129
10370,1,0,48,0,-48
10371,0,0,12,0,-12
10372,1,1,66,1603,1537
10373,0,0,96,0,-96
10374,0,0,35,0,-35
10375,0,0,20,0,-20
10376,1,0,5,0,-5
10377,0,0,19,0,-19
10378,1,1,168,1590,1422
10379,1,1,175,1312,1137
10380,1,1,1138,1261,123
10381,1,1,92,1204,1112
10382,0,0,22,0,-22
10383,1,0,81,0,-81
10384,0,0,192,0,-192
10385,0,0,53,0,-53
10386,1,1,704,1416,712
10387,1,0,44,0,-44
10388,1,0,81,0,-81
10389,1,1,1118,1269,151
10390,1,0,77,0,-77
10391,1,1,86,3518,3432
10392,0,0,98,0,-98
10393,0,0,23,0,-23
10394,1,1,756,1400,644
10395,1,0,17,0,-17
10396,1,1,1159,1206,47
10397,1,1,451,1268,817
10398,1,1,110,2326,2216
10399,0,0,27,0,-27
10400,0,0,66,0,-66
10401,1,0,166,0,-166
10402,1,1,166,1295,1129
10403,1,1,266,1425,1159
10404,0,0,3,0,-3
10405,1,0,138,0,-138
10406,0,0,9,0,-9
10407,1,0,75,0,-75
10408,0,0,14,0,-14
10409,0,0,18,0,-18
10410,0,0,55,0,-55
10411,1,1,408,1215,807
10412,1,0,19,0,-19
10413,0,0,13,0,-13
10414,1,0,8,0,-8
10415,1,1,1104,1945,841
10416,0,0,192,0,-192
10417,1,0,5,0,-5
10418,1,1,652,2469,1817
10419,0,0,57,0,-57
10420,1,0,9,0,-9
10421,1,1,240,1434,1194
10422,1,1,67,1851,1784
10423,0,0,8,0,-8
10424,0,0,79,0,-79
10425,0,0,19,0,-19
10426,1,1,2812,1352,-1460
10427,0,0,3,0,-3
10428,1,0,21,0,-21
10429,1,1,237,1463,1226
10430,1,1,107,1620,1513
10431,1,0,3,0,-3
10432,1,0,127,0,-127
10433,1,0,3,0,-3
10434,1,0,14,0,-14
10435,1,1,382,1346,964
10436,1,1,179,1306,1127
10437,1,0,47,0,-47
10438,1,0,20,0,-20
10439,1,0,13,0,-13
10440,0,0,6,0,-6
10441,0,0,10,0,-10
10442,1,1,953,4037,3084
10443,0,0,24,0,-24
10444,1,1,116,1283,1167
10445,1,0,25,0,-25
10446,1,1,473,2622,2149
10447,1,0,61,0,-61
10448,1,1,282,2868,2586
10449,1,0,37,0,-37
10450,0,0,48,0,-48
10451,1,1,1142,1442,300
10452,0,0,33,0,-33
10453,0,0,165,0,-165
10454,1,1,360,1374,1014
10455,0,0,28,0,-28
10456,0,0,7,0,-7
10457,1,0,96,0,-96
10458,1,1,2008,1770,-238
10459,1,0,63,0,-63
10460,1,0,54,0,-54
10461,0,0,31,0,-31
10462,0,0,12,0,-12
10463,1,1,503,1273,770
10464,0,0,8,0,-8
10465,0,0,174,0,-174
10466,0,0,3,0,-3
10467,1,1,585,2023,1438
10468,1,1,30,1341,1311
10469,1,0,228,0,-228
10470,1,1,385,1591,1206
10471,0,0,38,0,-38
10472,1,1,1208,1275,67
10473,1,0,13,0,-13
10474,1,0,139,0,-139
10475,0,0,1,0,-1
10476,0,0,11,0,-11
10477,1,1,998,1277,279
10478,1,1,1355,1252,-103
10479,0,0,32,0,-32
10480,0,0,65,0,-65
10481,1,0,54,0,-54
10482,1,1,1366,2464,1098
10483,1,1,729,1524,795
10484,1,0,38,0,-38
10485,1,1,330,1432,1102
10486,0,0,0,0,0
10487,0,0,56,0,-56
10488,1,0,5,0,-5
10489,0,0,14,0,-14
10490,0,0,116,0,-116
10491,0,0,20,0,-20
10492,1,0,130,0,-130
10493,1,1,413,1687,1274
10494,1,0,0,0,0
10495,1,1,312,1788,1476
10496,1,0,3,0,-3
10497,0,0,50,0,-50
10498,1,0,26,0,-26
10499,0,0,87,0,-87
10500,1,1,872,1658,786
10501,0,0,35,0,-35
10502,1,0,9,0,-9
10503,1,0,160,0,-160
10504,1,1,479,1411,932
10505,1,0,1,0,-1
10506,1,1,548,1236,688
10507,0,0,132,0,-132
10508,1,1,1478,1388,-90
10509,0,0,72,0,-72
10510,1,1,382,1268,886
10511,1,1,181,1241,1060
10512,0,0,2,0,-2
10513,1,0,86,0,-86
10514,1,0,43,0,-43
10515,0,0,48,0,-48
10516,0,0,4,0,-4
10517,1,1,511,1800,1289
10518,1,1,748,1367,619
10519,1,1,30,1465,1435
10520,0,0,34,0,-34
10521,1,0,3,0,-3
10522,0,0,141,0,-141
10523,0,0,16,0,-16
10524,0,0,21,0,-21
10525,1,0,0,0,0
10526,0,0,89,0,-89
10527,0,0,62,0,-62
10528,0,0,51,0,-51
10529,1,0,168,0,-168
10530,1,0,112,0,-112
10531,0,0,19,0,-19
10532,0,0,74,0,-74
10533,0,0,27,0,-27
10534,1,0,70,0,-70
10535,1,1,245,1235,990
10536,1,1,593,1349,756
10537,1,0,41,0,-41
10538,1,0,92,0,-92
10539,1,1,1169,1309,140
10540,0,0,7,0,-7
10541,1,1,54,1261,1207
10542,0,0,121,0,-121
10543,0,0,86,0,-86
10544,0,0,84,0,-84
10545,0,0,24,0,-24
10546,0,0,0,0,0
10547,0,0,1,0,-1
10548,1,1,53,1330,1277
10549,0,0,47,0,-47
10550,0,0,149,0,-149
10551,1,0,100,0,-100
10552,0,0,98,0,-98
10553,1,0,29,0,-29
10554,1,1,183,2162,1979
10555,1,0,25,0,-25
10556,1,1,336,2944,2608
10557,1,0,34,0,-34
10558,0,0,52,0,-52
10559,1,0,11,0,-11
10560,0,0,23,0,-23
10561,1,1,212,1289,1077
10562,1,0,3,0,-3
10563,1,1,443,2244,1801
10564,1,1,252,1387,1135
10565,0,0,4,0,-4
10566,0,0,24,0,-24
10567,0,0,44,0,-44
10568,0,0,82,0,-82
10569,0,0,43,0,-43
10570,1,0,37,0,-37
10571,1,1,216,1543,1327
10572,1,1,173,1421,1248
10573,1,0,2,0,-2
10574,0,0,204,0,-204
10575,1,0,51,0,-51
10576,0,0,18,0,-18
10577,0,0,5,0,-5
10578,1,0,4,0,-4
10579,1,1,1129,1999,870
10580,1,1,98,1247,1149
10581,1,0,40,0,-40
10582,0,0,8,0,-8
10583,0,0,64,0,-64
10584,0,0,150,0,-150
10585,1,1,584,2807,2223
10586,0,0,32,0,-32
10587,1,1,59,1420,1361
10588,1,1,128,1420,1292
10589,1,0,166,0,-166
10590,1,0,121,0,-121
10591,1,0,45,0,-45
10592,0,0,29,0,-29
10593,0,0,32,0,-32
10594,0,0,175,0,-175
10595,1,0,14,0,-14
10596,1,1,150,1666,1516
10597,1,1,180,2016,1836
10598,0,0,61,0,-61
10599,1,1,1491,1427,-64
10600,0,0,37,0,-37
10601,0,0,4,0,-4
10602,1,1,1262,1528,266
10603,1,0,192,0,-192
10604,1,0,35,0,-35
10605,1,1,160,1370,1210
10606,1,1,679,1831,1152
10607,0,0,85,0,-85
10608,1,0,28,0,-28
10609,1,1,423,1522,1099
10610,1,0,24,0,-24
10611,0,0,113,0,-113
10612,0,0,1,0,-1
10613,0,0,56,0,-56
10614,1,1,62,1363,1301
10615,1,0,10,0,-10
10616,1,0,44,0,-44
10617,0,0,7,0,-7
10618,0,0,87,0,-87
10619,1,1,655,1251,596
10620,1,1,147,1641,1494
10621,0,0,14,0,-14
10622,1,0,39,0,-39
10623,0,0,80,0,-80
10624,1,0,52,0,-52
10625,1,1,1027,1214,187
10626,1,0,80,0,-80
10627,1,1,2367,1494,-873
10628,1,1,447,1259,812
10629,1,1,1490,1289,-201
10630,0,0,5,0,-5
10631,0,0,46,0,-46
10632,1,0,167,0,-167
10633,1,1,388,1552,1164
10634,0,0,30,0,-30
10635,0,0,17,0,-17
10636,0,0,164,0,-164
10637,0,0,0,0,0
10638,1,1,96,1289,1193
10639,1,0,46,0,-46
10640,0,0,92,0,-92
10641,1,0,24,0,-24
10642,1,0,9,0,-9
10643,1,1,152,1464,1312
10644,0,0,63,0,-63
10645,1,1,430,1228,798
10646,0,0,34,0,-34
10647,0,0,28,0,-28
10648,1,0,134,0,-134
10649,1,0,0,0,0
10650,0,0,68,0,-68
10651,1,0,29,0,-29
10652,0,0,110,0,-110
10653,1,1,864,1444,580
10654,1,1,208,1322,1114
10655,1,1,505,1439,934
10656,0,0,127,0,-127
10657,0,0,38,0,-38
10658,0,0,110,0,-110
10659,1,0,15,0,-15
10660,0,0,4,0,-4
10661,0,0,8,0,-8
10662,0,0,109,0,-109
10663,1,0,78,0,-78
10664,1,0,11,0,-11
10665,0,0,51,0,-51
10666,1,1,676,1490,814
10667,0,0,50,0,-50
10668,1,1,1160,1362,202
10669,1,0,10,0,-10
10670,1,0,3,0,-3
10671,0,0,91,0,-91
10672,1,0,22,0,-22
10673,1,0,2,0,-2
10674,1,1,1234,1741,507
10675,0,0,6,0,-6
10676,1,1,277,1277,1000
10677,1,1,1673,1565,-108
10678,1,1,933,2237,1304
10679,0,0,23,0,-23
10680,0,0,2,0,-2
10681,1,1,293,1791,1498
10682,1,1,588,1272,684
10683,1,0,35,0,-35
10684,1,1,768,2982,2214
10685,0,0,94,0,-94
10686,0,0,52,0,-52
10687,0,0,89,0,-89
10688,0,0,62,0,-62
10689,1,1,812,1307,495
10690,0,0,5,0,-5
10691,0,0,28,0,-28
10692,1,1,1403,1375,-28
10693,1,0,17,0,-17
10694,0,0,147,0,-147
10695,1,0,21,0,-21
10696,1,1,330,1375,1045
10697,1,1,581,1307,726
10698,0,0,8,0,-8
10699,0,0,56,0,-56
10700,1,0,17,0,-17
10701,0,0,106,0,-106
10702,1,1,813,1204,391
10703,1,1,170,1314,1144
10704,1,0,179,0,-179
10705,1,0,20,0,-20
10706,0,0,62,0,-62
10707,1,0,95,0,-95
10708,1,1,914,1486,572
10709,0,0,17,0,-17
10710,1,1,2132,3583,1451
10711,0,0,64,0,-64
10712,1,1,347,1963,1616
10713,1,0,51,0,-51
10714,1,1,336,1265,929
10715,1,0,16,0,-16
10716,0,0,15,0,-15
10717,0,0,87,0,-87
10718,1,0,43,0,-43
10719,0,0,22,0,-22
10720,1,1,372,1274,902
10721,1,1,1651,5211,3560
10722,1,0,16,0,-16
10723,1,0,8,0,-8
10724,1,1,524,4104,3580
10725,0,0,31,0,-31
10726,1,0,1,0,-1
10727,1,0,67,0,-67
10728,1,1,1530,1955,425
10729,1,0,62,0,-62
10730,1,0,34,0,-34
10731,1,0,98,0,-98
10732,1,1,1510,1352,-158
10733,0,0,271,0,-271
10734,0,0,56,0,-56
10735,1,0,127,0,-127
10736,0,0,59,0,-59
10737,0,0,102,0,-102
10738,0,0,55,0,-55
10739,1,1,206,1219,1013
10740,1,0,39,0,-39
10741,1,1,811,1537,726
10742,0,0,21,0,-21
10743,0,0,47,0,-47
10744,0,0,4,0,-4
10745,1,1,995,1380,385
10746,0,0,7,0,-7
10747,0,0,22,0,-22
10748,1,0,19,0,-19
10749,1,1,476,1585,1109
10750,1,1,279,1231,952
10751,1,1,600,1585,985
10752,0,0,58,0,-58
10753,1,0,5,0,-5
10754,1,1,274,1279,1005
10755,1,1,188,1377,1189
10756,0,0,50,0,-50
10757,1,0,25,0,-25
10758,0,0,40,0,-40
10759,0,0,127,0,-127
10760,0,0,26,0,-26
10761,1,1,1711,1277,-434
10762,1,1,978,1574,596
10763,1,1,373,1311,938
10764,0,0,1,0,-1
10765,1,0,3,0,-3
10766,1,1,575,1302,727
10767,1,1,877,1655,778
10768,0,0,67,0,-67
10769,1,0,28,0,-28
10770,1,1,161,1635,1474
10771,1,0,3,0,-3
10772,1,1,234,1240,1006
10773,1,0,19,0,-19
10774,1,1,418,1222,804
10775,0,0,13,0,-13
10776,1,0,32,0,-32
10777,1,1,1242,1479,237
10778,1,0,139,0,-139
10779,0,0,9,0,-9
10780,1,1,560,1216,656
10781,0,0,44,0,-44
10782,0,0,64,0,-64
10783,1,0,68,0,-68
10784,0,0,65,0,-65
10785,1,0,22,0,-22
10786,1,1,450,1233,783
10787,1,1,84,1232,1148
10788,1,0,98,0,-98
10789,0,0,100,0,-100
10790,1,0,38,0,-38
10791,1,0,114,0,-114
10792,1,0,8,0,-8
10793,0,0,80,0,-80
10794,1,1,225,1443,1218
10795,0,0,166,0,-166
10796,1,1,274,1479,1205
10797,0,0,111,0,-111
10798,1,1,49,1744,1695
10799,1,1,529,1434,905
10800,1,0,51,0,-51
10801,0,0,17,0,-17
10802,1,0,45,0,-45
10803,0,0,17,0,-17
10804,0,0,20,0,-20
10805,0,0,77,0,-77
10806,0,0,23,0,-23
10807,1,0,8,0,-8
10808,1,1,735,1237,502
10809,0,0,58,0,-58
10810,0,0,28,0,-28
10811,1,0,8,0,-8
10812,0,0,13,0,-13
10813,1,1,473,1453,980
10814,1,0,17,0,-17
10815,1,1,631,1705,1074
10816,0,0,65,0,-65
10817,0,0,19,0,-19
10818,1,1,87,1514,1427
10819,0,0,114,0,-114
10820,0,0,64,0,-64
10821,1,1,311,1913,1602
10822,0,0,0,0,0
10823,1,1,292,2200,1908
10824,1,0,8,0,-8
10825,0,0,175,0,-175
10826,1,0,0,0,0
10827,1,0,159,0,-159
10828,0,0,17,0,-17
10829,1,1,119,1488,1369
10830,1,1,30,1219,1189
10831,1,1,719,1731,1012
10832,1,1,765,1348,583
10833,0,0,74,0,-74
10834,0,0,0,0,0
10835,0,0,14,0,-14
10836,1,0,33,0,-33
10837,0,0,23,0,-23
10838,0,0,223,0,-223
10839,0,0,84,0,-84
10840,0,0,84,0,-84
10841,0,0,130,0,-130
10842,1,0,11,0,-11
10843,1,0,2,0,-2
10844,1,1,675,1331,656
10845,1,0,126,0,-126
10846,1,0,17,0,-17
10847,0,0,3,0,-3
10848,0,0,6,0,-6
10849,1,1,24,1292,1268
10850,1,1,272,1449,1177
10851,1,0,15,0,-15
10852,1,1,339,1287,948
10853,0,0,87,0,-87
10854,1,0,27,0,-27
10855,1,0,5,0,-5
10856,0,0,43,0,-43
10857,0,0,4,0,-4
10858,1,0,7,0,-7
10859,1,0,0,0,0
10860,1,0,56,0,-56
10861,1,0,51,0,-51
10862,0,0,35,0,-35
10863,0,0,254,0,-254
10864,1,0,10,0,-10
10865,1,0,84,0,-84
10866,0,0,30,0,-30
10867,0,0,332,0,-332
10868,0,0,23,0,-23
10869,1,0,5,0,-5
10870,1,1,89,1583,1494
10871,1,0,36,0,-36
10872,0,0,122,0,-122
10873,0,0,13,0,-13
10874,0,0,46,0,-46
10875,0,0,34,0,-34
10876,0,0,33,0,-33
10877,1,0,64,0,-64
10878,0,0,39,0,-39
10879,1,0,8,0,-8
10880,1,0,33,0,-33
10881,1,1,840,1274,434
10882,1,1,529,1287,758
10883,0,0,94,0,-94
10884,0,0,5,0,-5
10885,1,1,787,1282,495
10886,0,0,35,0,-35
10887,0,0,61,0,-61
10888,0,0,8,0,-8
10889,1,1,55,1355,1300
10890,0,0,38,0,-38
10891,0,0,85,0,-85
10892,0,0,77,0,-77
10893,0,0,46,0,-46
10894,1,1,540,1273,733
10895,1,1,1059,1270,211
10896,0,0,12,0,-12
10897,1,0,14,0,-14
10898,0,0,60,0,-60
10899,0,0,18,0,-18
10900,1,0,68,0,-68
10901,0,0,105,0,-105
10902,1,0,44,0,-44
10903,1,0,214,0,-214
10904,1,1,203,1341,1138
10905,1,1,689,2084,1395
10906,0,0,139,0,-139
10907,0,0,75,0,-75
10908,1,1,1623,1248,-375
10909,1,0,12,0,-12
10910,0,0,127,0,-127
10911,1,0,33,0,-33
10912,1,0,7,0,-7
10913,0,0,39,0,-39
10914,1,0,70,0,-70
10915,0,0,49,0,-49
10916,1,0,116,0,-116
10917,1,1,620,1238,618
10918,0,0,118,0,-118
10919,1,1,123,1912,1789
10920,1,0,36,0,-36
10921,1,0,114,0,-114
10922,1,1,686,1552,866
10923,1,1,906,2767,1861
10924,1,1,104,1245,1141
10925,0,0,95,0,-95
10926,1,1,448,1264,816
10927,0,0,28,0,-28
10928,0,0,0,0,0
10929,0,0,171,0,-171
10930,1,1,205,1904,1699
10931,1,1,522,1652,1130
10932,1,1,263,1777,1514
10933,0,0,77,0,-77
10934,1,0,24,0,-24
10935,1,0,70,0,-70
10936,0,0,20,0,-20
10937,1,1,105,1573,1468
10938,0,0,75,0,-75
10939,0,0,24,0,-24
10940,1,0,118,0,-118
10941,0,0,49,0,-49
10942,1,0,14,0,-14
10943,1,0,151,0,-151
10944,1,1,403,1350,947
10945,0,0,78,0,-78
10946,1,0,22,0,-22
10947,1,0,34,0,-34
10948,1,0,16,0,-16
10949,1,1,904,1570,666
10950,1,0,26,0,-26
10951,0,0,141,0,-141
10952,0,0,17,0,-17
10953,1,0,7,0,-7
10954,0,0,1,0,-1
10955,1,0,22,0,-22
10956,0,0,14,0,-14
10957,1,1,1273,1349,76
10958,1,1,825,1420,595
10959,1,0,55,0,-55
10960,0,0,30,0,-30
10961,0,0,38,0,-38
10962,0,0,154,0,-154
10963,1,1,594,1763,1169
10964,0,0,7,0,-7
10965,1,0,33,0,-33
10966,1,0,32,0,-32
10967,1,0,47,0,-47
10968,1,1,427,1817,1390
10969,1,0,40,0,-40
10970,1,1,828,2260,1432
10971,0,0,127,0,-127
10972,1,0,17,0,-17
10973,1,0,4,0,-4
10974,1,0,6,0,-6
10975,0,0,4,0,-4
10976,0,0,8,0,-8
10977,1,1,412,1246,834
10978,1,1,49,1361,1312
10979,0,0,6,0,-6
10980,0,0,10,0,-10
10981,0,0,78,0,-78
10982,0,0,30,0,-30
10983,1,1,898,1271,373
10984,1,1,133,2041,1908
10985,1,1,903,1645,742
10986,1,1,1927,1840,-87
10987,0,0,110,0,-110
10988,1,1,937,1838,901
10989,1,0,79,0,-79
10990,0,0,303,0,-303
10991,0,0,29,0,-29
10992,1,0,3,0,-3
10993,0,0,25,0,-25
10994,1,1,212,1624,1412
10995,0,0,27,0,-27
10996,1,1,419,1419,1000
10997,1,1,435,1236,801
10998,1,0,42,0,-42
10999,1,1,287,1311,1024
11000,0,0,37,0,-37
11001,0,0,48,0,-48
11002,1,1,250,1242,992
11003,0,0,42,0,-42
11004,1,1,1397,2191,794
11005,0,0,19,0,-19
11006,1,0,137,0,-137
11007,0,0,41,0,-41
11008,0,0,29,0,-29
11009,0,0,40,0,-40
11010,0,0,37,0,-37
11011,0,0,46,0,-46
11012,1,0,0,0,0
11013,0,0,65,0,-65
11014,1,0,15,0,-15
11015,1,0,121,0,-121
11016,0,0,1,0,-1
11017,1,1,531,1224,693
11018,1,0,53,0,-53
11019,1,1,204,1636,1432
11020,1,0,7,0,-7
11021,0,0,18,0,-18
11022,1,1,2757,1220,-1537
11023,1,0,4,0,-4
11024,0,0,129,0,-129
11025,0,0,22,0,-22
11026,0,0,37,0,-37
11027,0,0,43,0,-43
11028,1,0,54,0,-54
11029,1,1,65,1412,1347
11030,0,0,43,0,-43
11031,0,0,116,0,-116
11032,0,0,77,0,-77
11033,0,0,56,0,-56
11034,0,0,67,0,-67
11035,1,0,17,0,-17
11036,0,0,6,0,-6
11037,1,1,874,1648,774
11038,1,1,321,1486,1165
11039,1,1,618,1275,657
11040,0,0,49,0,-49
11041,1,0,0,0,0
11042,1,1,248,1431,1183
11043,1,0,52,0,-52
11044,1,0,4,0,-4
11045,1,0,58,0,-58
11046,0,0,7,0,-7
11047,1,1,1198,1281,83
11048,1,0,69,0,-69
11049,1,1,163,1368,1205
11050,1,1,1127,1644,517
11051,1,0,48,0,-48
11052,0,0,7,0,-7
11053,1,0,34,0,-34
11054,1,1,335,1251,916
11055,1,1,782,1287,505
11056,0,0,207,0,-207
11057,1,0,9,0,-9
11058,1,0,28,0,-28
11059,0,0,16,0,-16
11060,1,0,10,0,-10
11061,0,0,6,0,-6
11062,1,1,414,1293,879
11063,0,0,35,0,-35
11064,0,0,53,0,-53
11065,1,1,563,1686,1123
11066,1,0,0,0,0
11067,1,0,38,0,-38
11068,0,0,81,0,-81
11069,0,0,19,0,-19
11070,0,0,170,0,-170
11071,0,0,29,0,-29
11072,0,0,13,0,-13
11073,0,0,90,0,-90
11074,0,0,3,0,-3
11075,1,1,814,1264,450
11076,1,0,69,0,-69
11077,0,0,41,0,-41
11078,0,0,75,0,-75
11079,1,0,307,0,-307
11080,1,1,109,1412,1303
11081,0,0,20,0,-20
11082,1,1,225,1625,1400
11083,0,0,112,0,-112
11084,0,0,26,0,-26
11085,1,0,11,0,-11
11086,0,0,42,0,-42
11087,0,0,12,0,-12
11088,0,0,2,0,-2
11089,0,0,10,0,-10
11090,0,0,24,0,-24
11091,0,0,66,0,-66
11092,1,0,92,0,-92
11093,1,0,22,0,-22
11094,1,1,144,1318,1174
11095,1,0,13,0,-13
11096,0,0,39,0,-39
11097,1,0,47,0,-47
11098,1,1,373,1455,1082
11099,1,0,41,0,-41
11100,1,0,0,0,0
11101,0,0,29,0,-29
11102,1,1,537,1312,775
11103,1,0,54,0,-54
11104,1,0,33,0,-33
11105,0,0,47,0,-47
11106,1,1,667,9378,8711
11107,1,0,61,0,-61
11108,0,0,5,0,-5
11109,0,0,29,0,-29
11110,1,1,130,1227,1097
11111,1,1,440,1951,1511
11112,1,1,938,1275,337
11113,1,1,16,1396,1380
11114,1,1,123,1469,1346
11115,0,0,12,0,-12
11116,0,0,46,0,-46
11117,1,0,39,0,-39
11118,1,1,228,1220,992
11119,1,0,70,0,-70
11120,1,1,349,1989,1640
11121,1,1,424,1219,795
11122,0,0,8,0,-8
11123,1,0,30,0,-30
11124,0,0,1,0,-1
11125,1,0,22,0,-22
11126,0,0,43,0,-43
11127,1,0,64,0,-64
11128,0,0,32,0,-32
11129,1,1,929,1261,332
11130,1,1,207,1201,994
11131,0,0,56,0,-56
11132,0,0,34,0,-34
11133,1,1,2538,1218,-1320
11134,0,0,169,0,-169
11135,0,0,33,0,-33
11136,1,0,41,0,-41
11137,0,0,21,0,-21
11138,1,1,25,1405,1380
11139,0,0,79,0,-79
11140,1,1,928,1555,627
11141,1,1,568,1399,831
11142,1,1,836,1202,366
11143,0,0,10,0,-10
11144,1,1,64,1265,1201
11145,1,0,26,0,-26
11146,0,0,35,0,-35
11147,1,0,224,0,-224
11148,1,1,112,1210,1098
11149,1,1,684,1274,590
11150,1,1,699,1961,1262
11151,1,1,509,1407,898
11152,0,0,0,0,0
11153,1,1,838,1301,463
11154,1,1,57,1414,1357
11155,1,1,211,1414,1203
11156,1,0,19,0,-19
11157,0,0,15,0,-15
11158,0,0,56,0,-56
11159,1,0,15,0,-15
11160,1,0,79,0,-79
11161,1,1,156,1508,1352
11162,0,0,6,0,-6
11163,0,0,67,0,-67
11164,1,1,301,1421,1120
11165,1,0,114,0,-114
11166,1,0,147,0,-147
11167,1,1,358,1633,1275
11168,1,1,630,1252,622
11169,1,0,1,0,-1
11170,0,0,15,0,-15
11171,1,0,32,0,-32
11172,0,0,77,0,-77
11173,1,0,7,0,-7
11174,1,1,952,1410,458
11175,1,1,652,2425,1773
11176,0,0,5,0,-5
11177,1,0,48,0,-48
11178,0,0,44,0,-44
11179,1,1,827,1317,490
11180,1,0,48,0,-48
11181,1,1,266,1276,1010
11182,1,0,175,0,-175
11183,1,0,14,0,-14
11184,1,1,560,1695,1135
11185,1,0,95,0,-95
11186,1,0,1,0,-1
11187,0,0,76,0,-76
11188,1,1,455,1783,1328
11189,1,1,478,1327,849
11190,1,1,1378,1461,83
11191,0,0,22,0,-22
11192,1,0,55,0,-55
11193,0,0,111,0,-111
11194,1,0,11,0,-11
11195,1,1,486,1241,755
11196,1,0,24,0,-24
11197,0,0,18,0,-18
11198,1,1,212,1305,1093
11199,0,0,103,0,-103
11200,1,0,62,0,-62
11201,1,1,2374,2635,261
11202,0,0,14,0,-14
11203,1,1,335,1201,866
11204,0,0,24,0,-24
11205,1,1,364,1463,1099
11206,1,1,163,2049,1886
11207,1,0,22,0,-22
11208,1,0,9,0,-9
11209,1,1,529,1685,1156
11210,0,0,14,0,-14
11211,0,0,41,0,-41
11212,1,1,423,2191,1768
11213,1,1,482,2150,1668
11214,0,0,40,0,-40
11215,1,0,25,0,-25
11216,1,0,7,0,-7
11217,0,0,0,0,0
11218,1,0,39,0,-39
11219,1,1,83,1257,1174
11220,1,1,1325,1393,68
11221,1,0,24,0,-24
11222,1,1,796,2009,1213
11223,0,0,15,0,-15
11224,0,0,42,0,-42
11225,1,0,25,0,-25
11226,1,0,9,0,-9
11227,1,0,12,0,-12
11228,1,1,733,1247,514
11229,0,0,20,0,-20
11230,0,0,39,0,-39
11231,0,0,109,0,-109
11232,1,1,1388,1209,-179
11233,0,0,14,0,-14
11234,0,0,30,0,-30
11235,1,0,68,0,-68
11236,1,0,16,0,-16
11237,0,0,47,0,-47
11238,1,1,237,1449,1212
11239,0,0,4,0,-4
11240,0,0,5,0,-5
11241,1,0,31,0,-31
11242,1,0,5,0,-5
11243,0,0,11,0,-11
11244,1,0,113,0,-113
11245,0,0,11,0,-11
11246,1,0,409,0,-409
11247,0,0,139,0,-139
11248,0,0,9,0,-9
11249,1,0,109,0,-109
11250,0,0,158,0,-158
11251,1,0,31,0,-31
11252,0,0,40,0,-40
11253,1,1,1170,1224,54
11254,1,1,336,1950,1614
11255,1,1,1916,1293,-623
11256,1,0,1,0,-1
11257,0,0,49,0,-49
11258,0,0,22,0,-22
11259,0,0,5,0,-5
11260,0,0,104,0,-104
11261,1,0,59,0,-59
11262,0,0,8,0,-8
11263,1,1,94,1777,1683
11264,1,1,779,2223,1444
11265,0,0,57,0,-57
11266,1,0,23,0,-23
11267,1,1,686,1638,952
11268,0,0,56,0,-56
11269,1,0,52,0,-52
11270,1,0,141,0,-141
11271,1,1,681,1614,933
11272,0,0,12,0,-12
11273,0,0,40,0,-40
11274,0,0,29,0,-29
11275,1,1,756,1410,654
11276,1,1,109,1342,1233
11277,0,0,3,0,-3
11278,0,0,21,0,-21
11279,1,0,44,0,-44
11280,0,0,129,0,-129
11281,1,0,32,0,-32
11282,1,0,6,0,-6
11283,1,1,374,1271,897
11284,0,0,2,0,-2
11285,0,0,4,0,-4
11286,1,0,2,0,-2
11287,1,1,37,1249,1212
11288,1,0,6,0,-6
11289,1,1,213,1509,1296
11290,1,1,209,1354,1145
11291,1,1,1110,1943,833
11292,1,0,46,0,-46
11293,0,0,51,0,-51
11294,1,0,32,0,-32
11295,0,0,80,0,-80
11296,1,1,134,1363,1229
11297,1,1,380,2687,2307
11298,1,0,22,0,-22
11299,1,0,0,0,0
11300,0,0,35,0,-35
11301,1,0,29,0,-29
11302,1,1,1284,1275,-9
11303,1,1,74,1460,1386
11304,0,0,4,0,-4
11305,1,1,1675,1331,-344
11306,1,1,1162,1558,396
11307,1,1,347,1575,1228
11308,1,0,38,0,-38
11309,1,1,940,1586,646
11310,0,0,18,0,-18
11311,1,0,15,0,-15
11312,1,1,233,2211,1978
11313,1,1,279,1256,977
11314,0,0,29,0,-29
11315,0,0,14,0,-14
11316,1,0,132,0,-132
11317,0,0,3,0,-3
11318,1,1,233,1923,1690
11319,0,0,22,0,-22
11320,1,0,1,0,-1
11321,1,0,13,0,-13
11322,0,0,30,0,-30
11323,1,1,57,1598,1541
11324,1,0,118,0,-118
11325,1,0,43,0,-43
11326,0,0,17,0,-17
11327,1,0,123,0,-123
11328,0,0,10,0,-10
11329,1,1,3280,1261,-2019
11330,0,0,0,0,0
11331,1,0,134,0,-134
11332,0,0,28,0,-28
11333,0,0,6,0,-6
11334,1,1,83,1484,1401
11335,0,0,49,0,-49
11336,1,1,70,1266,1196
11337,0,0,6,0,-6
11338,1,0,7,0,-7
11339,1,0,17,0,-17
11340,0,0,61,0,-61
11341,0,0,89,0,-89
11342,0,0,19,0,-19
11343,0,0,148,0,-148
11344,1,1,255,2907,2652
11345,1,0,15,0,-15
11346,0,0,21,0,-21
11347,1,0,0,0,0
11348,1,0,63,0,-63
11349,1,0,3,0,-3
11350,1,0,56,0,-56
11351,1,0,22,0,-22
11352,0,0,2,0,-2
11353,0,0,51,0,-51
11354,0,0,87,0,-87
11355,0,0,39,0,-39
11356,0,0,169,0,-169
11357,0,0,19,0,-19
11358,1,1,1224,1847,623
11359,1,1,221,1804,1583
11360,1,1,361,1572,1211
11361,0,0,67,0,-67
11362,1,1,656,1672,1016
11363,0,0,3,0,-3
11364,1,1,303,1304,1001
11365,1,0,40,0,-40
11366,1,1,823,1218,395
11367,1,0,12,0,-12
11368,0,0,29,0,-29
11369,0,0,6,0,-6
11370,1,1,51,1297,1246
11371,0,0,23,0,-23
11372,1,0,15,0,-15
11373,1,1,394,1272,878
11374,0,0,29,0,-29
11375,1,1,174,1935,1761
11376,0,0,11,0,-11
11377,0,0,8,0,-8
11378,0,0,18,0,-18
11379,0,0,32,0,-32
11380,1,1,96,1856,1760
11381,1,0,64,0,-64
11382,1,1,388,2944,2556
11383,0,0,25,0,-25
11384,1,1,137,1390,1253
11385,1,0,25,0,-25
11386,1,0,7,0,-7
11387,1,1,201,1570,1369
11388,0,0,65,0,-65
11389,0,0,81,0,-81
11390,0,0,5,0,-5
11391,1,0,120,0,-120
11392,1,1,327,1806,1479
11393,0,0,93,0,-93
11394,1,0,8,0,-8
11395,1,1,731,1688,957
11396,0,0,10,0,-10
11397,0,0,124,0,-124
11398,0,0,37,0,-37
11399,1,0,86,0,-86
11400,0,0,47,0,-47
11401,1,1,2119,1269,-850
11402,1,1,540,1251,711
11403,0,0,15,0,-15
11404,1,1,1656,1297,-359
11405,1,1,404,1577,1173
11406,1,0,35,0,-35
11407,1,1,167,1375,1208
11408,1,1,305,2515,2210
11409,0,0,11,0,-11
11410,0,0,73,0,-73
11411,1,0,111,0,-111
11412,1,1,399,1863,1464
11413,0,0,62,0,-62
11414,1,0,3,0,-3
11415,1,1,712,1533,821
11416,1,0,145,0,-145
11417,0,0,75,0,-75
11418,1,1,168,1295,1127
11419,1,1,239,1805,1566
11420,1,0,0,0,0
11421,1,0,21,0,-21
11422,1,0,31,0,-31
11423,0,0,35,0,-35
11424,1,1,2196,1469,-727
11425,1,0,44,0,-44
11426,0,0,7,0,-7
11427,0,0,135,0,-135
11428,0,0,5,0,-5
11429,1,1,285,2119,1834
11430,0,0,150,0,-150
11431,1,0,77,0,-77
11432,1,0,64,0,-64
11433,0,0,56,0,-56
11434,0,0,117,0,-117
11435,1,0,17,0,-17
11436,1,0,18,0,-18
11437,1,0,16,0,-16
11438,0,0,4,0,-4
11439,0,0,117,0,-117
11440,0,0,95,0,-95
11441,1,0,55,0,-55
11442,0,0,50,0,-50
11443,0,0,51,0,-51
11444,1,0,90,0,-90
11445,1,1,2667,1267,-1400
11446,0,0,148,0,-148
11447,1,1,727,3504,2777
11448,1,1,350,1219,869
11449,1,0,108,0,-108
11450,0,0,0,0,0
11451,1,0,47,0,-47
11452,1,1,724,1821,1097
11453,1,0,119,0,-119
11454,0,0,17,0,-17
11455,1,0,129,0,-129
11456,1,0,8,0,-8
11457,1,1,794,1650,856
11458,1,1,1052,2220,1168
11459,1,0,24,0,-24
11460,0,0,26,0,-26
11461,1,0,84,0,-84
11462,1,1,182,1261,1079
11463,1,0,19,0,-19
11464,1,0,58,0,-58
11465,0,0,8,0,-8
11466,0,0,76,0,-76
11467,0,0,109,0,-109
11468,0,0,25,0,-25
11469,0,0,57,0,-57
11470,1,1,1804,2008,204
11471,0,0,170,0,-170
11472,1,0,109,0,-109
11473,1,0,29,0,-29
11474,1,0,74,0,-74
11475,1,0,40,0,-40
11476,1,1,1671,1218,-453
11477,0,0,66,0,-66
11478,0,0,32,0,-32
11479,1,1,472,1317,845
11480,1,0,4,0,-4
11481,1,1,237,1672,1435
11482,0,0,5,0,-5
11483,0,0,92,0,-92
11484,0,0,72,0,-72
11485,1,1,485,1316,831
11486,1,1,1179,1354,175
11487,0,0,0,0,0
11488,0,0,65,0,-65
11489,1,1,759,1301,542
11490,1,0,1,0,-1
11491,0,0,56,0,-56
11492,1,1,197,1407,1210
11493,0,0,14,0,-14
11494,1,0,41,0,-41
11495,1,0,10,0,-10
11496,0,0,32,0,-32
11497,1,1,375,1915,1540
11498,0,0,14,0,-14
11499,1,1,588,1886,1298
11500,1,1,547,1589,1042
11501,0,0,82,0,-82
11502,0,0,0,0,0
11503,1,1,241,2070,1829
11504,0,0,35,0,-35
11505,1,0,73,0,-73
11506,1,0,25,0,-25
11507,1,1,234,1542,1308
11508,1,1,103,1778,1675
11509,1,0,7,0,-7
11510,1,0,68,0,-68
11511,0,0,52,0,-52
11512,1,1,254,1351,1097
11513,0,0,10,0,-10
11514,1,0,44,0,-44
11515,1,0,11,0,-11
11516,1,1,577,2202,1625
11517,1,1,139,1532,1393
11518,0,0,17,0,-17
11519,0,0,106,0,-106
11520,0,0,56,0,-56
11521,1,1,686,1239,553
11522,0,0,60,0,-60
11523,1,0,49,0,-49
11524,0,0,1,0,-1
11525,0,0,50,0,-50
11526,1,1,1034,1254,220
11527,0,0,29,0,-29
11528,1,1,97,1430,1333
11529,0,0,38,0,-38
11530,0,0,6,0,-6
11531,0,0,86,0,-86
11532,0,0,90,0,-90
11533,0,0,9,0,-9
11534,1,0,70,0,-70
11535,1,1,434,1303,869
11536,1,1,496,1859,1363
11537,1,1,1686,1262,-424
11538,0,0,74,0,-74
11539,1,0,34,0,-34
11540,0,0,73,0,-73
11541,1,1,156,1393,1237
11542,0,0,8,0,-8
11543,0,0,268,0,-268
11544,1,1,270,1321,1051
11545,1,0,20,0,-20
11546,0,0,97,0,-97
11547,0,0,27,0,-27
11548,1,1,99,1934,1835
11549,1,1,1255,1261,6
11550,1,1,28,2355,2327
11551,0,0,7,0,-7
11552,0,0,119,0,-119
11553,1,1,159,1430,1271
11554,0,0,3,0,-3
11555,0,0,18,0,-18
11556,0,0,2,0,-2
11557,1,0,28,0,-28
11558,1,0,1,0,-1
11559,1,0,3,0,-3
11560,1,1,502,1242,740
11561,0,0,136,0,-136
11562,1,1,320,1203,883
11563,1,0,227,0,-227
11564,0,0,59,0,-59
11565,1,1,780,1733,953
11566,1,1,917,1245,328
11567,1,0,49,0,-49
11568,1,0,2,0,-2
11569,1,1,466,1714,1248
11570,1,0,15,0,-15
11571,0,0,21,0,-21
11572,1,0,0,0,0
11573,0,0,157,0,-157
11574,0,0,3,0,-3
11575,0,0,4,0,-4
11576,1,1,300,1455,1155
11577,0,0,153,0,-153
11578,1,1,1222,1655,433
11579,1,1,179,1553,1374
11580,1,1,2667,1230,-1437
11581,1,1,123,1239,1116
11582,1,1,1315,1255,-60
11583,0,0,8,0,-8
11584,0,0,36,0,-36
11585,0,0,15,0,-15
11586,1,1,121,1855,1734
11587,1,0,58,0,-58
11588,1,0,45,0,-45
11589,1,1,322,1934,1612
11590,0,0,4,0,-4
11591,1,0,15,0,-15
11592,0,0,12,0,-12
11593,0,0,19,0,-19
11594,1,0,0,0,0
11595,0,0,6,0,-6
11596,1,1,162,1439,1277
11597,0,0,254,0,-254
11598,0,0,115,0,-115
11599,1,1,957,1355,398
11600,0,0,57,0,-57
11601,0,0,7,0,-7
11602,0,0,13,0,-13
11603,1,0,6,0,-6
11604,1,1,1015,1469,454
11605,0,0,13,0,-13
11606,1,0,126,0,-126
11607,1,0,23,0,-23
11608,0,0,129,0,-129
11609,1,0,12,0,-12
11610,0,0,24,0,-24
11611,1,0,64,0,-64
11612,1,1,503,1426,923
11613,1,0,1,0,-1
11614,1,1,420,1362,942
11615,0,0,58,0,-58
11616,1,1,394,2384,1990
11617,0,0,27,0,-27
11618,0,0,19,0,-19
11619,0,0,80,0,-80
11620,1,1,170,2362,2192
11621,0,0,48,0,-48
11622,0,0,51,0,-51
11623,1,0,140,0,-140
11624,1,1,2014,1582,-432
11625,1,1,950,1570,620
11626,1,1,747,1494,747
11627,0,0,47,0,-47
11628,0,0,28,0,-28
11629,1,0,41,0,-41
11630,1,1,1165,1862,697
11631,0,0,77,0,-77
11632,1,1,126,1357,1231
11633,0,0,129,0,-129
11634,1,0,0,0,0
11635,1,1,29,1723,1694
11636,1,0,38,0,-38
11637,1,1,393,1653,1260
11638,1,1,172,1283,1111
11639,0,0,37,0,-37
11640,1,1,164,1364,1200
11641,1,0,23,0,-23
11642,1,1,340,1855,1515
11643,1,1,194,1701,1507
11644,0,0,4,0,-4
11645,1,0,10,0,-10
11646,0,0,1,0,-1
11647,0,0,42,0,-42
11648,1,1,61,1307,1246
11649,1,0,18,0,-18
11650,1,1,1237,1383,146
11651,0,0,91,0,-91
11652,0,0,14,0,-14
11653,0,0,78,0,-78
11654,0,0,19,0,-19
11655,1,1,917,1392,475
11656,0,0,50,0,-50
11657,0,0,81,0,-81
11658,0,0,13,0,-13
11659,0,0,143,0,-143
11660,0,0,17,0,-17
11661,0,0,17,0,-17
11662,0,0,25,0,-25
11663,0,0,1,0,-1
11664,1,1,1094,1458,364
11665,1,0,13,0,-13
11666,1,0,33,0,-33
11667,0,0,45,0,-45
11668,0,0,49,0,-49
11669,1,1,544,1516,972
11670,1,0,119,0,-119
11671,0,0,78,0,-78
11672,1,1,390,1251,861
11673,1,0,190,0,-190
11674,0,0,16,0,-16
11675,0,0,50,0,-50
11676,1,0,7,0,-7
11677,0,0,8,0,-8
11678,1,0,78,0,-78
11679,0,0,18,0,-18
11680,0,0,33,0,-33
11681,1,1,542,1221,679
11682,0,0,5,0,-5
11683,1,0,100,0,-100
11684,0,0,59,0,-59
11685,0,0,14,0,-14
11686,1,0,12,0,-12
11687,0,0,12,0,-12
11688,0,0,44,0,-44
11689,1,1,447,1244,797
11690,0,0,32,0,-32
11691,1,1,664,1800,1136
11692,0,0,10,0,-10
11693,0,0,18,0,-18
11694,0,0,34,0,-34
11695,0,0,15,0,-15
11696,1,0,104,0,-104
11697,1,1,522,1351,829
11698,1,1,569,1248,679
11699,0,0,34,0,-34
11700,1,1,411,2695,2284
11701,1,0,13,0,-13
11702,0,0,172,0,-172
11703,0,0,109,0,-109
11704,1,0,24,0,-24
11705,1,0,9,0,-9
11706,0,0,161,0,-161
11707,0,0,20,0,-20
11708,1,1,154,1316,1162
11709,1,1,42,1370,1328
11710,0,0,13,0,-13
11711,0,0,52,0,-52
11712,1,0,155,0,-155
11713,0,0,13,0,-13
11714,0,0,14,0,-14
11715,1,1,861,1240,379
11716,0,0,47,0,-47
11717,1,0,31,0,-31
11718,1,0,37,0,-37
11719,0,0,16,0,-16
11720,1,1,203,1693,1490
11721,1,1,1294,1437,143
11722,0,0,15,0,-15
11723,0,0,51,0,-51
11724,1,0,27,0,-27
11725,0,0,42,0,-42
11726,1,1,198,1770,1572
11727,1,1,1725,3421,1696
11728,0,0,48,0,-48
11729,1,1,1098,1446,348
11730,0,0,11,0,-11
11731,0,0,28,0,-28
11732,1,0,78,0,-78
11733,1,1,190,1968,1778
11734,1,1,137,1572,1435
11735,0,0,18,0,-18
11736,1,1,93,1316,1223
11737,0,0,51,0,-51
11738,0,0,16,0,-16
11739,1,1,220,1303,1083
11740,1,1,630,1208,578
11741,1,1,3,1875,1872
11742,1,1,317,1540,1223
11743,0,0,15,0,-15
11744,0,0,202,0,-202
11745,1,1,1022,4229,3207
11746,1,0,7,0,-7
11747,1,0,19,0,-19
11748,1,1,1308,1253,-55
11749,1,1,626,1271,645
11750,1,0,38,0,-38
11751,1,1,402,1343,941
11752,1,1,21,1336,1315
11753,0,0,28,0,-28
11754,1,0,75,0,-75
11755,1,1,1085,1277,192
11756,1,0,55,0,-55
11757,1,0,104,0,-104
11758,1,1,1126,2134,1008
11759,1,1,167,1732,1565
11760,0,0,0,0,0
11761,1,0,20,0,-20
11762,1,0,21,0,-21
11763,1,0,27,0,-27
11764,1,1,406,1267,861
11765,1,0,50,0,-50
11766,1,1,838,1398,560
11767,1,0,73,0,-73
11768,1,1,242,1620,1378
11769,0,0,159,0,-159
11770,1,1,263,2011,1748
11771,1,0,106,0,-106
11772,1,1,378,1330,952
11773,1,1,128,1596,1468
11774,0,0,31,0,-31
11775,0,0,2,0,-2
11776,0,0,54,0,-54
11777,1,0,9,0,-9
11778,1,1,305,1247,942
11779,0,0,0,0,0
11780,0,0,30,0,-30
11781,0,0,45,0,-45
11782,0,0,22,0,-22
11783,0,0,7,0,-7
11784,0,0,49,0,-49
11785,1,0,51,0,-51
11786,1,1,66,1381,1315
11787,1,0,19,0,-19
11788,0,0,63,0,-63
11789,1,0,39,0,-39
11790,1,1,246,1484,1238
11791,1,0,2,0,-2
11792,1,0,95,0,-95
11793,0,0,85,0,-85
11794,0,0,117,0,-117
11795,1,1,549,1320,771
11796,0,0,183,0,-183
11797,1,1,196,1299,1103
11798,0,0,41,0,-41
11799,0,0,55,0,-55
11800,1,0,5,0,-5
11801,1,1,702,1321,619
11802,0,0,41,0,-41
11803,0,0,6,0,-6
11804,1,1,370,1639,1269
11805,0,0,33,0,-33
11806,0,0,24,0,-24
11807,1,1,215,1424,1209
11808,1,1,1071,2221,1150
11809,0,0,27,0,-27
11810,1,0,60,0,-60
11811,0,0,55,0,-55
11812,0,0,46,0,-46
11813,0,0,10,0,-10
11814,1,1,1147,2059,912
11815,1,1,1779,1288,-491
11816,1,1,1829,1445,-384
11817,1,0,1,0,-1
11818,1,0,89,0,-89
11819,0,0,43,0,-43
11820,1,0,47,0,-47
11821,1,1,137,1356,1219
11822,1,1,1067,1277,210
11823,1,1,624,1228,604
11824,0,0,153,0,-153
11825,1,1,964,1422,458
11826,0,0,65,0,-65
11827,1,0,16,0,-16
11828,1,1,112,1258,1146
11829,0,0,0,0,0
11830,1,0,42,0,-42
11831,1,0,47,0,-47
11832,1,1,335,1328,993
11833,1,1,1508,1337,-171
11834,1,0,281,0,-281
11835,1,1,268,1918,1650
11836,1,0,37,0,-37
11837,1,1,177,2253,2076
11838,1,1,720,1913,1193
11839,0,0,53,0,-53
11840,1,1,1636,1420,-216
11841,1,0,15,0,-15
11842,1,1,305,1867,1562
11843,1,0,103,0,-103
11844,1,1,420,1458,1038
11845,0,0,12,0,-12
11846,0,0,64,0,-64
11847,1,1,117,1775,1658
11848,1,0,14,0,-14
11849,1,1,350,1339,989
11850,0,0,115,0,-115
11851,1,0,59,0,-59
11852,1,0,36,0,-36
11853,1,1,284,1384,1100
11854,0,0,27,0,-27
11855,1,1,513,1377,864
11856,1,0,44,0,-44
11857,1,0,21,0,-21
11858,1,1,678,1765,1087
11859,1,1,1669,1266,-403
11860,0,0,36,0,-36
11861,1,0,76,0,-76
11862,0,0,165,0,-165
11863,1,1,230,2228,1998
11864,0,0,160,0,-160
11865,0,0,30,0,-30
11866,0,0,30,0,-30
11867,1,0,3,0,-3
11868,0,0,4,0,-4
11869,0,0,61,0,-61
11870,1,0,86,0,-86
11871,0,0,48,0,-48
11872,1,1,82,1296,1214
11873,1,1,1029,1899,870
11874,0,0,107,0,-107
11875,1,1,552,1301,749
11876,1,1,278,1276,998
11877,0,0,10,0,-10
11878,1,0,40,0,-40
11879,1,1,1031,1380,349
11880,1,1,1728,1202,-526
11881,0,0,52,0,-52
11882,0,0,15,0,-15
11883,1,0,238,0,-238
11884,0,0,49,0,-49
11885,1,0,47,0,-47
11886,1,1,187,1333,1146
11887,1,0,11,0,-11
11888,1,0,36,0,-36
11889,1,1,1085,1261,176
11890,1,1,329,1710,1381
11891,1,1,640,2176,1536
11892,0,0,11,0,-11
11893,1,1,785,2089,1304
11894,1,0,111,0,-111
11895,0,0,83,0,-83
11896,0,0,133,0,-133
11897,0,0,4,0,-4
11898,0,0,37,0,-37
11899,1,0,54,0,-54
11900,0,0,26,0,-26
11901,1,1,701,1895,1194
11902,1,0,30,0,-30
11903,1,1,286,2055,1769
11904,1,0,34,0,-34
11905,1,1,240,1361,1121
11906,1,0,19,0,-19
11907,1,0,45,0,-45
11908,0,0,59,0,-59
11909,0,0,28,0,-28
11910,1,1,724,2327,1603
11911,1,0,10,0,-10
11912,1,1,157,1430,1273
11913,0,0,2,0,-2
11914,1,1,982,2059,1077
11915,0,0,55,0,-55
11916,1,0,3,0,-3
11917,1,0,0,0,0
11918,1,0,139,0,-139
11919,0,0,31,0,-31
11920,1,0,75,0,-75
11921,0,0,59,0,-59
11922,1,0,60,0,-60
11923,1,1,994,1202,208
11924,0,0,44,0,-44
11925,1,0,33,0,-33
11926,0,0,34,0,-34
11927,0,0,125,0,-125
11928,0,0,20,0,-20
11929,1,1,358,2366,2008
11930,1,0,41,0,-41
11931,1,1,769,1547,778
11932,0,0,59,0,-59
11933,1,1,1074,1653,579
11934,0,0,70,0,-70
11935,0,0,44,0,-44
11936,1,0,51,0,-51
11937,0,0,125,0,-125
11938,1,0,24,0,-24
11939,0,0,64,0,-64
11940,0,0,53,0,-53
11941,1,0,66,0,-66
11942,0,0,38,0,-38
11943,1,0,51,0,-51
11944,1,1,1860,1202,-658
11945,0,0,20,0,-20
11946,0,0,78,0,-78
11947,0,0,64,0,-64
11948,0,0,254,0,-254
11949,0,0,88,0,-88
11950,1,1,223,1514,1291
11951,0,0,11,0,-11
11952,0,0,56,0,-56
11953,0,0,22,0,-22
11954,1,0,35,0,-35
11955,1,1,775,1226,451
11956,0,0,14,0,-14
11957,1,1,1149,1561,412
11958,0,0,36,0,-36
11959,1,1,263,1437,1174
11960,1,1,379,1553,1174
11961,0,0,23,0,-23
11962,1,0,59,0,-59
11963,0,0,70,0,-70
11964,1,1,116,1458,1342
11965,0,0,43,0,-43
11966,1,1,232,1337,1105
11967,1,0,44,0,-44
11968,1,1,470,1349,879
11969,1,1,528,1258,730
11970,1,0,35,0,-35
11971,1,0,47,0,-47
11972,1,0,72,0,-72
11973,1,1,1314,1396,82
11974,1,1,158,1358,1200
11975,0,0,17,0,-17
11976,0,0,59,0,-59
11977,0,0,51,0,-51
11978,1,1,190,3070,2880
11979,0,0,57,0,-57
11980,1,0,49,0,-49
11981,1,1,167,1428,1261
11982,0,0,75,0,-75
11983,1,1,453,1696,1243
11984,1,1,698,1922,1224
11985,0,0,8,0,-8
11986,0,0,56,0,-56
11987,1,1,117,1249,1132
11988,1,1,1425,1254,-171
11989,1,1,162,1382,1220
11990,1,1,218,3248,3030
11991,1,1,433,1295,862
11992,1,0,190,0,-190
11993,0,0,2,0,-2
11994,0,0,149,0,-149
11995,1,0,93,0,-93
11996,0,0,96,0,-96
11997,0,0,19,0,-19
11998,1,0,2,0,-2
11999,0,0,90,0,-90
12000,0,0,32,0,-32
12001,1,1,26,1270,1244
12002,0,0,9,0,-9
12003,1,1,69,1497,1428
12004,1,1,183,1584,1401
12005,0,0,56,0,-56
12006,1,1,544,1538,994
12007,1,1,410,1293,883
12008,0,0,9,0,-9
12009,1,0,20,0,-20
12010,0,0,110,0,-110
12011,1,1,504,1402,898
12012,1,1,173,1339,1166
12013,1,0,37,0,-37
12014,0,0,56,0,-56
12015,1,0,49,0,-49
12016,0,0,9,0,-9
12017,1,1,92,1722,1630
12018,0,0,58,0,-58
12019,0,0,11,0,-11
12020,0,0,63,0,-63
12021,1,0,30,0,-30
12022,0,0,28,0,-28
12023,0,0,111,0,-111
12024,1,0,70,0,-70
12025,1,0,2,0,-2
12026,0,0,54,0,-54
12027,0,0,18,0,-18
12028,1,0,16,0,-16
12029,1,0,57,0,-57
12030,0,0,44,0,-44
12031,1,0,18,0,-18
12032,0,0,40,0,-40
12033,0,0,23,0,-23
12034,1,1,196,1351,1155
12035,1,1,1172,1524,352
12036,0,0,8,0,-8
12037,0,0,24,0,-24
12038,0,0,35,0,-35
12039,1,1,705,1303,598
12040,0,0,86,0,-86
12041,1,1,494,1529,1035
12042,0,0,11,0,-11
12043,1,1,509,1470,961
12044,1,0,112,0,-112
12045,1,0,242,0,-242
12046,1,0,47,0,-47
12047,1,0,99,0,-99
12048,1,1,907,3140,2233
12049,1,1,24,1340,1316
12050,1,1,247,1453,1206
12051,1,0,0,0,0
12052,1,1,150,2316,2166
12053,1,1,512,1512,1000
12054,1,0,147,0,-147
12055,0,0,39,0,-39
12056,1,1,436,1327,891
12057,1,1,439,1387,948
12058,1,1,108,1488,1380
12059,1,1,543,1249,706
12060,0,0,23,0,-23
12061,0,0,23,0,-23
12062,0,0,12,0,-12
12063,1,0,129,0,-129
12064,0,0,17,0,-17
12065,0,0,79,0,-79
12066,1,1,243,1487,1244
12067,0,0,0,0,0
12068,0,0,49,0,-49
12069,1,1,211,1368,1157
12070,1,1,802,1823,1021
12071,0,0,51,0,-51
12072,1,0,9,0,-9
12073,1,0,92,0,-92
12074,0,0,45,0,-45
12075,0,0,1,0,-1
12076,0,0,17,0,-17
12077,0,0,60,0,-60
12078,1,0,3,0,-3
12079,1,1,375,1209,834
12080,1,0,9,0,-9
12081,1,0,50,0,-50
12082,1,1,659,2081,1422
12083,0,0,192,0,-192
12084,1,0,79,0,-79
12085,1,0,7,0,-7
12086,1,0,77,0,-77
12087,1,1,610,1334,724
12088,0,0,55,0,-55
12089,1,1,266,1262,996
12090,0,0,9,0,-9
12091,0,0,0,0,0
12092,1,0,124,0,-124
12093,1,0,17,0,-17
12094,0,0,76,0,-76
12095,0,0,5,0,-5
12096,1,0,0,0,0
12097,1,1,119,1257,1138
12098,0,0,5,0,-5
12099,1,1,143,1535,1392
12100,1,0,95,0,-95
12101,1,1,56,1305,1249
12102,0,0,250,0,-250
12103,0,0,135,0,-135
12104,1,1,324,1953,1629
12105,0,0,317,0,-317
12106,1,0,41,0,-41
12107,1,1,407,1691,1284
12108,1,1,897,1247,350
12109,1,0,40,0,-40
12110,0,0,107,0,-107
12111,1,0,52,0,-52
12112,0,0,28,0,-28
12113,1,0,34,0,-34
12114,0,0,22,0,-22
12115,1,0,31,0,-31
12116,0,0,156,0,-156
12117,0,0,11,0,-11
12118,1,1,394,1322,928
12119,1,1,240,1750,1510
12120,1,0,10,0,-10
12121,0,0,13,0,-13
12122,1,0,70,0,-70
12123,1,0,16,0,-16
12124,0,0,169,0,-169
12125,1,1,111,1657,1546
12126,0,0,22,0,-22
12127,0,0,38,0,-38
12128,1,1,187,1328,1141
12129,0,0,4,0,-4
12130,1,1,232,1332,1100
12131,0,0,23,0,-23
12132,1,1,492,1898,1406
12133,0,0,113,0,-113
12134,1,1,1185,1267,82
12135,1,0,38,0,-38
12136,1,1,874,1862,988
12137,1,0,21,0,-21
12138,0,0,1,0,-1
12139,0,0,204,0,-204
12140,1,1,58,1286,1228
12141,1,0,52,0,-52
12142,1,0,13,0,-13
12143,1,0,157,0,-157
12144,0,0,41,0,-41
12145,0,0,0,0,0
12146,1,0,32,0,-32
12147,1,1,669,1401,732
12148,1,0,9,0,-9
12149,0,0,47,0,-47
12150,1,0,10,0,-10
12151,0,0,27,0,-27
12152,0,0,103,0,-103
12153,1,0,22,0,-22
12154,1,1,196,1506,1310
12155,1,1,266,1286,1020
12156,0,0,37,0,-37
12157,0,0,4,0,-4
12158,0,0,32,0,-32
12159,1,1,183,1772,1589
12160,0,0,9,0,-9
12161,0,0,101,0,-101
12162,1,1,759,1257,498
12163,1,1,272,1498,1226
12164,1,1,385,1388,1003
12165,1,1,734,2113,1379
12166,0,0,80,0,-80
12167,1,0,137,0,-137
12168,1,0,49,0,-49
12169,0,0,40,0,-40
12170,1,1,527,1261,734
12171,1,0,130,0,-130
12172,0,0,25,0,-25
12173,1,0,78,0,-78
12174,1,0,7,0,-7
12175,0,0,13,0,-13
12176,1,0,23,0,-23
12177,1,1,189,1557,1368
12178,1,1,815,1571,756
12179,1,1,919,1360,441
12180,1,0,67,0,-67
12181,1,0,76,0,-76
12182,1,1,192,2230,2038
12183,1,1,1796,1214,-582
12184,0,0,20,0,-20
12185,1,1,440,1310,870
12186,1,1,743,1662,919
12187,0,0,175,0,-175
12188,1,0,24,0,-24
12189,1,0,1,0,-1
12190,0,0,0,0,0
12191,1,0,13,0,-13
12192,0,0,5,0,-5
12193,1,1,59,1317,1258
12194,1,0,22,0,-22
12195,0,0,22,0,-22
12196,1,1,414,1249,835
12197,0,0,14,0,-14
12198,1,1,182,1734,1552
12199,1,1,688,1303,615
12200,1,1,526,1200,674
12201,1,0,87,0,-87
12202,0,0,30,0,-30
12203,0,0,47,0,-47
12204,1,0,35,0,-35
12205,1,0,71,0,-71
12206,0,0,12,0,-12
12207,1,1,369,1418,1049
12208,1,0,33,0,-33
12209,1,1,294,1396,1102
12210,0,0,73,0,-73
12211,1,1,1003,1223,220
12212,0,0,15,0,-15
12213,1,1,297,1287,990
12214,1,0,47,0,-47
12215,0,0,98,0,-98
12216,0,0,71,0,-71
12217,1,1,884,1625,741
12218,1,1,243,5533,5290
12219,0,0,13,0,-13
12220,1,0,6,0,-6
12221,1,1,2370,1201,-1169
12222,1,1,258,1517,1259
12223,1,1,443,1318,875
12224,1,0,46,0,-46
12225,1,1,305,1743,1438
12226,1,0,10,0,-10
12227,1,0,255,0,-255
12228,1,1,187,1280,1093
12229,0,0,53,0,-53
12230,0,0,171,0,-171
12231,0,0,16,0,-16
12232,0,0,86,0,-86
12233,1,0,9,0,-9
12234,0,0,68,0,-68
12235,1,0,200,0,-200
12236,0,0,2,0,-2
12237,0,0,68,0,-68
12238,0,0,26,0,-26
12239,1,1,46,1226,1180
12240,0,0,18,0,-18
12241,1,1,276,1949,1673
12242,0,0,157,0,-157
12243,0,0,204,0,-204
12244,1,0,59,0,-59
12245,1,1,829,1465,636
12246,1,1,106,1517,1411
12247,0,0,13,0,-13
12248,0,0,54,0,-54
12249,1,0,14,0,-14
12250,1,0,98,0,-98
12251,0,0,45,0,-45
12252,1,1,52,1635,1583
12253,1,0,69,0,-69
12254,1,1,196,2150,1954
12255,0,0,71,0,-71
12256,1,1,187,2105,1918
12257,0,0,1,0,-1
12258,1,1,1690,1256,-434
12259,1,1,116,3013,2897
12260,0,0,1,0,-1
12261,1,0,6,0,-6
12262,0,0,51,0,-51
12263,0,0,46,0,-46
12264,1,1,1776,1760,-16
12265,1,0,230,0,-230
12266,0,0,82,0,-82
12267,0,0,92,0,-92
12268,1,0,19,0,-19
12269,1,1,1082,2005,923
12270,1,1,671,1239,568
12271,0,0,39,0,-39
12272,1,0,63,0,-63
12273,1,1,1173,1252,79
12274,1,1,369,1230,861
12275,1,0,90,0,-90
12276,0,0,20,0,-20
12277,1,1,231,1422,1191
12278,1,1,802,1632,830
12279,1,0,18,0,-18
12280,0,0,1,0,-1
12281,1,1,265,1279,1014
12282,1,1,324,1844,1520
12283,0,0,56,0,-56
12284,1,0,167,0,-167
12285,1,0,22,0,-22
12286,1,0,20,0,-20
12287,0,0,76,0,-76
12288,1,0,40,0,-40
12289,1,1,322,1928,1606
12290,0,0,20,0,-20
12291,0,0,143,0,-143
12292,0,0,49,0,-49
12293,1,0,7,0,-7
12294,1,1,123,2632,2509
12295,1,1,613,1411,798
12296,0,0,11,0,-11
12297,1,1,177,1207,1030
12298,1,0,70,0,-70
12299,0,0,56,0,-56
12300,0,0,42,0,-42
12301,1,1,287,1341,1054
12302,0,0,196,0,-196
12303,1,0,1,0,-1
12304,1,1,106,1721,1615
12305,1,0,56,0,-56
12306,0,0,4,0,-4
12307,1,1,1629,1507,-122
12308,1,1,136,1234,1098
12309,1,0,5,0,-5
12310,1,0,5,0,-5
12311,0,0,4,0,-4
12312,1,0,138,0,-138
12313,1,1,100,1599,1499
12314,0,0,108,0,-108
12315,0,0,141,0,-141
12316,1,1,396,1407,1011
12317,1,1,302,1810,1508
12318,1,0,33,0,-33
12319,0,0,34,0,-34
12320,0,0,88,0,-88
12321,1,1,425,1335,910
12322,1,1,552,1212,660
12323,1,0,69,0,-69
12324,1,1,242,1314,1072
12325,0,0,84,0,-84
12326,0,0,124,0,-124
12327,0,0,49,0,-49
12328,0,0,104,0,-104
12329,1,0,86,0,-86
12330,1,0,32,0,-32
12331,1,1,219,1240,1021
12332,1,1,1027,1606,579
12333,1,0,157,0,-157
12334,0,0,41,0,-41
12335,1,0,77,0,-77
12336,0,0,10,0,-10
12337,0,0,24,0,-24
12338,1,0,25,0,-25
12339,1,1,230,1482,1252
12340,1,1,196,1430,1234
12341,1,1,317,1784,1467
12342,0,0,4,0,-4
12343,1,0,36,0,-36
12344,1,0,22,0,-22
12345,0,0,17,0,-17
12346,1,0,58,0,-58
12347,0,0,39,0,-39
12348,0,0,40,0,-40
12349,1,1,869,1410,541
12350,1,0,54,0,-54
12351,1,1,164,1284,1120
12352,1,0,36,0,-36
12353,1,1,388,1468,1080
12354,1,1,854,1783,929
12355,1,1,410,1203,793
12356,0,0,93,0,-93
12357,1,0,126,0,-126
12358,0,0,8,0,-8
12359,0,0,39,0,-39
12360,1,1,372,1439,1067
12361,1,1,459,1390,931
12362,1,0,181,0,-181
12363,0,0,1,0,-1
12364,1,1,675,1277,602
12365,1,0,2,0,-2
12366,1,1,480,1330,850
12367,1,1,88,1376,1288
12368,1,0,22,0,-22
12369,0,0,2,0,-2
12370,0,0,45,0,-45
12371,1,0,0,0,0
12372,0,0,33,0,-33
12373,1,1,337,1239,902
12374,1,0,19,0,-19
12375,1,0,1,0,-1
12376,0,0,29,0,-29
12377,1,1,762,3244,2482
12378,1,1,665,1573,908
12379,1,0,82,0,-82
12380,1,0,164,0,-164
12381,1,0,56,0,-56
12382,1,1,352,1653,1301
12383,0,0,24,0,-24
12384,1,0,114,0,-114
12385,1,0,26,0,-26
12386,1,0,33,0,-33
12387,1,0,42,0,-42
12388,1,1,892,2714,1822
12389,0,0,4,0,-4
12390,1,1,1629,1707,78
12391,1,0,168,0,-168
12392,1,0,9,0,-9
12393,1,0,127,0,-127
12394,1,1,246,1515,1269
12395,1,0,4,0,-4
12396,0,0,40,0,-40
12397,1,0,30,0,-30
12398,1,0,121,0,-121
12399,1,1,375,1393,1018
12400,0,0,212,0,-212
12401,0,0,35,0,-35
12402,1,0,158,0,-158
12403,1,1,160,1209,1049
12404,1,1,579,1213,634
12405,1,0,22,0,-22
12406,0,0,21,0,-21
12407,1,1,59,1440,1381
12408,1,1,254,1203,949
12409,1,0,37,0,-37
12410,0,0,63,0,-63
12411,0,0,11,0,-11
12412,0,0,17,0,-17
12413,1,0,48,0,-48
12414,1,1,761,1837,1076
12415,1,0,70,0,-70
12416,1,1,589,1447,858
12417,1,0,75,0,-75
12418,1,1,748,1239,491
12419,1,0,143,0,-143
12420,0,0,19,0,-19
12421,1,0,28,0,-28
12422,0,0,6,0,-6
12423,1,1,789,1503,714
12424,0,0,49,0,-49
12425,0,0,29,0,-29
12426,1,1,111,1303,1192
12427,1,0,61,0,-61
12428,1,1,239,1275,1036
12429,1,0,60,0,-60
12430,1,0,4,0,-4
12431,0,0,50,0,-50
12432,1,0,11,0,-11
12433,1,1,199,1223,1024
12434,1,1,537,1213,676
12435,1,1,570,1611,1041
12436,1,0,77,0,-77
12437,1,0,53,0,-53
12438,1,0,2,0,-2
12439,0,0,3,0,-3
12440,0,0,108,0,-108
12441,1,0,58,0,-58
12442,1,1,459,1371,912
12443,0,0,24,0,-24
12444,0,0,12,0,-12
12445,0,0,5,0,-5
12446,0,0,34,0,-34
12447,0,0,104,0,-104
12448,0,0,89,0,-89
12449,0,0,39,0,-39
12450,1,0,22,0,-22
12451,1,1,72,1404,1332
12452,0,0,47,0,-47
12453,0,0,149,0,-149
12454,1,0,35,0,-35
12455,0,0,155,0,-155
12456,1,0,30,0,-30
12457,0,0,92,0,-92
12458,0,0,71,0,-71
12459,1,0,43,0,-43
12460,1,1,15,1222,1207
12461,1,0,8,0,-8
12462,0,0,16,0,-16
12463,0,0,3,0,-3
12464,1,1,1879,1691,-188
12465,0,0,35,0,-35
12466,1,1,280,1219,939
12467,1,0,73,0,-73
12468,1,1,82,1654,1572
12469,1,1,853,1860,1007
12470,0,0,34,0,-34
12471,0,0,204,0,-204
12472,1,1,102,1609,1507
12473,0,0,67,0,-67
12474,1,1,1146,1606,460
12475,1,0,122,0,-122
12476,0,0,37,0,-37
12477,1,1,358,1420,1062
12478,0,0,21,0,-21
12479,1,1,66,1448,1382
12480,1,0,45,0,-45
12481,0,0,10,0,-10
12482,0,0,0,0,0
12483,0,0,29,0,-29
12484,0,0,73,0,-73
12485,1,1,323,1214,891
12486,0,0,82,0,-82
12487,0,0,5,0,-5
12488,1,1,3130,1793,-1337
12489,0,0,60,0,-60
12490,1,0,112,0,-112
12491,1,0,7,0,-7
12492,1,0,96,0,-96
12493,0,0,161,0,-161
12494,0,0,49,0,-49
12495,0,0,148,0,-148
12496,0,0,59,0,-59
12497,1,0,77,0,-77
12498,0,0,81,0,-81
12499,0,0,79,0,-79
12500,1,0,42,0,-42
12501,1,1,197,1501,1304
12502,0,0,2,0,-2
12503,1,1,641,1225,584
12504,0,0,17,0,-17
12505,1,1,407,1633,1226
12506,1,1,394,1237,843
12507,0,0,19,0,-19
12508,1,0,32,0,-32
12509,0,0,16,0,-16
12510,1,1,428,1201,773
12511,1,1,193,1360,1167
12512,1,0,90,0,-90
12513,0,0,99,0,-99
12514,1,1,488,1319,831
12515,1,1,1608,1964,356
12516,1,0,1,0,-1
12517,0,0,23,0,-23
12518,1,1,438,1727,1289
12519,0,0,22,0,-22
12520,1,1,304,2778,2474
12521,1,0,142,0,-142
12522,1,1,30,2111,2081
12523,1,1,206,1219,1013
12524,1,0,44,0,-44
12525,1,1,412,1600,1188
12526,1,1,158,1771,1613
12527,0,0,135,0,-135
12528,1,1,469,1290,821
12529,0,0,39,0,-39
12530,1,0,3,0,-3
12531,1,0,70,0,-70
12532,1,0,58,0,-58
12533,0,0,82,0,-82
12534,1,1,5,2718,2713
12535,0,0,74,0,-74
12536,0,0,107,0,-107
12537,0,0,37,0,-37
12538,1,1,237,1332,1095
12539,1,0,14,0,-14
12540,0,0,3,0,-3
12541,0,0,3,0,-3
12542,0,0,88,0,-88
12543,1,1,156,1215,1059
12544,0,0,3,0,-3
12545,1,1,218,1384,1166
12546,1,0,8,0,-8
12547,1,0,64,0,-64
12548,1,0,92,0,-92
12549,0,0,23,0,-23
12550,1,0,2,0,-2
12551,1,1,1110,1308,198
12552,1,0,0,0,0
12553,1,0,153,0,-153
12554,1,1,252,1340,1088
12555,1,0,9,0,-9
12556,1,1,204,1565,1361
12557,1,1,247,1469,1222
12558,0,0,230,0,-230
12559,1,0,77,0,-77
12560,1,1,424,1343,919
12561,1,1,427,1525,1098
12562,1,0,50,0,-50
12563,0,0,53,0,-53
12564,0,0,34,0,-34
12565,1,1,58,1227,1169
12566,1,0,18,0,-18
12567,1,0,50,0,-50
12568,1,1,2032,1259,-773
12569,1,1,501,1531,1030
12570,0,0,77,0,-77
12571,1,0,167,0,-167
12572,0,0,262,0,-262
12573,1,1,198,2056,1858
12574,0,0,37,0,-37
12575,1,1,817,1322,505
12576,1,1,293,1507,1214
12577,1,1,71,1946,1875
12578,1,0,25,0,-25
12579,1,1,108,1525,1417
12580,1,1,350,1301,951
12581,0,0,18,0,-18
12582,1,0,2,0,-2
12583,1,0,4,0,-4
12584,0,0,7,0,-7
12585,1,1,96,1201,1105
12586,0,0,21,0,-21
12587,1,0,172,0,-172
12588,1,1,230,1279,1049
12589,1,0,31,0,-31
12590,0,0,32,0,-32
12591,0,0,53,0,-53
12592,1,1,306,1571,1265
12593,1,0,111,0,-111
12594,1,1,195,1598,1403
12595,1,1,554,1220,666
12596,0,0,85,0,-85
12597,1,0,74,0,-74
12598,1,1,835,1903,1068
12599,0,0,63,0,-63
12600,1,0,23,0,-23
12601,0,0,17,0,-17
12602,1,1,153,3751,3598
12603,0,0,32,0,-32
12604,0,0,137,0,-137
12605,0,0,80,0,-80
12606,0,0,97,0,-97
12607,1,0,37,0,-37
12608,1,0,50,0,-50
12609,1,1,1138,1233,95
12610,1,0,0,0,0
12611,1,1,522,2240,1718
12612,0,0,0,0,0
12613,1,0,196,0,-196
12614,0,0,48,0,-48
12615,0,0,97,0,-97
12616,1,1,764,1412,648
12617,0,0,144,0,-144
12618,0,0,82,0,-82
12619,0,0,63,0,-63
12620,1,0,17,0,-17
12621,1,1,1012,1717,705
12622,1,1,2563,1278,-1285
12623,1,1,540,1959,1419
12624,1,0,54,0,-54
12625,1,1,293,1856,1563
12626,1,0,43,0,-43
12627,1,1,1900,1923,23
12628,1,1,183,1205,1022
12629,1,0,12,0,-12
12630,1,1,445,1498,1053
12631,1,1,162,1268,1106
12632,1,0,93,0,-93
12633,1,0,30,0,-30
12634,0,0,129,0,-129
12635,0,0,1,0,-1
12636,1,0,91,0,-91
12637,1,0,7,0,-7
12638,1,1,143,1525,1382
12639,1,1,117,1362,1245
12640,1,0,148,0,-148
12641,1,1,192,1294,1102
12642,1,1,973,3468,2495
12643,1,1,549,1295,746
12644,1,1,350,1897,1547
12645,1,1,97,1314,1217
12646,0,0,39,0,-39
12647,1,1,209,1316,1107
12648,1,1,165,2132,1967
12649,0,0,43,0,-43
12650,1,1,110,1858,1748
12651,0,0,57,0,-57
12652,1,1,356,1972,1616
12653,1,0,130,0,-130
12654,1,1,218,1325,1107
12655,0,0,63,0,-63
12656,0,0,0,0,0
12657,1,1,370,1653,1283
12658,1,0,65,0,-65
12659,1,1,304,1459,1155
12660,0,0,121,0,-121
12661,1,0,81,0,-81
12662,1,1,95,1697,1602
12663,0,0,68,0,-68
12664,0,0,58,0,-58
12665,1,1,564,1226,662
12666,1,0,42,0,-42
12667,0,0,105,0,-105
12668,1,1,683,1463,780
12669,0,0,83,0,-83
12670,0,0,95,0,-95
12671,1,1,740,2141,1401
12672,1,1,51,1366,1315
12673,1,1,88,1228,1140
12674,1,1,528,1716,1188
12675,0,0,3,0,-3
12676,1,1,265,1500,1235
12677,0,0,2,0,-2
12678,1,1,272,1215,943
12679,1,1,330,3604,3274
12680,1,0,48,0,-48
12681,1,0,242,0,-242
12682,0,0,74,0,-74
12683,1,0,36,0,-36
12684,0,0,9,0,-9
12685,0,0,22,0,-22
12686,1,1,188,2972,2784
12687,1,1,220,1410,1190
12688,0,0,57,0,-57
12689,1,1,70,1331,1261
12690,1,0,0,0,0
12691,0,0,18,0,-18
12692,1,0,7,0,-7
12693,1,1,247,1217,970
12694,0,0,163,0,-163
12695,1,0,60,0,-60
12696,1,1,2321,1346,-975
12697,0,0,37,0,-37
12698,1,0,10,0,-10
12699,1,1,242,1210,968
12700,1,0,91,0,-91
12701,1,0,92,0,-92
12702,1,1,282,1275,993
12703,1,1,542,1507,965
12704,0,0,9,0,-9
12705,0,0,79,0,-79
12706,0,0,36,0,-36
12707,1,1,1241,2015,774
12708,1,0,70,0,-70
12709,0,0,76,0,-76
12710,1,0,63,0,-63
12711,1,1,269,1462,1193
12712,0,0,20,0,-20
12713,1,1,1254,1860,606
12714,1,1,73,1210,1137
12715,0,0,38,0,-38
12716,0,0,1,0,-1
12717,1,0,11,0,-11
12718,1,0,15,0,-15
12719,1,1,272,1374,1102
12720,0,0,0,0,0
12721,1,1,64,1829,1765
12722,1,1,1514,1691,177
12723,1,0,3,0,-3
12724,0,0,11,0,-11
12725,1,1,154,1476,1322
12726,0,0,64,0,-64
12727,1,1,833,1321,488
12728,0,0,46,0,-46
12729,0,0,100,0,-100
12730,1,0,38,0,-38
12731,1,1,387,1650,1263
12732,0,0,6,0,-6
12733,1,0,1,0,-1
12734,1,0,13,0,-13
12735,0,0,1,0,-1
12736,0,0,55,0,-55
12737,1,1,660,1727,1067
12738,0,0,28,0,-28
12739,1,0,4,0,-4
12740,0,0,32,0,-32
12741,0,0,137,0,-137
12742,0,0,45,0,-45
12743,0,0,6,0,-6
12744,1,1,287,1306,1019
12745,1,0,28,0,-28
12746,0,0,30,0,-30
12747,1,0,6,0,-6
12748,1,0,11,0,-11
12749,0,0,109,0,-109
12750,0,0,59,0,-59
12751,0,0,203,0,-203
12752,0,0,187,0,-187
12753,0,0,43,0,-43
12754,1,0,32,0,-32
12755,0,0,7,0,-7
12756,0,0,81,0,-81
12757,1,0,56,0,-56
12758,1,0,31,0,-31
12759,0,0,82,0,-82
12760,0,0,8,0,-8
12761,1,0,44,0,-44
12762,1,0,48,0,-48
12763,0,0,52,0,-52
12764,0,0,33,0,-33
12765,0,0,33,0,-33
12766,0,0,83,0,-83
12767,0,0,94,0,-94
12768,1,1,70,1885,1815
12769,0,0,39,0,-39
12770,1,0,150,0,-150
12771,0,0,41,0,-41
12772,1,1,762,1580,818
12773,1,1,303,1425,1122
12774,0,0,22,0,-22
12775,1,1,558,1856,1298
12776,1,0,95,0,-95
12777,0,0,1,0,-1
12778,0,0,25,0,-25
12779,1,0,6,0,-6
12780,1,0,128,0,-128
12781,1,1,250,1390,1140
12782,1,1,186,1224,1038
12783,1,1,1588,1565,-23
12784,0,0,20,0,-20
12785,1,0,67,0,-67
12786,0,0,4,0,-4
12787,0,0,55,0,-55
12788,0,0,7,0,-7
12789,1,0,12,0,-12
12790,0,0,40,0,-40
12791,0,0,69,0,-69
12792,0,0,19,0,-19
12793,1,0,195,0,-195
12794,1,0,41,0,-41
12795,1,0,39,0,-39
12796,0,0,29,0,-29
12797,1,1,272,1825,1553
12798,0,0,318,0,-318
12799,0,0,41,0,-41
12800,1,1,1189,1556,367
12801,0,0,6,0,-6
12802,1,1,203,1486,1283
12803,1,0,26,0,-26
12804,0,0,47,0,-47
12805,1,0,11,0,-11
12806,0,0,144,0,-144
12807,1,0,29,0,-29
12808,1,0,10,0,-10
12809,0,0,21,0,-21
12810,0,0,182,0,-182
12811,0,0,28,0,-28
12812,1,1,92,1493,1401
12813,0,0,6,0,-6
12814,1,1,950,1201,251
12815,1,1,176,2165,1989
12816,1,1,270,1337,1067
12817,0,0,16,0,-16
12818,1,1,177,1762,1585
12819,1,1,524,2734,2210
12820,1,0,97,0,-97
12821,1,1,320,1338,1018
12822,0,0,17,0,-17
12823,1,0,80,0,-80
12824,1,0,41,0,-41
12825,0,0,76,0,-76
12826,0,0,10,0,-10
12827,1,1,365,1427,1062
12828,0,0,32,0,-32
12829,1,1,461,1507,1046
12830,1,0,177,0,-177
12831,0,0,19,0,-19
12832,0,0,84,0,-84
12833,1,0,1,0,-1
12834,0,0,70,0,-70
12835,1,1,154,2338,2184
12836,1,1,59,1204,1145
12837,0,0,63,0,-63
12838,1,1,494,2007,1513
12839,0,0,81,0,-81
12840,1,0,43,0,-43
12841,0,0,1,0,-1
12842,0,0,17,0,-17
12843,0,0,72,0,-72
12844,0,0,30,0,-30
12845,1,0,7,0,-7
12846,1,1,137,1295,1158
12847,0,0,6,0,-6
12848,1,0,8,0,-8
12849,0,0,42,0,-42
12850,1,0,110,0,-110
12851,0,0,33,0,-33
12852,0,0,32,0,-32
12853,1,1,1598,1933,335
12854,1,1,795,1910,1115
12855,0,0,124,0,-124
12856,0,0,62,0,-62
12857,1,0,41,0,-41
12858,1,0,17,0,-17
12859,0,0,44,0,-44
12860,1,1,1039,1200,161
12861,0,0,61,0,-61
12862,0,0,119,0,-119
12863,0,0,27,0,-27
12864,1,1,679,1592,913
12865,1,0,19,0,-19
12866,0,0,2,0,-2
12867,0,0,143,0,-143
12868,0,0,9,0,-9
12869,1,0,31,0,-31
12870,0,0,7,0,-7
12871,0,0,100,0,-100
12872,0,0,38,0,-38
12873,1,0,0,0,0
12874,1,1,864,1821,957
12875,1,1,1181,2972,1791
12876,1,1,231,1775,1544
12877,0,0,52,0,-52
12878,1,0,47,0,-47
12879,1,0,55,0,-55
12880,1,0,7,0,-7
12881,0,0,42,0,-42
12882,1,0,3,0,-3
12883,0,0,17,0,-17
12884,0,0,14,0,-14
12885,1,0,49,0,-49
12886,0,0,7,0,-7
12887,1,1,947,1429,482
12888,0,0,7,0,-7
12889,1,0,20,0,-20
12890,0,0,64,0,-64
12891,1,1,235,1335,1100
12892,1,1,987,1536,549
12893,0,0,118,0,-118
12894,0,0,36,0,-36
12895,0,0,92,0,-92
12896,1,1,1425,1960,535
12897,1,1,515,1215,700
12898,0,0,44,0,-44
12899,1,0,78,0,-78
12900,1,1,453,1650,1197
12901,0,0,158,0,-158
12902,1,1,1116,1280,164
12903,1,1,4046,1293,-2753
12904,0,0,91,0,-91
12905,1,1,148,1290,1142
12906,1,0,18,0,-18
12907,1,1,969,1373,404
12908,0,0,89,0,-89
12909,1,1,252,1373,1121
12910,1,0,6,0,-6
12911,1,1,156,1262,1106
12912,1,1,545,1662,1117
12913,1,0,65,0,-65
12914,1,0,47,0,-47
12915,0,0,24,0,-24
12916,1,1,328,1607,1279
12917,1,1,191,1381,1190
12918,1,0,244,0,-244
12919,1,0,81,0,-81
12920,0,0,5,0,-5
12921,0,0,4,0,-4
12922,0,0,46,0,-46
12923,0,0,85,0,-85
12924,0,0,228,0,-228
12925,0,0,34,0,-34
12926,0,0,15,0,-15
12927,1,0,80,0,-80
12928,1,0,76,0,-76
12929,1,0,7,0,-7
12930,0,0,19,0,-19
12931,1,0,2,0,-2
12932,1,1,89,2161,2072
12933,1,1,2461,1506,-955
12934,0,0,9,0,-9
12935,0,0,44,0,-44
12936,0,0,50,0,-50
12937,1,0,58,0,-58
12938,1,0,57,0,-57
12939,1,1,1073,1233,160
12940,0,0,117,0,-117
12941,0,0,99,0,-99
12942,1,0,14,0,-14
12943,0,0,1,0,-1
12944,0,0,16,0,-16
12945,0,0,85,0,-85
12946,0,0,80,0,-80
12947,1,1,602,1642,1040
12948,0,0,13,0,-13
12949,1,1,177,1526,1349
12950,1,0,84,0,-84
12951,1,1,1628,1676,48
12952,1,0,32,0,-32
12953,0,0,7,0,-7
12954,1,0,56,0,-56
12955,1,0,54,0,-54
12956,0,0,58,0,-58
12957,0,0,23,0,-23
12958,1,1,227,1299,1072
12959,0,0,15,0,-15
12960,1,0,57,0,-57
12961,0,0,29,0,-29
12962,0,0,51,0,-51
12963,1,0,84,0,-84
12964,1,1,36,1278,1242
12965,1,1,368,2279,1911
12966,1,0,243,0,-243
12967,1,0,51,0,-51
12968,0,0,67,0,-67
12969,0,0,197,0,-197
12970,1,0,1,0,-1
12971,1,0,37,0,-37
12972,0,0,66,0,-66
12973,0,0,236,0,-236
12974,1,1,626,1206,580
12975,1,1,35,1409,1374
12976,1,1,157,1319,1162
12977,1,1,499,1401,902
12978,0,0,109,0,-109
12979,1,1,429,1542,1113
12980,1,1,198,1231,1033
12981,0,0,44,0,-44
12982,1,1,430,1391,961
12983,0,0,73,0,-73
12984,1,1,174,1274,1100
12985,1,0,15,0,-15
12986,1,0,50,0,-50
12987,0,0,89,0,-89
12988,0,0,30,0,-30
12989,1,1,36,1360,1324
12990,1,1,247,1356,1109
12991,0,0,46,0,-46
12992,1,1,1267,1377,110
12993,0,0,84,0,-84
12994,1,0,65,0,-65
12995,1,1,1185,1629,444
12996,0,0,18,0,-18
12997,1,0,16,0,-16
12998,1,1,1426,2327,901
12999,1,1,256,1225,969
13000,0,0,22,0,-22
13001,1,0,21,0,-21
13002,1,0,10,0,-10
13003,0,0,79,0,-79
13004,0,0,45,0,-45
13005,0,0,74,0,-74
13006,0,0,4,0,-4
13007,1,1,127,1265,1138
13008,1,1,337,1398,1061
13009,1,1,241,1370,1129
13010,0,0,25,0,-25
13011,1,0,83,0,-83
13012,0,0,91,0,-91
13013,1,1,724,1259,535
13014,1,0,17,0,-17
13015,1,0,22,0,-22
13016,0,0,64,0,-64
13017,1,0,39,0,-39
13018,1,1,345,1382,1037
13019,1,0,53,0,-53
13020,0,0,13,0,-13
13021,0,0,19,0,-19
13022,1,1,1291,1297,6
13023,1,1,751,2024,1273
13024,0,0,28,0,-28
13025,0,0,14,0,-14
13026,0,0,6,0,-6
13027,1,0,17,0,-17
13028,1,0,24,0,-24
13029,0,0,1,0,-1
13030,1,1,555,1343,788
13031,1,0,51,0,-51
13032,1,1,40,1788,1748
13033,0,0,98,0,-98
13034,0,0,18,0,-18
13035,0,0,133,0,-133
13036,0,0,17,0,-17
13037,0,0,41,0,-41
13038,1,1,1158,1715,557
13039,0,0,49,0,-49
13040,1,0,12,0,-12
13041,1,0,182,0,-182
13042,0,0,92,0,-92
13043,0,0,0,0,0
13044,1,1,1782,1714,-68
13045,0,0,12,0,-12
13046,0,0,10,0,-10
13047,0,0,11,0,-11
13048,1,0,87,0,-87
13049,1,1,410,1323,913
13050,1,0,76,0,-76
13051,0,0,153,0,-153
13052,0,0,29,0,-29
13053,1,0,47,0,-47
13054,1,0,96,0,-96
13055,1,0,83,0,-83
13056,1,1,1536,1871,335
13057,0,0,96,0,-96
13058,1,0,24,0,-24
13059,0,0,15,0,-15
13060,1,1,75,1816,1741
13061,0,0,0,0,0
13062,0,0,5,0,-5
13063,0,0,5,0,-5
13064,0,0,46,0,-46
13065,1,1,1275,1258,-17
13066,1,0,12,0,-12
13067,1,1,90,1864,1774
13068,0,0,29,0,-29
13069,0,0,19,0,-19
13070,1,1,635,1737,1102
13071,0,0,10,0,-10
13072,0,0,38,0,-38
13073,0,0,8,0,-8
13074,0,0,12,0,-12
13075,0,0,37,0,-37
13076,1,0,7,0,-7
13077,1,1,168,1735,1567
13078,1,1,943,1213,270
13079,1,1,1561,1281,-280
13080,0,0,7,0,-7
13081,1,0,3,0,-3
13082,0,0,26,0,-26
13083,1,1,788,1784,996
13084,0,0,48,0,-48
13085,0,0,62,0,-62
13086,1,1,453,1357,904
13087,0,0,43,0,-43
13088,1,1,111,1445,1334
13089,1,1,558,1222,664
13090,1,1,10,1384,1374
13091,0,0,48,0,-48
13092,1,0,13,0,-13
13093,1,0,2,0,-2
13094,1,1,172,1290,1118
13095,1,1,325,3237,2912
13096,0,0,15,0,-15
13097,1,0,8,0,-8
13098,1,0,1,0,-1
13099,1,0,91,0,-91
13100,0,0,5,0,-5
13101,1,0,31,0,-31
13102,0,0,13,0,-13
13103,1,1,296,1781,1485
13104,1,1,44,1258,1214
13105,1,0,76,0,-76
13106,1,0,46,0,-46
13107,1,1,181,1269,1088
13108,0,0,16,0,-16
13109,1,1,414,1301,887
13110,1,0,131,0,-131
13111,0,0,12,0,-12
13112,0,0,77,0,-77
13113,0,0,18,0,-18
13114,1,1,147,1436,1289
13115,0,0,31,0,-31
13116,1,1,1035,1460,425
13117,1,0,34,0,-34
13118,1,1,392,1307,915
13119,1,1,702,1317,615
13120,0,0,32,0,-32
13121,1,1,75,1209,1134
13122,1,1,363,1411,1048
13123,1,0,12,0,-12
13124,0,0,36,0,-36
13125,0,0,132,0,-132
13126,0,0,4,0,-4
13127,1,0,55,0,-55
13128,1,0,30,0,-30
13129,0,0,22,0,-22
13130,0,0,0,0,0
13131,1,0,76,0,-76
13132,1,1,391,1989,1598
13133,1,1,25,1268,1243
13134,1,1,147,3065,2918
13135,1,1,352,1258,906
13136,1,0,67,0,-67
13137,0,0,9,0,-9
13138,0,0,15,0,-15
13139,0,0,21,0,-21
13140,0,0,31,0,-31
13141,1,1,643,1572,929
13142,0,0,37,0,-37
13143,0,0,20,0,-20
13144,1,0,212,0,-212
13145,0,0,125,0,-125
13146,1,0,25,0,-25
13147,1,1,700,1740,1040
13148,0,0,34,0,-34
13149,1,1,454,1288,834
13150,0,0,11,0,-11
13151,1,1,2552,1323,-1229
13152,1,0,7,0,-7
13153,1,0,2,0,-2
13154,1,0,56,0,-56
13155,0,0,89,0,-89
13156,0,0,132,0,-132
13157,0,0,20,0,-20
13158,0,0,8,0,-8
13159,1,0,12,0,-12
13160,1,1,155,1924,1769
13161,0,0,61,0,-61
13162,1,1,423,2903,2480
13163,1,1,214,1360,1146
13164,1,1,1477,1334,-143
13165,0,0,16,0,-16
13166,1,1,856,1443,587
13167,1,0,24,0,-24
13168,1,1,19,1356,1337
13169,1,1,575,1335,760
13170,1,1,136,1220,1084
13171,0,0,125,0,-125
13172,0,0,15,0,-15
13173,1,0,86,0,-86
13174,0,0,30,0,-30
13175,0,0,12,0,-12
13176,0,0,4,0,-4
13177,0,0,286,0,-286
13178,0,0,103,0,-103
13179,1,1,431,1388,957
13180,0,0,83,0,-83
13181,0,0,134,0,-134
13182,0,0,76,0,-76
13183,0,0,27,0,-27
13184,1,0,2,0,-2
13185,0,0,41,0,-41
13186,0,0,45,0,-45
13187,0,0,3,0,-3
13188,1,0,54,0,-54
13189,1,1,251,1456,1205
13190,1,0,15,0,-15
13191,0,0,40,0,-40
13192,0,0,145,0,-145
13193,0,0,28,0,-28
13194,0,0,14,0,-14
13195,1,0,21,0,-21
13196,0,0,60,0,-60
13197,1,0,1,0,-1
13198,1,1,970,1261,291
13199,1,0,43,0,-43
13200,0,0,95,0,-95
13201,0,0,25,0,-25
13202,0,0,20,0,-20
13203,1,0,10,0,-10
13204,1,1,202,1649,1447
13205,1,1,99,1665,1566
13206,0,0,48,0,-48
13207,1,1,499,1557,1058
13208,0,0,77,0,-77
13209,1,0,47,0,-47
13210,1,0,114,0,-114
13211,1,0,16,0,-16
13212,0,0,37,0,-37
13213,1,1,333,2331,1998
13214,1,1,156,1239,1083
13215,0,0,8,0,-8
13216,0,0,8,0,-8
13217,1,1,594,1961,1367
13218,0,0,81,0,-81
13219,0,0,63,0,-63
13220,0,0,12,0,-12
13221,1,1,832,1371,539
13222,0,0,36,0,-36
13223,0,0,2,0,-2
13224,1,0,18,0,-18
13225,0,0,45,0,-45
13226,1,1,381,1793,1412
13227,1,1,107,1715,1608
13228,0,0,40,0,-40
13229,1,1,277,1706,1429
13230,0,0,37,0,-37
13231,1,1,85,2260,2175
13232,0,0,118,0,-118
13233,1,1,206,1294,1088
13234,1,1,299,1336,1037
13235,1,1,301,1553,1252
13236,1,1,811,1235,424
13237,0,0,9,0,-9
13238,1,0,115,0,-115
13239,0,0,4,0,-4
13240,0,0,11,0,-11
13241,1,1,346,1213,867
13242,1,0,63,0,-63
13243,1,0,6,0,-6
13244,0,0,52,0,-52
13245,1,1,137,1795,1658
13246,1,1,1191,1586,395
13247,1,1,111,1253,1142
13248,1,0,91,0,-91
13249,0,0,7,0,-7
13250,1,1,1367,1657,290
13251,1,1,594,1204,610
13252,0,0,17,0,-17
13253,0,0,191,0,-191
13254,1,0,7,0,-7
13255,1,1,487,1271,784
13256,1,1,178,1371,1193
13257,1,1,146,1289,1143
13258,0,0,179,0,-179
13259,0,0,26,0,-26
13260,0,0,97,0,-97
13261,1,0,18,0,-18
13262,0,0,31,0,-31
13263,1,1,435,1412,977
13264,0,0,27,0,-27
13265,1,1,174,1389,1215
13266,1,0,4,0,-4
13267,1,0,48,0,-48
13268,1,1,148,1352,1204
13269,0,0,32,0,-32
13270,1,1,207,1286,1079
13271,0,0,8,0,-8
13272,1,0,8,0,-8
13273,0,0,3,0,-3
13274,0,0,23,0,-23
13275,0,0,149,0,-149
13276,1,1,73,1415,1342
13277,0,0,7,0,-7
13278,1,1,54,1645,1591
13279,1,0,72,0,-72
13280,1,0,10,0,-10
13281,1,1,238,1224,986
13282,0,0,40,0,-40
13283,1,1,1850,1228,-622
13284,1,0,62,0,-62
13285,1,0,1,0,-1
13286,0,0,19,0,-19
13287,1,0,27,0,-27
13288,1,1,1344,1555,211
13289,0,0,20,0,-20
13290,0,0,100,0,-100
13291,0,0,36,0,-36
13292,0,0,0,0,0
13293,1,1,456,1254,798
13294,0,0,104,0,-104
13295,1,0,6,0,-6
13296,1,1,1168,1342,174
13297,0,0,22,0,-22
13298,1,1,169,3509,3340
13299,1,1,152,1439,1287
13300,1,1,1106,1715,609
13301,0,0,8,0,-8
13302,0,0,59,0,-59
13303,1,1,1056,1635,579
13304,1,0,87,0,-87
13305,1,0,2,0,-2
13306,0,0,48,0,-48
13307,1,0,69,0,-69
13308,1,0,38,0,-38
13309,1,0,32,0,-32
13310,1,1,143,1400,1257
13311,0,0,20,0,-20
13312,1,1,498,1413,915
13313,1,0,97,0,-97
13314,1,0,110,0,-110
13315,0,0,23,0,-23
13316,1,0,40,0,-40
13317,1,1,252,1426,1174
13318,0,0,286,0,-286
13319,1,1,211,1552,1341
13320,1,1,962,1319,357
13321,0,0,63,0,-63
13322,1,0,58,0,-58
13323,0,0,31,0,-31
13324,1,1,288,1520,1232
13325,1,0,92,0,-92
13326,1,1,214,1263,1049
13327,1,0,23,0,-23
13328,0,0,29,0,-29
13329,0,0,87,0,-87
13330,1,1,319,6157,5838
13331,1,1,1162,1286,124
13332,1,0,40,0,-40
13333,0,0,55,0,-55
13334,0,0,31,0,-31
13335,1,0,36,0,-36
13336,1,1,1432,1728,296
13337,0,0,70,0,-70
13338,0,0,5,0,-5
13339,0,0,21,0,-21
13340,0,0,197,0,-197
13341,1,1,284,1558,1274
13342,0,0,38,0,-38
13343,0,0,37,0,-37
13344,1,0,2,0,-2
13345,0,0,38,0,-38
13346,1,1,136,1290,1154
13347,1,0,27,0,-27
13348,1,0,22,0,-22
13349,1,1,678,1267,589
13350,0,0,6,0,-6
13351,1,0,2,0,-2
13352,1,1,271,1215,944
13353,1,0,12,0,-12
13354,1,0,1,0,-1
13355,1,0,5,0,-5
13356,0,0,114,0,-114
13357,1,0,59,0,-59
13358,0,0,37,0,-37
13359,1,1,895,2698,1803
13360,0,0,3,0,-3
13361,1,0,8,0,-8
13362,1,1,684,1587,903
13363,1,1,395,1354,959
13364,1,1,588,1362,774
13365,1,1,125,1521,1396
13366,0,0,6,0,-6
13367,0,0,0,0,0
13368,1,1,50,1589,1539
13369,1,0,105,0,-105
13370,0,0,41,0,-41
13371,1,0,44,0,-44
13372,1,1,643,1248,605
13373,0,0,65,0,-65
13374,1,1,360,1327,967
13375,0,0,35,0,-35
13376,1,1,193,1754,1561
13377,0,0,13,0,-13
13378,0,0,16,0,-16
13379,1,0,3,0,-3
13380,1,1,663,1295,632
13381,0,0,38,0,-38
13382,0,0,46,0,-46
13383,1,1,546,1313,767
13384,0,0,66,0,-66
13385,0,0,6,0,-6
13386,1,1,124,1761,1637
13387,1,1,145,1730,1585
13388,1,1,632,1276,644
13389,0,0,28,0,-28
13390,0,0,54,0,-54
13391,1,1,392,1294,902
13392,0,0,81,0,-81
13393,1,1,554,1369,815
13394,0,0,1,0,-1
13395,1,0,82,0,-82
13396,0,0,110,0,-110
13397,1,0,7,0,-7
13398,0,0,163,0,-163
13399,0,0,17,0,-17
13400,1,0,138,0,-138
13401,0,0,29,0,-29
13402,0,0,61,0,-61
13403,1,1,331,2896,2565
13404,1,0,35,0,-35
13405,1,0,46,0,-46
13406,1,1,1115,1393,278
13407,0,0,17,0,-17
13408,1,0,40,0,-40
13409,1,0,34,0,-34
13410,1,0,129,0,-129
13411,1,0,23,0,-23
13412,0,0,11,0,-11
13413,1,0,16,0,-16
13414,0,0,19,0,-19
13415,1,0,63,0,-63
13416,1,0,68,0,-68
13417,0,0,323,0,-323
13418,1,0,19,0,-19
13419,0,0,29,0,-29
13420,0,0,0,0,0
13421,1,1,975,1810,835
13422,1,1,587,1803,1216
13423,0,0,60,0,-60
13424,1,0,5,0,-5
13425,0,0,45,0,-45
13426,1,0,15,0,-15
13427,1,1,194,1656,1462
13428,0,0,26,0,-26
13429,0,0,10,0,-10
13430,1,0,58,0,-58
13431,1,0,10,0,-10
13432,0,0,2,0,-2
13433,0,0,67,0,-67
13434,0,0,11,0,-11
13435,1,1,309,1383,1074
13436,1,1,1396,1273,-123
13437,1,0,8,0,-8
13438,1,1,237,1365,1128
13439,1,1,193,1716,1523
13440,1,1,751,1857,1106
13441,1,0,7,0,-7
13442,0,0,16,0,-16
13443,1,0,0,0,0
13444,1,1,467,1515,1048
13445,1,1,338,1987,1649
13446,1,0,32,0,-32
13447,1,1,589,1416,827
13448,1,0,135,0,-135
13449,1,1,303,1252,949
13450,0,0,43,0,-43
13451,1,0,30,0,-30
13452,0,0,6,0,-6
13453,1,1,1731,2141,410
13454,1,1,210,1284,1074
13455,0,0,39,0,-39
13456,1,0,74,0,-74
13457,1,0,101,0,-101
13458,0,0,20,0,-20
13459,0,0,4,0,-4
13460,1,1,158,1572,1414
13461,1,1,2650,1335,-1315
13462,0,0,32,0,-32
13463,0,0,16,0,-16
13464,0,0,35,0,-35
13465,1,0,26,0,-26
13466,0,0,39,0,-39
13467,1,1,59,1358,1299
13468,1,1,19,1557,1538
13469,1,1,5,1375,1370
13470,1,0,84,0,-84
13471,0,0,23,0,-23
13472,1,0,0,0,0
13473,1,1,210,2284,2074
13474,1,1,272,1439,1167
13475,1,0,91,0,-91
13476,1,1,69,1207,1138
13477,0,0,41,0,-41
13478,1,1,122,1298,1176
13479,1,1,425,1496,1071
13480,0,0,65,0,-65
13481,1,1,440,1598,1158
13482,1,1,531,2545,2014
13483,0,0,0,0,0
13484,1,0,6,0,-6
13485,0,0,103,0,-103
13486,0,0,4,0,-4
13487,0,0,82,0,-82
13488,0,0,7,0,-7
13489,0,0,5,0,-5
13490,0,0,158,0,-158
13491,1,0,0,0,0
13492,0,0,57,0,-57
13493,0,0,27,0,-27
13494,1,1,591,1329,738
13495,0,0,83,0,-83
13496,0,0,10,0,-10
13497,1,1,850,1563,713
13498,0,0,7,0,-7
13499,1,0,83,0,-83
13500,0,0,24,0,-24
13501,1,1,333,1204,871
13502,1,0,15,0,-15
13503,1,0,475,0,-475
13504,0,0,0,0,0
13505,1,0,22,0,-22
13506,1,0,55,0,-55
13507,0,0,69,0,-69
13508,0,0,28,0,-28
13509,1,0,15,0,-15
13510,1,1,831,1349,518
13511,1,1,62,1410,1348
13512,0,0,7,0,-7
13513,1,1,1015,1527,512
13514,0,0,28,0,-28
13515,1,1,1561,1272,-289
13516,1,1,1368,1473,105
13517,1,0,19,0,-19
13518,1,0,4,0,-4
13519,0,0,103,0,-103
13520,0,0,317,0,-317
13521,1,1,1449,1435,-14
13522,1,1,558,1279,721
13523,0,0,22,0,-22
13524,1,1,1659,1514,-145
13525,1,0,3,0,-3
13526,1,1,1100,1855,755
13527,1,0,34,0,-34
13528,0,0,43,0,-43
13529,1,0,21,0,-21
13530,1,1,265,1348,1083
13531,1,0,32,0,-32
13532,1,1,1779,1449,-330
13533,0,0,3,0,-3
13534,0,0,139,0,-139
13535,1,0,36,0,-36
13536,0,0,43,0,-43
13537,1,1,262,1408,1146
13538,0,0,28,0,-28
13539,1,0,24,0,-24
13540,0,0,62,0,-62
13541,1,0,0,0,0
13542,1,1,130,1305,1175
13543,1,1,597,1263,666
13544,0,0,31,0,-31
13545,0,0,13,0,-13
13546,1,1,1721,1790,69
13547,1,1,264,1695,1431
13548,0,0,151,0,-151
13549,1,0,31,0,-31
13550,1,1,419,1469,1050
13551,1,0,58,0,-58
13552,0,0,97,0,-97
13553,1,0,48,0,-48
13554,0,0,51,0,-51
13555,0,0,15,0,-15
13556,1,0,11,0,-11
13557,0,0,178,0,-178
13558,0,0,44,0,-44
13559,0,0,122,0,-122
13560,1,0,22,0,-22
13561,1,1,357,1275,918
13562,1,0,11,0,-11
13563,1,1,601,1817,1216
13564,1,1,406,2611,2205
13565,0,0,11,0,-11
13566,1,0,7,0,-7
13567,0,0,54,0,-54
13568,1,0,37,0,-37
13569,1,0,25,0,-25
13570,1,1,1010,1263,253
13571,1,1,99,1447,1348
13572,1,1,164,1263,1099
13573,0,0,22,0,-22
13574,0,0,7,0,-7
13575,1,1,449,2753,2304
13576,0,0,25,0,-25
13577,1,1,478,1811,1333
13578,1,0,27,0,-27
13579,1,1,1957,2604,647
13580,0,0,42,0,-42
13581,0,0,115,0,-115
13582,1,0,211,0,-211
13583,1,0,43,0,-43
13584,1,0,19,0,-19
13585,1,0,40,0,-40
13586,0,0,137,0,-137
13587,1,0,84,0,-84
13588,1,1,176,1445,1269
13589,0,0,84,0,-84
13590,0,0,35,0,-35
13591,1,1,720,1603,883
13592,1,0,2,0,-2
13593,1,1,264,1436,1172
13594,1,1,544,1279,735
13595,0,0,19,0,-19
13596,1,1,665,1949,1284
13597,1,1,738,1376,638
13598,1,1,241,1365,1124
13599,0,0,45,0,-45
13600,1,1,167,1438,1271
13601,1,1,1818,1760,-58
13602,1,0,190,0,-190
13603,1,0,105,0,-105
13604,0,0,52,0,-52
13605,0,0,0,0,0
13606,1,0,159,0,-159
13607,1,1,261,1449,1188
13608,0,0,166,0,-166
13609,1,1,362,1241,879
13610,1,1,2056,1309,-747
13611,1,0,103,0,-103
13612,1,1,1937,1644,-293
13613,1,0,84,0,-84
13614,1,1,1353,1246,-107
13615,1,1,525,1638,1113
13616,0,0,4,0,-4
13617,0,0,24,0,-24
13618,0,0,33,0,-33
13619,0,0,171,0,-171
13620,0,0,84,0,-84
13621,1,1,570,1422,852
13622,1,0,11,0,-11
13623,1,0,11,0,-11
13624,1,1,180,6298,6118
13625,0,0,3,0,-3
13626,1,1,448,1916,1468
13627,1,0,10,0,-10
13628,0,0,16,0,-16
13629,0,0,23,0,-23
13630,1,0,36,0,-36
13631,1,1,213,1617,1404
13632,1,0,11,0,-11
13633,0,0,22,0,-22
13634,0,0,46,0,-46
13635,0,0,33,0,-33
13636,0,0,70,0,-70
13637,0,0,6,0,-6
13638,1,0,88,0,-88
13639,1,1,738,1300,562
13640,0,0,0,0,0
13641,1,1,118,1367,1249
13642,1,1,223,1940,1717
13643,0,0,105,0,-105
13644,0,0,40,0,-40
13645,1,1,395,1200,805
13646,1,0,27,0,-27
13647,1,0,36,0,-36
13648,1,0,31,0,-31
13649,1,1,1091,1672,581
13650,0,0,120,0,-120
13651,1,0,115,0,-115
13652,0,0,8,0,-8
13653,1,1,1040,2244,1204
13654,1,1,521,1268,747
13655,1,0,201,0,-201
13656,1,1,224,1731,1507
13657,1,1,252,1326,1074
13658,0,0,129,0,-129
13659,1,0,42,0,-42
13660,1,0,119,0,-119
13661,1,0,4,0,-4
13662,0,0,15,0,-15
13663,0,0,46,0,-46
13664,1,1,381,1886,1505
13665,0,0,25,0,-25
13666,0,0,42,0,-42
13667,1,1,615,1310,695
13668,0,0,17,0,-17
13669,1,1,84,1242,1158
13670,0,0,52,0,-52
13671,0,0,32,0,-32
13672,0,0,3,0,-3
13673,1,0,52,0,-52
13674,0,0,93,0,-93
13675,1,1,412,2315,1903
13676,0,0,17,0,-17
13677,0,0,26,0,-26
13678,1,0,4,0,-4
13679,1,1,911,1861,950
13680,1,0,94,0,-94
13681,1,1,891,1394,503
13682,0,0,59,0,-59
13683,0,0,44,0,-44
13684,0,0,37,0,-37
13685,1,1,879,2015,1136
13686,0,0,8,0,-8
13687,1,0,16,0,-16
13688,1,1,683,2161,1478
13689,0,0,101,0,-101
13690,1,0,7,0,-7
13691,1,0,88,0,-88
13692,0,0,17,0,-17
13693,0,0,30,0,-30
13694,1,0,115,0,-115
13695,1,1,1663,1967,304
13696,1,0,14,0,-14
13697,0,0,25,0,-25
13698,0,0,1,0,-1
13699,1,0,2,0,-2
13700,1,0,5,0,-5
13701,0,0,1,0,-1
13702,1,0,1,0,-1
13703,0,0,200,0,-200
13704,1,0,86,0,-86
13705,1,1,562,1980,1418
13706,1,1,2131,1240,-891
13707,0,0,28,0,-28
13708,1,1,493,1344,851
13709,1,1,17,1472,1455
13710,0,0,17,0,-17
13711,1,1,545,1411,866
13712,1,0,61,0,-61
13713,0,0,55,0,-55
13714,1,1,232,1270,1038
13715,0,0,57,0,-57
13716,0,0,62,0,-62
13717,1,1,184,2331,2147
13718,0,0,5,0,-5
13719,1,1,1141,1347,206
13720,1,0,11,0,-11
13721,0,0,40,0,-40
13722,1,0,236,0,-236
13723,0,0,77,0,-77
13724,1,0,45,0,-45
13725,0,0,44,0,-44
13726,1,1,434,1459,1025
13727,1,1,518,2177,1659
13728,1,1,369,1664,1295
13729,0,0,117,0,-117
13730,0,0,38,0,-38
13731,0,0,3,0,-3
13732,1,1,1206,1568,362
13733,1,0,79,0,-79
13734,1,1,799,1397,598
13735,1,1,998,2346,1348
13736,1,0,17,0,-17
13737,0,0,35,0,-35
13738,1,0,8,0,-8
13739,1,0,104,0,-104
13740,1,1,807,1315,508
13741,1,1,1669,1389,-280
13742,1,1,62,1232,1170
13743,1,1,218,1326,1108
13744,0,0,40,0,-40
13745,1,0,1,0,-1
13746,1,1,1134,1602,468
13747,1,0,54,0,-54
13748,1,0,69,0,-69
13749,0,0,162,0,-162
13750,1,0,27,0,-27
13751,1,1,710,1343,633
13752,0,0,29,0,-29
13753,1,0,90,0,-90
13754,1,1,489,1392,903
13755,1,0,59,0,-59
13756,1,0,80,0,-80
13757,0,0,32,0,-32
13758,0,0,58,0,-58
13759,1,0,2,0,-2
13760,1,0,43,0,-43
13761,1,1,383,2153,1770
13762,0,0,9,0,-9
13763,1,0,3,0,-3
13764,1,0,8,0,-8
13765,0,0,17,0,-17
13766,1,1,1046,2233,1187
13767,1,1,1073,1293,220
13768,1,1,312,2025,1713
13769,0,0,3,0,-3
13770,1,1,27,1620,1593
13771,1,1,29,1323,1294
13772,1,0,110,0,-110
13773,1,0,97,0,-97
13774,0,0,85,0,-85
13775,0,0,155,0,-155
13776,0,0,24,0,-24
13777,0,0,10,0,-10
13778,1,1,54,1270,1216
13779,1,0,6,0,-6
13780,1,0,61,0,-61
13781,0,0,167,0,-167
13782,0,0,24,0,-24
13783,0,0,55,0,-55
13784,0,0,66,0,-66
13785,1,1,303,1274,971
13786,0,0,23,0,-23
13787,1,0,97,0,-97
13788,0,0,36,0,-36
13789,1,0,36,0,-36
13790,1,1,387,1556,1169
13791,1,1,385,3540,3155
13792,0,0,25,0,-25
13793,1,0,19,0,-19
13794,1,1,268,1397,1129
13795,1,0,26,0,-26
13796,1,0,19,0,-19
13797,0,0,18,0,-18
13798,0,0,18,0,-18
13799,0,0,4,0,-4
13800,1,0,13,0,-13
13801,1,1,285,1529,1244
13802,1,1,415,2125,1710
13803,1,1,821,1587,766
13804,0,0,93,0,-93
13805,1,1,948,1854,906
13806,0,0,4,0,-4
13807,0,0,4,0,-4
13808,1,1,498,1397,899
13809,1,1,362,1741,1379
13810,1,0,54,0,-54
13811,1,1,341,1231,890
13812,1,1,107,2135,2028
13813,0,0,64,0,-64
13814,0,0,3,0,-3
13815,1,1,129,1665,1536
13816,0,0,185,0,-185
13817,1,0,14,0,-14
13818,1,1,259,1262,1003
13819,0,0,3,0,-3
13820,1,0,28,0,-28
13821,1,0,27,0,-27
13822,1,0,23,0,-23
13823,0,0,79,0,-79
13824,1,0,19,0,-19
13825,1,1,378,1617,1239
13826,1,1,65,2048,1983
13827,0,0,85,0,-85
13828,1,1,508,1727,1219
13829,0,0,117,0,-117
13830,1,1,653,1341,688
13831,1,0,1,0,-1
13832,1,1,332,1385,1053
13833,1,0,10,0,-10
13834,1,0,72,0,-72
13835,1,0,58,0,-58
13836,1,0,80,0,-80
13837,1,0,65,0,-65
13838,0,0,61,0,-61
13839,0,0,26,0,-26
13840,1,1,806,1461,655
13841,0,0,96,0,-96
13842,1,1,151,2248,2097
13843,1,1,1321,1281,-40
13844,0,0,149,0,-149
13845,1,1,114,1208,1094
13846,1,1,120,1536,1416
13847,0,0,8,0,-8
13848,0,0,138,0,-138
13849,0,0,16,0,-16
13850,1,1,543,1507,964
13851,0,0,16,0,-16
13852,1,0,12,0,-12
13853,1,0,200,0,-200
13854,1,1,289,1262,973
13855,1,0,31,0,-31
13856,1,1,532,1549,1017
13857,0,0,2,0,-2
13858,1,0,48,0,-48
13859,0,0,7,0,-7
13860,0,0,42,0,-42
13861,0,0,73,0,-73
13862,0,0,131,0,-131
13863,1,1,743,1973,1230
13864,1,0,44,0,-44
13865,0,0,2,0,-2
13866,0,0,20,0,-20
13867,0,0,47,0,-47
13868,0,0,8,0,-8
13869,1,1,2027,1741,-286
13870,0,0,110,0,-110
13871,0,0,116,0,-116
13872,1,1,287,1950,1663
13873,0,0,55,0,-55
13874,1,1,339,1282,943
13875,1,1,77,1446,1369
13876,0,0,54,0,-54
13877,1,1,1741,1525,-216
13878,1,0,27,0,-27
13879,1,1,1448,1707,259
13880,1,1,2491,1320,-1171
13881,1,1,498,1522,1024
13882,1,1,215,1283,1068
13883,1,0,240,0,-240
13884,1,0,31,0,-31
13885,1,0,35,0,-35
13886,0,0,54,0,-54
13887,1,0,18,0,-18
13888,1,0,104,0,-104
13889,1,1,234,1494,1260
13890,1,1,55,1353,1298
13891,0,0,116,0,-116
13892,1,0,15,0,-15
13893,1,1,1427,1228,-199
13894,1,0,30,0,-30
13895,1,1,2075,1433,-642
13896,1,0,47,0,-47
13897,1,1,291,1324,1033
13898,1,1,535,3496,2961
13899,0,0,5,0,-5
13900,0,0,185,0,-185
13901,1,1,1018,1485,467
13902,1,0,9,0,-9
13903,1,0,45,0,-45
13904,1,0,33,0,-33
13905,1,0,16,0,-16
13906,0,0,34,0,-34
13907,1,0,10,0,-10
13908,1,1,1399,1837,438
13909,1,0,24,0,-24
13910,0,0,21,0,-21
13911,1,1,197,1766,1569
13912,1,0,10,0,-10
13913,1,0,38,0,-38
13914,0,0,60,0,-60
13915,1,1,324,1295,971
13916,1,0,71,0,-71
13917,1,1,391,1386,995
13918,1,0,0,0,0
13919,1,1,502,1518,1016
13920,1,0,91,0,-91
13921,1,0,107,0,-107
13922,0,0,10,0,-10
13923,1,0,74,0,-74
13924,0,0,17,0,-17
13925,1,0,26,0,-26
13926,0,0,7,0,-7
13927,1,1,303,1768,1465
13928,0,0,10,0,-10
13929,1,1,541,1473,932
13930,0,0,10,0,-10
13931,0,0,122,0,-122
13932,1,0,71,0,-71
13933,1,1,624,1458,834
13934,1,0,79,0,-79
13935,0,0,16,0,-16
13936,1,1,406,1654,1248
13937,1,1,285,1254,969
13938,1,1,1323,1440,117
13939,1,0,25,0,-25
13940,1,0,5,0,-5
13941,0,0,14,0,-14
13942,0,0,26,0,-26
13943,0,0,39,0,-39
13944,1,1,232,2811,2579
13945,0,0,24,0,-24
13946,1,0,25,0,-25
13947,0,0,136,0,-136
13948,0,0,1,0,-1
13949,1,0,6,0,-6
13950,1,0,118,0,-118
13951,0,0,21,0,-21
13952,1,0,12,0,-12
13953,1,0,51,0,-51
13954,1,0,87,0,-87
13955,0,0,17,0,-17
13956,1,1,265,1216,951
13957,1,1,111,1338,1227
13958,0,0,96,0,-96
13959,1,1,112,1288,1176
13960,1,0,24,0,-24
13961,1,0,41,0,-41
13962,0,0,17,0,-17
13963,0,0,46,0,-46
13964,0,0,37,0,-37
13965,0,0,46,0,-46
13966,0,0,25,0,-25
13967,1,1,787,1371,584
13968,1,1,360,1329,969
13969,1,0,3,0,-3
13970,0,0,55,0,-55
13971,1,0,29,0,-29
13972,0,0,11,0,-11
13973,1,0,10,0,-10
13974,1,1,302,1546,1244
13975,1,1,581,1347,766
13976,0,0,75,0,-75
13977,1,0,98,0,-98
13978,1,1,248,1705,1457
13979,1,1,324,1278,954
13980,1,0,8,0,-8
13981,1,0,8,0,-8
13982,0,0,56,0,-56
13983,1,0,38,0,-38
13984,1,1,509,1252,743
13985,0,0,349,0,-349
13986,1,1,1202,1266,64
13987,0,0,12,0,-12
13988,1,0,13,0,-13
13989,0,0,110,0,-110
13990,0,0,74,0,-74
13991,0,0,88,0,-88
13992,0,0,18,0,-18
13993,1,0,80,0,-80
13994,1,0,29,0,-29
13995,0,0,142,0,-142
13996,0,0,98,0,-98
13997,0,0,49,0,-49
13998,1,0,36,0,-36
13999,1,0,2,0,-2
14000,1,1,325,1281,956
14001,1,1,576,2510,1934
14002,1,0,63,0,-63
14003,0,0,5,0,-5
14004,0,0,59,0,-59
14005,1,1,402,1708,1306
14006,1,1,410,1854,1444
14007,0,0,0,0,0
14008,0,0,128,0,-128
14009,0,0,74,0,-74
14010,1,0,6,0,-6
14011,1,0,69,0,-69
14012,0,0,120,0,-120
14013,1,1,115,1229,1114
14014,1,0,128,0,-128
14015,1,1,78,1358,1280
14016,1,1,263,1766,1503
14017,0,0,112,0,-112
14018,0,0,6,0,-6
14019,1,0,132,0,-132
14020,0,0,17,0,-17
14021,1,0,15,0,-15
14022,1,0,11,0,-11
14023,1,0,48,0,-48
14024,1,0,54,0,-54
14025,1,1,253,1836,1583
14026,0,0,22,0,-22
14027,1,0,38,0,-38
14028,1,0,4,0,-4
14029,0,0,55,0,-55
14030,0,0,74,0,-74
14031,1,0,61,0,-61
14032,1,0,9,0,-9
14033,0,0,1,0,-1
14034,1,0,30,0,-30
14035,1,0,33,0,-33
14036,0,0,58,0,-58
14037,0,0,24,0,-24
14038,1,0,47,0,-47
14039,0,0,6,0,-6
14040,1,1,478,1607,1129
14041,0,0,66,0,-66
14042,0,0,10,0,-10
14043,1,1,1049,1315,266
14044,0,0,8,0,-8
14045,1,0,23,0,-23
14046,1,0,115,0,-115
14047,0,0,9,0,-9
14048,1,1,282,1238,956
14049,0,0,23,0,-23
14050,1,1,577,1627,1050
14051,1,0,27,0,-27
14052,1,1,103,1215,1112
14053,0,0,40,0,-40
14054,1,1,97,4685,4588
14055,1,1,810,1256,446
14056,0,0,229,0,-229
14057,0,0,26,0,-26
14058,1,0,190,0,-190
14059,1,0,160,0,-160
14060,1,1,399,1306,907
14061,0,0,27,0,-27
14062,1,1,65,1801,1736
14063,1,0,4,0,-4
14064,0,0,46,0,-46
14065,1,0,180,0,-180
14066,0,0,83,0,-83
14067,0,0,138,0,-138
14068,1,1,231,1288,1057
14069,1,1,688,1377,689
14070,0,0,41,0,-41
14071,0,0,22,0,-22
14072,1,1,83,2271,2188
14073,0,0,0,0,0
14074,0,0,4,0,-4
14075,1,1,160,1442,1282
14076,1,1,272,1366,1094
14077,1,0,74,0,-74
14078,0,0,89,0,-89
14079,0,0,32,0,-32
14080,1,0,18,0,-18
14081,0,0,73,0,-73
14082,1,0,70,0,-70
14083,1,1,191,2133,1942
14084,0,0,81,0,-81
14085,1,1,160,1403,1243
14086,0,0,125,0,-125
14087,1,1,666,1345,679
14088,0,0,15,0,-15
14089,1,1,120,1295,1175
14090,0,0,83,0,-83
14091,0,0,69,0,-69
14092,1,1,416,1461,1045
14093,1,1,165,1230,1065
14094,0,0,77,0,-77
14095,0,0,61,0,-61
14096,1,1,292,1282,990
14097,1,0,5,0,-5
14098,1,1,765,1386,621
14099,0,0,15,0,-15
14100,1,1,270,1373,1103
14101,1,1,240,1285,1045
14102,1,0,92,0,-92
14103,1,0,3,0,-3
14104,0,0,23,0,-23
14105,1,1,359,1240,881
14106,1,0,151,0,-151
14107,0,0,48,0,-48
14108,0,0,81,0,-81
14109,0,0,152,0,-152
14110,1,1,176,1631,1455
14111,0,0,6,0,-6
14112,1,1,294,1339,1045
14113,0,0,64,0,-64
14114,0,0,99,0,-99
14115,0,0,1,0,-1
14116,1,0,47,0,-47
14117,1,1,709,1223,514
14118,1,1,695,1230,535
14119,1,0,42,0,-42
14120,0,0,11,0,-11
14121,0,0,25,0,-25
14122,1,1,667,1302,635
14123,0,0,19,0,-19
14124,1,0,34,0,-34
14125,1,1,195,1210,1015
14126,1,1,599,1277,678
14127,1,0,41,0,-41
14128,0,0,66,0,-66
14129,0,0,48,0,-48
14130,0,0,57,0,-57
14131,0,0,10,0,-10
14132,1,0,49,0,-49
14133,1,1,436,1291,855
14134,0,0,6,0,-6
14135,1,1,1134,1803,669
14136,1,1,458,1243,785
14137,0,0,70,0,-70
14138,0,0,4,0,-4
14139,1,0,11,0,-11
14140,1,1,457,1430,973
14141,1,0,45,0,-45
14142,1,1,155,1922,1767
14143,0,0,3,0,-3
14144,1,1,347,1317,970
14145,1,0,172,0,-172
14146,0,0,78,0,-78
14147,1,0,45,0,-45
14148,0,0,96,0,-96
14149,1,0,27,0,-27
14150,0,0,22,0,-22
14151,1,1,678,1311,633
14152,0,0,45,0,-45
14153,1,1,147,1411,1264
14154,0,0,0,0,0
14155,0,0,10,0,-10
14156,1,1,47,1386,1339
14157,0,0,37,0,-37
14158,1,0,67,0,-67
14159,1,0,11,0,-11
14160,1,1,3047,1221,-1826
14161,1,1,699,1249,550
14162,0,0,36,0,-36
14163,1,0,4,0,-4
14164,1,0,1,0,-1
14165,1,1,494,1244,750
14166,1,0,21,0,-21
14167,0,0,95,0,-95
14168,0,0,102,0,-102
14169,0,0,53,0,-53
14170,1,0,27,0,-27
14171,1,1,1449,1316,-133
14172,1,1,294,1261,967
14173,0,0,43,0,-43
14174,0,0,36,0,-36
14175,1,1,117,1241,1124
14176,1,1,1244,1219,-25
14177,0,0,126,0,-126
14178,0,0,15,0,-15
14179,0,0,82,0,-82
14180,1,1,610,1232,622
14181,0,0,5,0,-5
14182,1,0,149,0,-149
14183,1,1,692,1547,855
14184,1,1,174,2716,2542
14185,0,0,219,0,-219
14186,1,0,18,0,-18
14187,1,0,59,0,-59
14188,1,1,1939,1562,-377
14189,0,0,4,0,-4
14190,1,0,52,0,-52
14191,1,1,60,1468,1408
14192,0,0,13,0,-13
14193,1,0,2,0,-2
14194,0,0,45,0,-45
14195,0,0,10,0,-10
14196,1,0,22,0,-22
14197,0,0,21,0,-21
14198,1,1,1165,1588,423
14199,1,1,316,1643,1327
14200,1,1,157,1504,1347
14201,0,0,5,0,-5
14202,0,0,4,0,-4
14203,1,0,31,0,-31
14204,1,0,21,0,-21
14205,0,0,84,0,-84
14206,1,1,496,1300,804
14207,1,1,257,1668,1411
14208,0,0,74,0,-74
14209,1,1,383,1757,1374
14210,1,0,26,0,-26
14211,0,0,75,0,-75
14212,0,0,10,0,-10
14213,1,0,11,0,-11
14214,1,0,28,0,-28
14215,0,0,10,0,-10
14216,1,1,63,1223,1160
14217,1,0,4,0,-4
14218,1,0,64,0,-64
14219,0,0,89,0,-89
14220,1,0,8,0,-8
14221,0,0,24,0,-24
14222,1,0,80,0,-80
14223,1,1,416,1294,878
14224,1,1,90,1913,1823
14225,0,0,68,0,-68
14226,1,0,24,0,-24
14227,1,1,432,1267,835
14228,0,0,45,0,-45
14229,0,0,5,0,-5
14230,1,1,83,1773,1690
14231,0,0,63,0,-63
14232,0,0,15,0,-15
14233,1,0,12,0,-12
14234,1,0,20,0,-20
14235,1,0,0,0,0
14236,1,0,0,0,0
14237,1,0,12,0,-12
14238,1,1,291,1528,1237
14239,1,1,179,1307,1128
14240,1,1,95,1201,1106
14241,0,0,50,0,-50
14242,0,0,39,0,-39
14243,1,1,41,1358,1317
14244,1,1,878,1369,491
14245,0,0,38,0,-38
14246,0,0,19,0,-19
14247,1,0,77,0,-77
14248,0,0,6,0,-6
14249,1,0,36,0,-36
14250,0,0,1,0,-1
14251,1,1,820,1453,633
14252,1,1,1239,1230,-9
14253,1,1,616,1537,921
14254,1,1,313,1596,1283
14255,1,0,38,0,-38
14256,1,0,8,0,-8
14257,1,1,335,1452,1117
14258,0,0,86,0,-86
14259,0,0,72,0,-72
14260,0,0,96,0,-96
14261,1,0,5,0,-5
14262,0,0,12,0,-12
14263,0,0,8,0,-8
14264,0,0,44,0,-44
14265,0,0,72,0,-72
14266,0,0,30,0,-30
14267,1,1,216,1995,1779
14268,0,0,50,0,-50
14269,0,0,61,0,-61
14270,0,0,12,0,-12
14271,0,0,23,0,-23
14272,1,1,1033,1368,335
14273,1,0,71,0,-71
14274,1,1,91,1238,1147
14275,1,1,475,1251,776
14276,1,0,6,0,-6
14277,1,1,628,1325,697
14278,1,1,1486,2090,604
14279,0,0,8,0,-8
14280,0,0,115,0,-115
14281,0,0,68,0,-68
14282,1,1,526,1344,818
14283,1,0,6,0,-6
14284,1,1,93,1726,1633
14285,0,0,6,0,-6
14286,1,1,325,1305,980
14287,1,1,133,1476,1343
14288,1,1,162,1541,1379
14289,1,1,793,1223,430
14290,0,0,32,0,-32
14291,1,1,695,1583,888
14292,0,0,88,0,-88
14293,1,0,13,0,-13
14294,1,0,3,0,-3
14295,1,1,2111,1444,-667
14296,0,0,69,0,-69
14297,1,0,34,0,-34
14298,0,0,6,0,-6
14299,1,1,784,1375,591
14300,1,0,143,0,-143
14301,1,0,118,0,-118
14302,0,0,182,0,-182
14303,1,0,0,0,0
14304,0,0,8,0,-8
14305,1,1,485,1235,750
14306,1,0,67,0,-67
14307,0,0,42,0,-42
14308,0,0,56,0,-56
14309,1,0,20,0,-20
14310,1,0,96,0,-96
14311,1,1,304,1574,1270
14312,0,0,3,0,-3
14313,1,1,506,1794,1288
14314,1,1,129,1335,1206
14315,1,0,1,0,-1
14316,0,0,28,0,-28
14317,0,0,94,0,-94
14318,1,0,53,0,-53
14319,1,0,105,0,-105
14320,1,0,17,0,-17
14321,0,0,8,0,-8
14322,1,0,28,0,-28
14323,1,1,461,1465,1004
14324,1,1,178,1660,1482
14325,1,0,131,0,-131
14326,0,0,16,0,-16
14327,1,0,57,0,-57
14328,0,0,13,0,-13
14329,0,0,12,0,-12
14330,0,0,71,0,-71
14331,0,0,50,0,-50
14332,0,0,15,0,-15
14333,1,1,42,1364,1322
14334,1,0,48,0,-48
14335,0,0,70,0,-70
14336,0,0,16,0,-16
14337,0,0,7,0,-7
14338,0,0,16,0,-16
14339,1,0,5,0,-5
14340,0,0,47,0,-47
14341,0,0,1,0,-1
14342,1,0,23,0,-23
14343,1,0,39,0,-39
14344,0,0,0,0,0
14345,1,1,917,1353,436
14346,1,0,105,0,-105
14347,0,0,12,0,-12
14348,1,0,54,0,-54
14349,1,0,28,0,-28
14350,1,0,8,0,-8
14351,1,0,77,0,-77
14352,1,0,5,0,-5
14353,0,0,53,0,-53
14354,1,0,2,0,-2
14355,1,0,3,0,-3
14356,0,0,54,0,-54
14357,1,0,56,0,-56
14358,0,0,61,0,-61
14359,1,1,37,1204,1167
14360,1,1,1803,1371,-432
14361,1,1,347,1252,905
14362,1,0,95,0,-95
14363,0,0,60,0,-60
14364,1,1,89,3735,3646
14365,0,0,8,0,-8
14366,1,0,23,0,-23
14367,0,0,13,0,-13
14368,1,0,32,0,-32
14369,1,1,183,1521,1338
14370,1,0,41,0,-41
14371,1,1,319,1469,1150
14372,0,0,51,0,-51
14373,0,0,2,0,-2
14374,0,0,41,0,-41
14375,0,0,58,0,-58
14376,0,0,5,0,-5
14377,1,1,231,1358,1127
14378,1,1,76,1384,1308
14379,0,0,90,0,-90
14380,0,0,17,0,-17
14381,1,0,20,0,-20
14382,1,0,51,0,-51
14383,1,0,40,0,-40
14384,0,0,98,0,-98
14385,1,0,38,0,-38
14386,1,0,65,0,-65
14387,1,0,13,0,-13
14388,1,1,306,1332,1026
14389,1,0,34,0,-34
14390,1,1,201,1691,1490
14391,1,0,29,0,-29
14392,0,0,3,0,-3
14393,0,0,33,0,-33
14394,1,0,1,0,-1
14395,0,0,56,0,-56
14396,1,1,539,2353,1814
14397,0,0,40,0,-40
14398,1,0,106,0,-106
14399,0,0,100,0,-100
14400,1,0,15,0,-15
14401,1,0,15,0,-15
14402,0,0,83,0,-83
14403,1,0,14,0,-14
14404,1,0,5,0,-5
14405,1,0,11,0,-11
14406,1,0,1,0,-1
14407,0,0,18,0,-18
14408,1,1,1052,1237,185
14409,1,1,741,1266,525
14410,0,0,3,0,-3
14411,1,1,343,1492,1149
14412,1,0,18,0,-18
14413,1,0,0,0,0
14414,0,0,84,0,-84
14415,1,1,457,2011,1554
14416,1,0,28,0,-28
14417,0,0,2,0,-2
14418,0,0,2,0,-2
14419,1,0,27,0,-27
14420,0,0,52,0,-52
14421,0,0,39,0,-39
14422,1,0,140,0,-140
14423,1,1,196,1218,1022
14424,1,1,121,1288,1167
14425,1,1,328,1482,1154
14426,0,0,22,0,-22
14427,1,1,635,1391,756
14428,1,1,262,1223,961
14429,0,0,47,0,-47
14430,0,0,49,0,-49
14431,1,0,65,0,-65
14432,0,0,44,0,-44
14433,1,0,9,0,-9
14434,1,1,180,1307,1127
14435,0,0,17,0,-17
14436,1,1,243,1315,1072
14437,0,0,2,0,-2
14438,1,0,23,0,-23
14439,1,0,6,0,-6
14440,1,0,18,0,-18
14441,1,0,9,0,-9
14442,0,0,52,0,-52
14443,0,0,35,0,-35
14444,1,0,100,0,-100
14445,0,0,14,0,-14
14446,0,0,37,0,-37
14447,0,0,32,0,-32
14448,0,0,56,0,-56
14449,1,1,955,1751,796
14450,1,1,384,1438,1054
14451,0,0,9,0,-9
14452,1,1,68,1228,1160
14453,1,0,81,0,-81
14454,0,0,19,0,-19
14455,1,1,1026,1488,462
14456,0,0,108,0,-108
14457,1,0,5,0,-5
14458,1,0,5,0,-5
14459,0,0,6,0,-6
14460,1,0,24,0,-24
14461,1,0,43,0,-43
14462,1,1,104,1507,1403
14463,1,1,331,1513,1182
14464,0,0,0,0,0
14465,1,1,355,1654,1299
14466,1,1,581,2857,2276
14467,1,1,473,1243,770
14468,1,0,86,0,-86
14469,0,0,15,0,-15
14470,0,0,1,0,-1
14471,1,0,25,0,-25
14472,0,0,99,0,-99
14473,0,0,79,0,-79
14474,1,0,89,0,-89
14475,1,1,549,2219,1670
14476,1,1,247,1323,1076
14477,1,1,192,1391,1199
14478,1,0,92,0,-92
14479,1,0,20,0,-20
14480,1,0,34,0,-34
14481,1,1,941,1237,296
14482,1,0,129,0,-129
14483,1,0,60,0,-60
14484,1,0,10,0,-10
14485,0,0,5,0,-5
14486,1,0,35,0,-35
14487,0,0,46,0,-46
14488,1,0,86,0,-86
14489,1,0,85,0,-85
14490,1,1,430,2072,1642
14491,1,1,805,1205,400
14492,0,0,53,0,-53
14493,1,1,95,1328,1233
14494,0,0,112,0,-112
14495,1,0,90,0,-90
14496,1,0,71,0,-71
14497,1,1,302,1406,1104
14498,0,0,22,0,-22
14499,1,0,64,0,-64
14500,1,0,36,0,-36
14501,0,0,14,0,-14
14502,0,0,27,0,-27
14503,1,1,322,1210,888
14504,0,0,44,0,-44
14505,1,1,292,1248,956
14506,1,0,50,0,-50
14507,1,1,65,1632,1567
14508,1,0,96,0,-96
14509,0,0,49,0,-49
14510,1,0,15,0,-15
14511,1,0,37,0,-37
14512,1,0,23,0,-23
14513,0,0,14,0,-14
14514,1,0,58,0,-58
14515,0,0,50,0,-50
14516,1,0,241,0,-241
14517,1,1,46,1228,1182
14518,1,1,225,1238,1013
14519,1,1,230,1309,1079
14520,1,1,207,1231,1024
14521,1,1,1849,1484,-365
14522,1,1,774,1207,433
14523,1,0,35,0,-35
14524,1,0,188,0,-188
14525,0,0,24,0,-24
14526,1,1,885,1267,382
14527,1,0,22,0,-22
14528,1,0,38,0,-38
14529,1,0,65,0,-65
14530,1,0,23,0,-23
14531,0,0,3,0,-3
14532,1,0,24,0,-24
14533,1,1,1081,1557,476
14534,1,0,11,0,-11
14535,0,0,8,0,-8
14536,0,0,1,0,-1
14537,0,0,7,0,-7
14538,1,1,177,1587,1410
14539,1,0,26,0,-26
14540,0,0,23,0,-23
14541,1,1,179,1224,1045
14542,1,0,29,0,-29
14543,0,0,17,0,-17
14544,1,0,31,0,-31
14545,1,0,2,0,-2
14546,1,0,5,0,-5
14547,1,0,2,0,-2
14548,1,1,1833,1276,-557
14549,1,0,69,0,-69
14550,0,0,35,0,-35
14551,1,0,107,0,-107
14552,1,1,332,1896,1564
14553,1,0,26,0,-26
14554,0,0,29,0,-29
14555,0,0,3,0,-3
14556,0,0,20,0,-20
14557,0,0,51,0,-51
14558,1,1,446,1579,1133
14559,1,0,62,0,-62
14560,0,0,36,0,-36
14561,1,0,77,0,-77
14562,1,1,28,1544,1516
14563,1,1,99,1285,1186
14564,0,0,10,0,-10
14565,0,0,52,0,-52
14566,1,1,2825,1591,-1234
14567,1,1,23,1272,1249
14568,1,1,634,1533,899
14569,0,0,31,0,-31
14570,1,1,1134,1299,165
14571,1,0,2,0,-2
14572,0,0,174,0,-174
14573,1,0,7,0,-7
14574,1,0,11,0,-11
14575,1,1,1017,2970,1953
14576,0,0,73,0,-73
14577,1,0,1,0,-1
14578,1,1,98,1216,1118
14579,0,0,144,0,-144
14580,1,1,266,1446,1180
14581,1,0,3,0,-3
14582,1,1,248,1362,1114
14583,1,0,111,0,-111
14584,0,0,83,0,-83
14585,1,1,375,1202,827
14586,0,0,20,0,-20
14587,1,1,402,2940,2538
14588,0,0,83,0,-83
14589,0,0,73,0,-73
14590,0,0,5,0,-5
14591,0,0,44,0,-44
14592,1,0,9,0,-9
14593,1,1,220,1213,993
14594,1,0,47,0,-47
14595,1,1,617,1523,906
14596,1,0,10,0,-10
14597,1,0,12,0,-12
14598,0,0,28,0,-28
14599,1,1,923,1507,584
14600,0,0,189,0,-189
14601,0,0,210,0,-210
14602,1,0,10,0,-10
14603,0,0,53,0,-53
14604,1,0,29,0,-29
14605,1,1,436,1214,778
14606,0,0,35,0,-35
14607,0,0,28,0,-28
14608,0,0,1,0,-1
14609,1,0,45,0,-45
14610,0,0,14,0,-14
14611,1,1,318,1767,1449
14612,1,0,0,0,0
14613,1,1,1103,1771,668
14614,1,0,55,0,-55
14615,1,0,8,0,-8
14616,1,1,968,1815,847
14617,1,1,389,1807,1418
14618,1,1,378,1793,1415
14619,1,1,339,1827,1488
14620,1,0,21,0,-21
14621,1,1,1734,1623,-111
14622,0,0,363,0,-363
14623,0,0,9,0,-9
14624,0,0,7,0,-7
14625,1,0,107,0,-107
14626,0,0,39,0,-39
14627,0,0,30,0,-30
14628,0,0,142,0,-142
14629,1,0,23,0,-23
14630,1,1,1877,1550,-327
14631,1,0,166,0,-166
14632,1,1,44,1516,1472
14633,1,0,13,0,-13
14634,1,0,19,0,-19
14635,1,0,17,0,-17
14636,1,0,6,0,-6
14637,1,0,34,0,-34
14638,0,0,41,0,-41
14639,0,0,147,0,-147
14640,1,1,702,1385,683
14641,1,0,43,0,-43
14642,1,0,48,0,-48
14643,0,0,40,0,-40
14644,1,1,150,1376,1226
14645,1,1,157,1258,1101
14646,1,0,24,0,-24
14647,1,0,8,0,-8
14648,1,0,66,0,-66
14649,0,0,5,0,-5
14650,1,0,26,0,-26
14651,1,1,396,1371,975
14652,0,0,14,0,-14
14653,1,1,29,9039,9010
14654,0,0,0,0,0
14655,1,1,786,1210,424
14656,1,1,187,1214,1027
14657,1,1,601,2856,2255
14658,1,1,93,1553,1460
14659,0,0,0,0,0
14660,1,1,178,2007,1829
14661,0,0,6,0,-6
14662,1,0,27,0,-27
14663,1,1,1671,1231,-440
14664,0,0,3,0,-3
14665,1,0,100,0,-100
14666,0,0,3,0,-3
14667,1,1,206,1347,1141
14668,1,1,754,1701,947
14669,1,0,53,0,-53
14670,1,0,17,0,-17
14671,0,0,34,0,-34
14672,0,0,73,0,-73
14673,1,0,59,0,-59
14674,0,0,45,0,-45
14675,0,0,56,0,-56
14676,1,1,246,1702,1456
14677,0,0,106,0,-106
14678,1,1,388,1214,826
14679,0,0,20,0,-20
14680,1,1,469,1569,1100
14681,1,0,4,0,-4
14682,1,0,118,0,-118
14683,0,0,17,0,-17
14684,1,0,36,0,-36
14685,0,0,16,0,-16
14686,1,0,51,0,-51
14687,1,0,29,0,-29
14688,0,0,61,0,-61
14689,1,1,429,1280,851
14690,1,0,66,0,-66
14691,1,1,85,1690,1605
14692,0,0,10,0,-10
14693,1,0,69,0,-69
14694,1,1,577,2078,1501
14695,0,0,2,0,-2
14696,0,0,2,0,-2
14697,0,0,90,0,-90
14698,0,0,25,0,-25
14699,0,0,14,0,-14
14700,1,1,260,1511,1251
14701,1,0,50,0,-50
14702,1,0,23,0,-23
14703,0,0,58,0,-58
14704,0,0,125,0,-125
14705,1,0,72,0,-72
14706,1,0,24,0,-24
14707,1,0,64,0,-64
14708,0,0,30,0,-30
14709,1,1,116,1333,1217
14710,0,0,7,0,-7
14711,1,1,323,1221,898
14712,0,0,190,0,-190
14713,0,0,14,0,-14
14714,0,0,15,0,-15
14715,1,1,1090,1565,475
14716,1,0,22,0,-22
14717,1,1,154,2258,2104
14718,1,0,21,0,-21
14719,1,0,105,0,-105
14720,1,1,497,1572,1075
14721,1,0,48,0,-48
14722,0,0,5,0,-5
14723,0,0,224,0,-224
14724,1,0,37,0,-37
14725,1,0,75,0,-75
14726,1,0,7,0,-7
14727,0,0,176,0,-176
14728,0,0,27,0,-27
14729,0,0,45,0,-45
14730,1,0,159,0,-159
14731,0,0,3,0,-3
14732,1,1,896,1516,620
14733,1,0,137,0,-137
14734,1,0,130,0,-130
14735,0,0,4,0,-4
14736,0,0,5,0,-5
14737,0,0,31,0,-31
14738,0,0,11,0,-11
14739,0,0,95,0,-95
14740,0,0,95,0,-95
14741,0,0,58,0,-58
14742,0,0,36,0,-36
14743,1,0,16,0,-16
14744,1,1,354,1735,1381
14745,1,1,259,1940,1681
14746,1,1,110,1752,1642
14747,1,0,9,0,-9
14748,0,0,43,0,-43
14749,1,0,1,0,-1
14750,0,0,60,0,-60
14751,1,0,32,0,-32
14752,1,0,91,0,-91
14753,0,0,4,0,-4
14754,0,0,149,0,-149
14755,0,0,82,0,-82
14756,0,0,22,0,-22
14757,0,0,28,0,-28
14758,1,1,1027,1798,771
14759,1,0,16,0,-16
14760,1,0,40,0,-40
14761,0,0,37,0,-37
14762,1,0,74,0,-74
14763,1,0,27,0,-27
14764,0,0,19,0,-19
14765,0,0,65,0,-65
14766,0,0,16,0,-16
14767,0,0,5,0,-5
14768,0,0,94,0,-94
14769,1,0,79,0,-79
14770,0,0,48,0,-48
14771,0,0,128,0,-128
14772,1,1,681,2480,1799
14773,1,1,516,1712,1196
14774,1,0,121,0,-121
14775,0,0,0,0,0
14776,0,0,1,0,-1
14777,1,1,605,1488,883
14778,1,1,399,1351,952
14779,0,0,83,0,-83
14780,1,0,21,0,-21
14781,1,0,154,0,-154
14782,1,0,33,0,-33
14783,0,0,29,0,-29
14784,0,0,6,0,-6
14785,1,1,109,1353,1244
14786,0,0,24,0,-24
14787,0,0,41,0,-41
14788,1,0,187,0,-187
14789,1,0,129,0,-129
14790,1,0,24,0,-24
14791,0,0,38,0,-38
14792,1,1,211,1471,1260
14793,0,0,34,0,-34
14794,1,1,669,1234,565
14795,0,0,5,0,-5
14796,0,0,144,0,-144
14797,0,0,48,0,-48
14798,0,0,61,0,-61
14799,0,0,60,0,-60
14800,1,1,277,1318,1041
14801,0,0,122,0,-122
14802,1,0,25,0,-25
14803,0,0,16,0,-16
14804,1,0,17,0,-17
14805,0,0,11,0,-11
14806,0,0,86,0,-86
14807,0,0,1,0,-1
14808,1,1,310,1749,1439
14809,1,0,84,0,-84
14810,1,1,982,1830,848
14811,0,0,51,0,-51
14812,0,0,145,0,-145
14813,0,0,1,0,-1
14814,0,0,39,0,-39
14815,0,0,133,0,-133
14816,0,0,102,0,-102
14817,1,1,767,1221,454
14818,0,0,84,0,-84
14819,1,1,2205,1208,-997
14820,1,0,22,0,-22
14821,1,0,48,0,-48
14822,0,0,38,0,-38
14823,1,1,188,1338,1150
14824,1,0,76,0,-76
14825,0,0,90,0,-90
14826,1,0,6,0,-6
14827,1,1,1030,1205,175
14828,0,0,1,0,-1
14829,1,1,398,2287,1889
14830,0,0,12,0,-12
14831,0,0,115,0,-115
14832,1,0,33,0,-33
14833,0,0,109,0,-109
14834,0,0,70,0,-70
14835,1,0,16,0,-16
14836,0,0,15,0,-15
14837,0,0,69,0,-69
14838,0,0,222,0,-222
14839,1,0,32,0,-32
14840,1,1,35,1532,1497
14841,0,0,24,0,-24
14842,0,0,10,0,-10
14843,0,0,0,0,0
14844,1,0,2,0,-2
14845,1,1,34,1456,1422
14846,0,0,139,0,-139
14847,0,0,15,0,-15
14848,1,1,206,1529,1323
14849,0,0,6,0,-6
14850,1,1,859,1306,447
14851,1,0,24,0,-24
14852,1,1,65,2719,2654
14853,1,0,64,0,-64
14854,0,0,113,0,-113
14855,0,0,68,0,-68
14856,1,0,12,0,-12
14857,1,0,2,0,-2
14858,0,0,34,0,-34
14859,0,0,69,0,-69
14860,1,1,158,3703,3545
14861,0,0,22,0,-22
14862,1,0,63,0,-63
14863,1,0,7,0,-7
14864,0,0,110,0,-110
14865,0,0,21,0,-21
14866,1,1,452,1329,877
14867,0,0,83,0,-83
14868,1,1,722,1365,643
14869,0,0,42,0,-42
14870,0,0,66,0,-66
14871,0,0,137,0,-137
14872,1,1,1092,1547,455
14873,0,0,31,0,-31
14874,1,1,379,1326,947
14875,0,0,2,0,-2
14876,0,0,77,0,-77
14877,1,1,437,4412,3975
14878,1,0,54,0,-54
14879,1,1,588,1342,754
14880,1,0,121,0,-121
14881,1,0,13,0,-13
14882,1,1,75,1288,1213
14883,1,0,16,0,-16
14884,1,0,18,0,-18
14885,1,1,276,1284,1008
14886,0,0,3,0,-3
14887,0,0,259,0,-259
14888,1,1,223,1334,1111
14889,1,1,125,1266,1141
14890,1,1,512,1271,759
14891,1,1,473,2048,1575
14892,0,0,85,0,-85
14893,0,0,7,0,-7
14894,1,0,15,0,-15
14895,1,0,69,0,-69
14896,1,0,69,0,-69
14897,1,1,1355,1436,81
14898,1,1,399,1678,1279
14899,0,0,12,0,-12
14900,1,1,80,1299,1219
14901,0,0,72,0,-72
14902,1,1,130,1312,1182
14903,1,0,114,0,-114
14904,1,1,520,1362,842
14905,1,0,92,0,-92
14906,1,1,624,2037,1413
14907,1,0,74,0,-74
14908,1,1,295,1219,924
14909,1,0,5,0,-5
14910,1,0,17,0,-17
14911,0,0,92,0,-92
14912,0,0,13,0,-13
14913,1,1,468,1366,898
14914,0,0,194,0,-194
14915,1,0,63,0,-63
14916,1,1,104,4076,3972
14917,0,0,70,0,-70
14918,1,0,2,0,-2
14919,0,0,76,0,-76
14920,1,0,11,0,-11
14921,1,0,71,0,-71
14922,1,1,651,1416,765
14923,0,0,139,0,-139
14924,0,0,19,0,-19
14925,1,0,37,0,-37
14926,1,0,162,0,-162
14927,1,0,33,0,-33
14928,1,1,1093,1612,519
14929,1,0,25,0,-25
14930,0,0,109,0,-109
14931,0,0,50,0,-50
14932,1,1,154,1697,1543
14933,1,0,69,0,-69
14934,1,0,20,0,-20
14935,1,0,50,0,-50
14936,1,1,982,1309,327
14937,0,0,184,0,-184
14938,1,1,480,1339,859
14939,1,1,80,1604,1524
14940,0,0,42,0,-42
14941,1,1,518,2057,1539
14942,1,0,14,0,-14
14943,1,1,226,1278,1052
14944,1,0,73,0,-73
14945,1,1,323,1429,1106
14946,1,0,71,0,-71
14947,1,0,44,0,-44
14948,0,0,113,0,-113
14949,1,1,261,2722,2461
14950,1,0,36,0,-36
14951,0,0,20,0,-20
14952,1,0,84,0,-84
14953,1,1,274,1283,1009
14954,1,1,107,1420,1313
14955,1,1,125,1417,1292
14956,1,1,177,1847,1670
14957,1,0,103,0,-103
14958,1,1,249,1387,1138
14959,0,0,36,0,-36
14960,1,1,166,1619,1453
14961,1,0,175,0,-175
14962,1,0,10,0,-10
14963,1,0,1,0,-1
14964,1,0,21,0,-21
14965,1,1,182,1545,1363
14966,0,0,3,0,-3
14967,1,0,7,0,-7
14968,1,1,3128,1308,-1820
14969,1,0,19,0,-19
14970,0,0,1,0,-1
14971,1,1,266,1500,1234
14972,0,0,12,0,-12
14973,1,0,3,0,-3
14974,1,1,347,1594,1247
14975,1,0,45,0,-45
14976,1,1,112,1255,1143
14977,1,1,1315,1216,-99
14978,0,0,109,0,-109
14979,1,0,11,0,-11
14980,1,0,15,0,-15
14981,0,0,121,0,-121
14982,1,0,69,0,-69
14983,1,1,917,1402,485
14984,1,1,165,1455,1290
14985,0,0,3,0,-3
14986,0,0,111,0,-111
14987,1,0,77,0,-77
14988,0,0,1,0,-1
14989,0,0,33,0,-33
14990,1,0,111,0,-111
14991,1,1,2103,3584,1481
14992,1,1,327,1295,968
14993,1,1,605,1303,698
14994,0,0,8,0,-8
14995,0,0,5,0,-5
14996,1,1,541,1680,1139
14997,1,0,97,0,-97
14998,1,0,64,0,-64
14999,1,1,269,1241,972
15000,0,0,113,0,-113
15001,1,1,153,3103,2950
15002,1,0,14,0,-14
15003,0,0,104,0,-104
15004,1,1,115,1269,1154
15005,1,1,257,1929,1672
15006,1,1,58,1384,1326
15007,1,0,44,0,-44
15008,1,0,80,0,-80
15009,0,0,26,0,-26
15010,1,1,21,2043,2022
15011,1,0,8,0,-8
15012,0,0,13,0,-13
15013,0,0,37,0,-37
15014,1,0,28,0,-28
15015,1,1,43,1259,1216
15016,1,1,1881,1262,-619
15017,1,1,439,1652,1213
15018,1,0,111,0,-111
15019,0,0,1,0,-1
15020,1,1,165,1275,1110
15021,0,0,41,0,-41
15022,0,0,25,0,-25
15023,1,0,9,0,-9
15024,1,0,60,0,-60
15025,1,1,519,1366,847
15026,1,1,347,1327,980
15027,0,0,39,0,-39
15028,0,0,128,0,-128
15029,1,1,127,1514,1387
15030,0,0,11,0,-11
15031,1,1,204,2199,1995
15032,0,0,3,0,-3
15033,1,1,22,1429,1407
15034,1,1,439,1498,1059
15035,0,0,14,0,-14
15036,1,1,673,1425,752
15037,1,1,845,1411,566
15038,1,1,435,1464,1029
15039,1,0,17,0,-17
15040,1,0,243,0,-243
15041,1,0,68,0,-68
15042,1,0,98,0,-98
15043,0,0,78,0,-78
15044,1,1,387,1362,975
15045,0,0,7,0,-7
15046,1,0,15,0,-15
15047,0,0,34,0,-34
15048,1,1,997,1232,235
15049,1,0,73,0,-73
15050,1,0,1,0,-1
15051,0,0,27,0,-27
15052,1,0,41,0,-41
15053,0,0,51,0,-51
15054,0,0,75,0,-75
15055,1,1,1198,1212,14
15056,1,0,243,0,-243
15057,1,1,199,1343,1144
15058,1,1,1162,1329,167
15059,1,0,3,0,-3
15060,1,1,340,1382,1042
15061,0,0,72,0,-72
15062,0,0,99,0,-99
15063,0,0,27,0,-27
15064,1,0,39,0,-39
15065,0,0,28,0,-28
15066,0,0,2,0,-2
15067,0,0,62,0,-62
15068,1,1,443,1374,931
15069,1,1,383,1354,971
15070,1,1,144,1294,1150
15071,1,0,4,0,-4
15072,1,1,300,1656,1356
15073,1,1,1510,1378,-132
15074,1,1,403,1883,1480
15075,1,0,34,0,-34
15076,1,1,11,1393,1382
15077,0,0,44,0,-44
15078,1,1,77,1376,1299
15079,1,0,10,0,-10
15080,0,0,75,0,-75
15081,1,1,219,1350,1131
15082,0,0,53,0,-53
15083,0,0,38,0,-38
15084,1,1,294,1802,1508
15085,1,1,77,1261,1184
15086,1,0,15,0,-15
15087,1,0,31,0,-31
15088,0,0,50,0,-50
15089,0,0,26,0,-26
15090,1,0,97,0,-97
15091,1,0,86,0,-86
15092,1,0,176,0,-176
15093,1,0,9,0,-9
15094,1,1,729,1675,946
15095,1,1,92,1392,1300
15096,0,0,21,0,-21
15097,0,0,89,0,-89
15098,1,1,129,1762,1633
15099,0,0,76,0,-76
15100,1,1,128,1627,1499
15101,1,0,16,0,-16
15102,1,1,22,3226,3204
15103,1,0,132,0,-132
15104,1,0,120,0,-120
15105,0,0,75,0,-75
15106,1,1,322,2514,2192
15107,1,1,514,1569,1055
15108,0,0,15,0,-15
15109,0,0,27,0,-27
15110,0,0,64,0,-64
15111,0,0,21,0,-21
15112,0,0,14,0,-14
15113,1,0,29,0,-29
15114,1,0,97,0,-97
15115,1,1,737,1209,472
15116,1,0,90,0,-90
15117,0,0,25,0,-25
15118,0,0,35,0,-35
15119,1,0,274,0,-274
15120,1,1,503,1241,738
15121,0,0,54,0,-54
15122,0,0,28,0,-28
15123,1,1,1773,1603,-170
15124,1,1,116,1512,1396
15125,1,1,203,2592,2389
15126,1,0,72,0,-72
15127,1,1,93,1546,1453
15128,1,1,277,2258,1981
15129,1,1,164,1233,1069
15130,0,0,40,0,-40
15131,0,0,94,0,-94
15132,1,0,4,0,-4
15133,1,0,0,0,0
15134,0,0,116,0,-116
15135,0,0,13,0,-13
15136,1,0,3,0,-3
15137,0,0,8,0,-8
15138,0,0,145,0,-145
15139,1,0,21,0,-21
15140,0,0,122,0,-122
15141,1,0,19,0,-19
15142,1,0,75,0,-75
15143,1,0,75,0,-75
15144,1,0,9,0,-9
15145,0,0,38,0,-38
15146,0,0,1,0,-1
15147,1,1,973,1620,647
15148,0,0,9,0,-9
15149,1,1,565,1227,662
15150,1,1,197,1682,1485
15151,0,0,83,0,-83
15152,1,1,1143,1347,204
15153,0,0,80,0,-80
15154,1,0,50,0,-50
15155,0,0,224,0,-224
15156,1,1,363,1668,1305
15157,0,0,76,0,-76
15158,1,0,205,0,-205
15159,1,0,34,0,-34
15160,0,0,40,0,-40
15161,1,0,63,0,-63
15162,1,1,507,1243,736
15163,1,0,35,0,-35
15164,1,0,29,0,-29
15165,1,0,5,0,-5
15166,1,1,94,1223,1129
15167,0,0,76,0,-76
15168,1,0,2,0,-2
15169,1,1,361,4620,4259
15170,1,0,30,0,-30
15171,1,1,643,1549,906
15172,1,0,39,0,-39
15173,0,0,24,0,-24
15174,0,0,22,0,-22
15175,0,0,25,0,-25
15176,1,1,93,1966,1873
15177,1,1,822,1223,401
15178,1,1,1581,1208,-373
15179,0,0,41,0,-41
15180,1,0,14,0,-14
15181,1,1,934,1633,699
15182,1,0,8,0,-8
15183,1,0,28,0,-28
15184,1,1,1011,1544,533
15185,1,1,348,1226,878
15186,1,1,1183,1401,218
15187,0,0,7,0,-7
15188,1,0,12,0,-12
15189,1,0,27,0,-27
15190,1,1,402,1272,870
15191,1,0,14,0,-14
15192,0,0,2,0,-2
15193,1,0,17,0,-17
15194,1,1,302,1921,1619
15195,1,1,186,1297,1111
15196,0,0,66,0,-66
15197,0,0,16,0,-16
15198,1,1,149,2091,1942
15199,0,0,21,0,-21
15200,1,1,425,1554,1129
15201,1,0,17,0,-17
15202,0,0,8,0,-8
15203,1,0,57,0,-57
15204,1,1,103,1507,1404
15205,0,0,129,0,-129
15206,1,0,104,0,-104
15207,0,0,48,0,-48
15208,0,0,196,0,-196
15209,0,0,77,0,-77
15210,1,1,474,1435,961
15211,1,1,883,2779,1896
15212,0,0,94,0,-94
15213,1,1,927,1204,277
15214,1,1,151,2008,1857
15215,1,1,752,1303,551
15216,0,0,79,0,-79
15217,1,0,35,0,-35
15218,1,0,1,0,-1
15219,1,1,148,1237,1089
15220,0,0,64,0,-64
15221,1,1,268,1989,1721
15222,0,0,48,0,-48
15223,1,0,79,0,-79
15224,0,0,64,0,-64
15225,0,0,3,0,-3
15226,0,0,72,0,-72
15227,1,0,35,0,-35
15228,1,1,378,2475,2097
15229,1,0,33,0,-33
15230,1,1,514,2212,1698
15231,1,0,3,0,-3
15232,1,1,620,1641,1021
15233,0,0,3,0,-3
15234,1,0,0,0,0
15235,1,1,113,1213,1100
15236,0,0,5,0,-5
15237,0,0,29,0,-29
15238,1,1,413,1211,798
15239,0,0,8,0,-8
15240,1,1,697,1239,542
15241,0,0,2,0,-2
15242,1,1,519,1256,737
15243,1,0,7,0,-7
15244,0,0,18,0,-18
15245,1,0,69,0,-69
15246,1,1,66,1336,1270
15247,0,0,0,0,0
15248,0,0,23,0,-23
15249,0,0,3,0,-3
15250,0,0,43,0,-43
15251,1,0,48,0,-48
15252,0,0,77,0,-77
15253,1,1,534,1255,721
15254,0,0,25,0,-25
15255,0,0,33,0,-33
15256,1,1,885,2364,1479
15257,1,0,12,0,-12
15258,1,1,68,1980,1912
15259,1,0,56,0,-56
15260,1,0,47,0,-47
15261,1,0,8,0,-8
15262,1,1,3001,1391,-1610
15263,1,1,273,1297,1024
15264,1,1,446,1268,822
15265,0,0,65,0,-65
15266,0,0,12,0,-12
15267,1,0,8,0,-8
15268,0,0,74,0,-74
15269,0,0,10,0,-10
15270,1,0,80,0,-80
15271,1,0,45,0,-45
15272,1,0,78,0,-78
15273,1,0,62,0,-62
15274,1,0,4,0,-4
15275,1,1,421,1433,1012
15276,0,0,28,0,-28
15277,0,0,127,0,-127
15278,0,0,11,0,-11
15279,1,0,6,0,-6
15280,1,1,411,1599,1188
15281,1,1,474,1762,1288
15282,0,0,58,0,-58
15283,1,0,32,0,-32
15284,1,1,269,1480,1211
15285,0,0,19,0,-19
15286,0,0,124,0,-124
15287,1,0,62,0,-62
15288,1,1,460,2707,2247
15289,1,0,5,0,-5
15290,0,0,81,0,-81
15291,1,0,30,0,-30
15292,0,0,81,0,-81
15293,1,0,30,0,-30
15294,0,0,0,0,0
15295,1,0,79,0,-79
15296,1,0,40,0,-40
15297,0,0,199,0,-199
15298,1,0,135,0,-135
15299,1,0,51,0,-51
15300,1,1,277,1223,946
15301,0,0,99,0,-99
15302,0,0,43,0,-43
15303,0,0,6,0,-6
15304,1,1,436,1857,1421
15305,1,1,255,1774,1519
15306,1,0,28,0,-28
15307,0,0,31,0,-31
15308,0,0,84,0,-84
15309,0,0,24,0,-24
15310,0,0,146,0,-146
15311,1,0,2,0,-2
15312,0,0,66,0,-66
15313,1,0,2,0,-2
15314,1,1,649,1277,628
15315,1,1,96,1331,1235
15316,0,0,55,0,-55
15317,1,1,282,3050,2768
15318,1,1,507,1570,1063
15319,1,0,42,0,-42
15320,1,0,33,0,-33
15321,1,0,23,0,-23
15322,0,0,32,0,-32
15323,1,1,48,1266,1218
15324,1,1,151,2544,2393
15325,1,1,955,1245,290
15326,0,0,15,0,-15
15327,1,1,104,1297,1193
15328,1,1,156,1204,1048
15329,1,1,105,1347,1242
15330,0,0,83,0,-83
15331,1,0,60,0,-60
15332,1,0,18,0,-18
15333,0,0,26,0,-26
15334,0,0,77,0,-77
15335,1,1,318,1399,1081
15336,0,0,14,0,-14
15337,1,0,221,0,-221
15338,1,0,99,0,-99
15339,1,0,71,0,-71
15340,0,0,65,0,-65
15341,0,0,63,0,-63
15342,1,0,49,0,-49
15343,1,1,59,1513,1454
15344,1,1,1795,2073,278
15345,0,0,21,0,-21
15346,1,0,19,0,-19
15347,1,0,76,0,-76
15348,1,0,38,0,-38
15349,1,1,409,2123,1714
15350,0,0,0,0,0
15351,0,0,66,0,-66
15352,1,1,71,1539,1468
15353,1,1,730,1237,507
15354,1,0,30,0,-30
15355,1,0,46,0,-46
15356,1,1,218,2276,2058
15357,1,1,129,1221,1092
15358,1,1,60,1341,1281
15359,0,0,40,0,-40
15360,0,0,14,0,-14
15361,0,0,96,0,-96
15362,0,0,19,0,-19
15363,0,0,10,0,-10
15364,0,0,59,0,-59
15365,1,0,85,0,-85
15366,1,1,721,2013,1292
15367,1,1,530,1205,675
15368,0,0,46,0,-46
15369,0,0,44,0,-44
15370,1,0,180,0,-180
15371,1,0,59,0,-59
15372,1,0,55,0,-55
15373,1,1,101,1262,1161
15374,1,1,1392,1862,470
15375,1,0,0,0,0
15376,1,1,990,1528,538
15377,1,1,504,1421,917
15378,1,0,6,0,-6
15379,1,0,14,0,-14
15380,1,1,154,1420,1266
15381,0,0,23,0,-23
15382,0,0,56,0,-56
15383,1,0,2,0,-2
15384,1,0,134,0,-134
15385,1,1,1608,1265,-343
15386,1,1,794,1809,1015
15387,1,1,44,1286,1242
15388,1,0,196,0,-196
15389,1,1,540,1596,1056
15390,1,1,331,1319,988
15391,0,0,92,0,-92
15392,1,0,6,0,-6
15393,0,0,69,0,-69
15394,0,0,5,0,-5
15395,1,1,528,2189,1661
15396,0,0,1,0,-1
15397,0,0,39,0,-39
15398,1,0,38,0,-38
15399,0,0,6,0,-6
15400,1,0,69,0,-69
15401,0,0,121,0,-121
15402,1,1,471,1393,922
15403,1,1,270,1220,950
15404,1,1,1455,1665,210
15405,1,1,286,1204,918
15406,0,0,24,0,-24
15407,1,1,276,1818,1542
15408,1,0,8,0,-8
15409,0,0,4,0,-4
15410,1,0,0,0,0
15411,1,0,0,0,0
15412,0,0,43,0,-43
15413,1,0,9,0,-9
15414,0,0,93,0,-93
15415,1,0,66,0,-66
15416,1,0,93,0,-93
15417,0,0,29,0,-29
15418,0,0,74,0,-74
15419,1,0,115,0,-115
15420,0,0,3,0,-3
15421,1,1,673,1366,693
15422,1,0,14,0,-14
15423,0,0,47,0,-47
15424,1,0,7,0,-7
15425,1,1,62,2600,2538
15426,1,0,19,0,-19
15427,0,0,31,0,-31
15428,1,1,242,1292,1050
15429,1,1,570,1317,747
15430,1,0,6,0,-6
15431,0,0,104,0,-104
15432,0,0,74,0,-74
15433,1,1,158,1423,1265
15434,1,0,48,0,-48
15435,1,1,373,1804,1431
15436,1,0,11,0,-11
15437,1,1,1387,1570,183
15438,1,0,181,0,-181
15439,0,0,37,0,-37
15440,1,0,86,0,-86
15441,0,0,6,0,-6
15442,0,0,8,0,-8
15443,1,1,1279,2007,728
15444,1,1,100,1486,1386
15445,1,1,254,1321,1067
15446,1,1,857,1511,654
15447,1,1,728,1210,482
15448,0,0,25,0,-25
15449,1,0,59,0,-59
15450,1,0,22,0,-22
15451,1,0,23,0,-23
15452,0,0,164,0,-164
15453,0,0,30,0,-30
15454,0,0,106,0,-106
15455,1,0,0,0,0
15456,0,0,49,0,-49
15457,1,0,21,0,-21
15458,1,1,542,1388,846
15459,1,0,11,0,-11
15460,0,0,90,0,-90
15461,1,0,61,0,-61
15462,0,0,32,0,-32
15463,1,0,17,0,-17
15464,0,0,15,0,-15
15465,1,0,30,0,-30
15466,1,0,74,0,-74
15467,0,0,36,0,-36
15468,1,1,585,1254,669
15469,1,1,217,1213,996
15470,1,0,103,0,-103
15471,1,1,462,1273,811
15472,0,0,21,0,-21
15473,1,0,37,0,-37
15474,0,0,34,0,-34
15475,1,0,22,0,-22
15476,0,0,27,0,-27
15477,0,0,22,0,-22
15478,1,0,225,0,-225
15479,0,0,76,0,-76
15480,0,0,52,0,-52
15481,0,0,46,0,-46
15482,1,0,87,0,-87
15483,0,0,6,0,-6
15484,1,1,37,2096,2059
15485,1,0,34,0,-34
15486,1,0,35,0,-35
15487,1,0,117,0,-117
15488,1,0,49,0,-49
15489,0,0,3,0,-3
15490,1,0,8,0,-8
15491,1,1,390,1397,1007
15492,1,1,467,1265,798
15493,1,1,823,1361,538
15494,0,0,32,0,-32
15495,0,0,0,0,0
15496,0,0,78,0,-78
15497,0,0,32,0,-32
15498,1,1,407,1277,870
15499,0,0,5,0,-5
15500,1,1,991,1945,954
15501,0,0,67,0,-67
15502,1,1,445,1234,789
15503,0,0,24,0,-24
15504,1,1,285,1275,990
15505,0,0,6,0,-6
15506,1,1,961,1288,327
15507,1,0,11,0,-11
15508,0,0,74,0,-74
15509,1,1,1018,1265,247
15510,1,0,14,0,-14
15511,1,0,17,0,-17
15512,1,0,33,0,-33
15513,1,0,4,0,-4
15514,1,0,32,0,-32
15515,0,0,7,0,-7
15516,0,0,75,0,-75
15517,1,0,28,0,-28
15518,0,0,13,0,-13
15519,1,1,203,1329,1126
15520,1,0,17,0,-17
15521,1,1,256,1212,956
15522,1,1,375,1354,979
15523,0,0,11,0,-11
15524,0,0,46,0,-46
15525,0,0,31,0,-31
15526,1,0,17,0,-17
15527,0,0,3,0,-3
15528,1,0,29,0,-29
15529,1,0,141,0,-141
15530,1,0,54,0,-54
15531,0,0,6,0,-6
15532,0,0,73,0,-73
15533,0,0,76,0,-76
15534,1,1,230,1205,975
15535,0,0,9,0,-9
15536,0,0,94,0,-94
15537,1,0,1,0,-1
15538,0,0,47,0,-47
15539,1,0,33,0,-33
15540,1,0,3,0,-3
15541,1,1,188,1570,1382
15542,1,0,76,0,-76
15543,1,1,380,1220,840
15544,1,0,97,0,-97
15545,0,0,41,0,-41
15546,1,0,30,0,-30
15547,1,1,391,1841,1450
15548,0,0,28,0,-28
15549,1,0,84,0,-84
15550,0,0,14,0,-14
15551,0,0,30,0,-30
15552,0,0,93,0,-93
15553,1,0,44,0,-44
15554,1,1,657,1203,546
15555,1,0,0,0,0
15556,0,0,12,0,-12
15557,1,0,88,0,-88
15558,1,1,141,1216,1075
15559,1,0,21,0,-21
15560,0,0,31,0,-31
15561,1,1,712,1301,589
15562,0,0,21,0,-21
15563,1,1,845,1301,456
15564,1,1,156,1543,1387
15565,0,0,39,0,-39
15566,0,0,28,0,-28
15567,0,0,83,0,-83
15568,0,0,16,0,-16
15569,1,1,1202,1333,131
15570,0,0,38,0,-38
15571,0,0,11,0,-11
15572,1,1,426,1463,1037
15573,1,1,234,6230,5996
15574,1,0,74,0,-74
15575,0,0,182,0,-182
15576,1,0,12,0,-12
15577,0,0,26,0,-26
15578,0,0,130,0,-130
15579,1,0,17,0,-17
15580,0,0,43,0,-43
15581,0,0,15,0,-15
15582,1,1,134,1296,1162
15583,0,0,52,0,-52
15584,0,0,96,0,-96
15585,0,0,59,0,-59
15586,1,0,95,0,-95
15587,1,0,92,0,-92
15588,0,0,117,0,-117
15589,0,0,66,0,-66
15590,1,0,26,0,-26
15591,0,0,93,0,-93
15592,1,0,191,0,-191
15593,0,0,1,0,-1
15594,0,0,37,0,-37
15595,1,0,145,0,-145
15596,0,0,2,0,-2
15597,1,0,7,0,-7
15598,1,0,106,0,-106
15599,1,0,70,0,-70
15600,1,0,106,0,-106
15601,1,0,11,0,-11
15602,1,0,2,0,-2
15603,0,0,20,0,-20
15604,1,1,313,1389,1076
15605,1,0,2,0,-2
15606,1,1,973,1288,315
15607,0,0,42,0,-42
15608,0,0,19,0,-19
15609,1,1,1112,1391,279
15610,1,1,265,1632,1367
15611,1,0,101,0,-101
15612,0,0,36,0,-36
15613,1,0,33,0,-33
15614,0,0,0,0,0
15615,1,0,101,0,-101
15616,0,0,5,0,-5
15617,1,1,522,1374,852
15618,1,0,47,0,-47
15619,0,0,6,0,-6
15620,0,0,16,0,-16
15621,1,0,103,0,-103
15622,0,0,29,0,-29
15623,1,0,37,0,-37
15624,1,1,38,1294,1256
15625,0,0,120,0,-120
15626,1,1,1015,1219,204
15627,1,1,280,2342,2062
15628,1,0,7,0,-7
15629,0,0,34,0,-34
15630,1,1,1229,1293,64
15631,0,0,20,0,-20
15632,0,0,15,0,-15
15633,1,0,10,0,-10
15634,1,0,0,0,0
15635,1,0,48,0,-48
15636,1,1,596,1249,653
15637,1,0,29,0,-29
15638,0,0,10,0,-10
15639,1,1,103,1598,1495
15640,0,0,32,0,-32
15641,0,0,5,0,-5
15642,0,0,0,0,0
15643,0,0,84,0,-84
15644,0,0,29,0,-29
15645,1,0,1,0,-1
15646,0,0,50,0,-50
15647,1,1,275,5104,4829
15648,1,0,18,0,-18
15649,1,0,52,0,-52
15650,0,0,31,0,-31
15651,1,0,36,0,-36
15652,1,1,1002,1231,229
15653,0,0,46,0,-46
15654,1,1,580,1248,668
15655,0,0,111,0,-111
15656,0,0,132,0,-132
15657,1,1,145,1470,1325
15658,1,1,307,1639,1332
15659,0,0,20,0,-20
15660,1,0,0,0,0
15661,1,0,52,0,-52
15662,1,0,36,0,-36
15663,0,0,9,0,-9
15664,1,1,552,1210,658
15665,0,0,136,0,-136
15666,1,0,106,0,-106
15667,1,1,1036,1481,445
15668,0,0,65,0,-65
15669,1,1,573,1203,630
15670,0,0,9,0,-9
15671,1,1,663,1437,774
15672,0,0,42,0,-42
15673,0,0,131,0,-131
15674,1,0,45,0,-45
15675,1,1,179,2039,1860
15676,0,0,134,0,-134
15677,1,1,376,1312,936
15678,1,1,565,1519,954
15679,0,0,0,0,0
15680,1,1,62,1318,1256
15681,1,1,1554,2112,558
15682,0,0,44,0,-44
15683,1,1,640,1464,824
15684,0,0,73,0,-73
15685,0,0,24,0,-24
15686,0,0,36,0,-36
15687,1,1,88,3024,2936
15688,1,1,318,1563,1245
15689,1,0,89,0,-89
15690,0,0,0,0,0
15691,0,0,111,0,-111
15692,1,0,75,0,-75
15693,1,1,560,1336,776
15694,0,0,28,0,-28
15695,1,0,88,0,-88
15696,0,0,27,0,-27
15697,1,1,440,1304,864
15698,1,0,15,0,-15
15699,0,0,37,0,-37
15700,1,1,383,1632,1249
15701,1,0,22,0,-22
15702,0,0,36,0,-36
15703,0,0,159,0,-159
15704,1,1,474,1366,892
15705,1,1,758,1718,960
15706,1,0,404,0,-404
15707,1,1,1079,2192,1113
15708,1,0,7,0,-7
15709,0,0,12,0,-12
15710,1,1,1331,1275,-56
15711,1,0,60,0,-60
15712,0,0,84,0,-84
15713,1,1,331,5566,5235
15714,1,1,1131,1622,491
15715,1,0,32,0,-32
15716,1,0,65,0,-65
15717,1,1,572,1617,1045
15718,0,0,11,0,-11
15719,1,0,39,0,-39
15720,0,0,27,0,-27
15721,0,0,56,0,-56
15722,0,0,78,0,-78
15723,1,0,104,0,-104
15724,1,1,265,1635,1370
15725,1,1,287,1261,974
15726,0,0,263,0,-263
15727,0,0,60,0,-60
15728,1,0,32,0,-32
15729,1,1,617,1260,643
15730,0,0,235,0,-235
15731,0,0,40,0,-40
15732,1,0,17,0,-17
15733,0,0,44,0,-44
15734,1,1,302,1455,1153
15735,1,1,1164,1302,138
15736,1,1,1012,1585,573
15737,0,0,7,0,-7
15738,0,0,21,0,-21
15739,0,0,3,0,-3
15740,1,1,124,1821,1697
15741,0,0,15,0,-15
15742,1,0,3,0,-3
15743,1,0,34,0,-34
15744,1,1,176,1354,1178
15745,0,0,79,0,-79
15746,1,1,1982,1622,-360
15747,1,0,2,0,-2
15748,1,0,81,0,-81
15749,0,0,94,0,-94
15750,1,0,27,0,-27
15751,0,0,24,0,-24
15752,0,0,76,0,-76
15753,1,1,423,1775,1352
15754,1,1,664,1633,969
15755,1,1,259,1553,1294
15756,1,0,28,0,-28
15757,1,0,19,0,-19
15758,1,1,628,1677,1049
15759,0,0,6,0,-6
15760,0,0,25,0,-25
15761,0,0,16,0,-16
15762,0,0,96,0,-96
15763,1,1,278,1239,961
15764,0,0,11,0,-11
15765,1,1,87,2218,2131
15766,0,0,60,0,-60
15767,0,0,21,0,-21
15768,1,1,584,1254,670
15769,0,0,17,0,-17
15770,1,1,1934,1648,-286
15771,1,0,25,0,-25
15772,1,0,30,0,-30
15773,1,1,145,1206,1061
15774,1,1,354,1207,853
15775,1,0,28,0,-28
15776,1,1,890,1341,451
15777,0,0,26,0,-26
15778,1,1,793,1334,541
15779,1,0,41,0,-41
15780,1,0,71,0,-71
15781,1,0,32,0,-32
15782,1,0,69,0,-69
15783,1,1,618,1282,664
15784,1,1,164,1276,1112
15785,1,0,21,0,-21
15786,1,0,34,0,-34
15787,1,1,182,1711,1529
15788,0,0,34,0,-34
15789,0,0,2,0,-2
15790,0,0,0,0,0
15791,0,0,27,0,-27
15792,0,0,51,0,-51
15793,1,1,44,1587,1543
15794,0,0,113,0,-113
15795,1,0,39,0,-39
15796,0,0,102,0,-102
15797,0,0,15,0,-15
15798,0,0,6,0,-6
15799,0,0,45,0,-45
15800,0,0,54,0,-54
15801,1,0,82,0,-82
15802,1,1,104,1356,1252
15803,0,0,46,0,-46
15804,1,1,42,1353,1311
15805,1,0,65,0,-65
15806,0,0,5,0,-5
15807,0,0,106,0,-106
15808,0,0,165,0,-165
15809,0,0,49,0,-49
15810,1,1,853,1244,391
15811,0,0,14,0,-14
15812,0,0,26,0,-26
15813,0,0,210,0,-210
15814,0,0,15,0,-15
15815,1,0,48,0,-48
15816,1,0,27,0,-27
15817,1,1,614,1338,724
15818,0,0,44,0,-44
15819,1,1,377,1288,911
15820,0,0,24,0,-24
15821,0,0,100,0,-100
15822,1,1,819,1685,866
15823,1,1,503,1458,955
15824,1,0,12,0,-12
15825,0,0,151,0,-151
15826,0,0,24,0,-24
15827,1,0,49,0,-49
15828,0,0,9,0,-9
15829,0,0,23,0,-23
15830,0,0,139,0,-139
15831,1,0,13,0,-13
15832,1,1,360,1715,1355
15833,1,0,21,0,-21
15834,1,1,67,1855,1788
15835,1,0,12,0,-12
15836,1,0,47,0,-47
15837,1,0,13,0,-13
15838,1,0,5,0,-5
15839,1,0,13,0,-13
15840,1,1,222,1265,1043
15841,1,0,68,0,-68
15842,0,0,9,0,-9
15843,1,1,110,1312,1202
15844,1,1,408,1463,1055
15845,1,1,15,1249,1234
15846,1,1,363,1238,875
15847,0,0,56,0,-56
15848,1,0,20,0,-20
15849,1,0,61,0,-61
15850,0,0,3,0,-3
15851,1,0,22,0,-22
15852,1,1,864,1231,367
15853,1,1,526,1500,974
15854,1,0,9,0,-9
15855,1,1,56,1874,1818
15856,0,0,91,0,-91
15857,0,0,10,0,-10
15858,1,0,60,0,-60
15859,1,0,30,0,-30
15860,0,0,4,0,-4
15861,1,1,79,1279,1200
15862,0,0,71,0,-71
15863,1,0,4,0,-4
15864,1,0,3,0,-3
15865,0,0,29,0,-29
15866,1,1,532,1266,734
15867,0,0,24,0,-24
15868,1,0,0,0,0
15869,0,0,128,0,-128
15870,0,0,76,0,-76
15871,1,1,1711,2143,432
15872,1,1,557,1643,1086
15873,1,1,223,2027,1804
15874,1,0,8,0,-8
15875,1,1,258,1338,1080
15876,1,1,62,1254,1192
15877,1,1,255,1829,1574
15878,1,0,11,0,-11
15879,1,1,148,1415,1267
15880,1,1,516,1286,770
15881,0,0,20,0,-20
15882,1,0,80,0,-80
15883,0,0,22,0,-22
15884,0,0,17,0,-17
15885,1,0,68,0,-68
15886,0,0,1,0,-1
15887,1,1,163,1279,1116
15888,0,0,48,0,-48
15889,1,1,614,1377,763
15890,0,0,2,0,-2
15891,0,0,126,0,-126
15892,1,0,34,0,-34
15893,0,0,94,0,-94
15894,1,1,445,1228,783
15895,0,0,78,0,-78
15896,0,0,13,0,-13
15897,1,1,47,1249,1202
15898,1,0,5,0,-5
15899,1,0,92,0,-92
15900,1,1,138,1459,1321
15901,1,1,772,1329,557
15902,1,1,243,1336,1093
15903,0,0,93,0,-93
15904,1,0,27,0,-27
15905,1,1,574,2016,1442
15906,1,1,903,1462,559
15907,1,0,17,0,-17
15908,1,1,78,1585,1507
15909,1,0,42,0,-42
15910,1,1,389,1249,860
15911,1,1,1686,1246,-440
15912,0,0,178,0,-178
15913,1,1,650,1561,911
15914,0,0,19,0,-19
15915,1,1,62,1361,1299
15916,1,1,573,1264,691
15917,1,1,813,1219,406
15918,1,0,39,0,-39
15919,1,0,9,0,-9
15920,0,0,14,0,-14
15921,1,0,89,0,-89
15922,1,0,11,0,-11
15923,1,0,43,0,-43
15924,1,1,278,1218,940
15925,0,0,5,0,-5
15926,1,1,269,1645,1376
15927,1,1,468,1276,808
15928,1,1,334,1473,1139
15929,0,0,41,0,-41
15930,1,1,967,2777,1810
15931,0,0,56,0,-56
15932,1,1,499,1584,1085
15933,0,0,63,0,-63
15934,0,0,22,0,-22
15935,0,0,153,0,-153
15936,0,0,45,0,-45
15937,1,0,23,0,-23
15938,0,0,45,0,-45
15939,0,0,53,0,-53
15940,0,0,28,0,-28
15941,1,1,155,2080,1925
15942,1,1,212,1766,1554
15943,0,0,11,0,-11
15944,1,0,258,0,-258
15945,0,0,25,0,-25
15946,0,0,5,0,-5
15947,1,0,15,0,-15
15948,1,0,32,0,-32
15949,1,0,18,0,-18
15950,1,1,736,1483,747
15951,1,1,1142,1326,184
15952,1,1,384,1484,1100
15953,1,1,279,1434,1155
15954,0,0,65,0,-65
15955,1,1,276,1576,1300
15956,1,0,39,0,-39
15957,1,1,1187,1672,485
15958,1,0,27,0,-27
15959,1,0,22,0,-22
15960,1,0,154,0,-154
15961,0,0,13,0,-13
15962,1,0,17,0,-17
15963,1,0,15,0,-15
15964,0,0,13,0,-13
15965,1,1,202,1443,1241
15966,0,0,32,0,-32
15967,0,0,28,0,-28
15968,0,0,32,0,-32
15969,1,1,1303,1522,219
15970,1,0,39,0,-39
15971,0,0,102,0,-102
15972,0,0,2,0,-2
15973,1,0,108,0,-108
15974,0,0,25,0,-25
15975,0,0,87,0,-87
15976,0,0,3,0,-3
15977,0,0,32,0,-32
15978,1,1,152,1347,1195
15979,0,0,58,0,-58
15980,1,1,628,1904,1276
15981,1,0,48,0,-48
15982,1,1,52,1257,1205
15983,1,0,35,0,-35
15984,1,1,939,1796,857
15985,1,1,845,1351,506
15986,0,0,54,0,-54
15987,1,1,725,1298,573
15988,0,0,9,0,-9
15989,1,0,0,0,0
15990,1,1,165,1579,1414
15991,0,0,8,0,-8
15992,1,1,48,1703,1655
15993,1,0,143,0,-143
15994,0,0,50,0,-50
15995,1,1,237,1477,1240
15996,0,0,39,0,-39
15997,0,0,15,0,-15
15998,0,0,14,0,-14
15999,1,1,47,1626,1579
16000,1,0,58,0,-58
16001,0,0,18,0,-18
16002,0,0,16,0,-16
16003,0,0,71,0,-71
16004,0,0,17,0,-17
16005,0,0,186,0,-186
16006,1,0,36,0,-36
16007,1,0,12,0,-12
16008,0,0,116,0,-116
16009,1,1,167,1355,1188
16010,0,0,106,0,-106
16011,1,0,13,0,-13
16012,1,1,118,1272,1154
16013,1,1,384,1557,1173
16014,1,0,0,0,0
16015,1,1,309,1393,1084
16016,1,0,35,0,-35
16017,0,0,154,0,-154
16018,0,0,4,0,-4
16019,1,1,521,2791,2270
16020,0,0,26,0,-26
16021,1,0,23,0,-23
16022,1,0,80,0,-80
16023,1,1,403,1402,999
16024,0,0,51,0,-51
16025,1,1,403,1573,1170
16026,0,0,4,0,-4
16027,1,0,220,0,-220
16028,1,0,198,0,-198
16029,0,0,176,0,-176
16030,0,0,15,0,-15
16031,0,0,18,0,-18
16032,1,1,41,1208,1167
16033,1,1,336,1976,1640
16034,1,1,2174,1297,-877
16035,0,0,129,0,-129
16036,0,0,47,0,-47
16037,1,1,675,1269,594
16038,1,0,11,0,-11
16039,1,1,1129,1661,532
16040,0,0,67,0,-67
16041,1,0,68,0,-68
16042,0,0,45,0,-45
16043,1,0,27,0,-27
16044,1,1,1849,1732,-117
16045,1,0,30,0,-30
16046,1,0,18,0,-18
16047,0,0,5,0,-5
16048,1,0,56,0,-56
16049,0,0,64,0,-64
16050,1,0,42,0,-42
16051,1,0,51,0,-51
16052,1,0,29,0,-29
16053,0,0,7,0,-7
16054,1,1,121,1218,1097
16055,1,1,632,1379,747
16056,1,0,28,0,-28
16057,1,1,189,1434,1245
16058,1,0,42,0,-42
16059,0,0,111,0,-111
16060,1,1,1970,4054,2084
16061,1,1,771,1246,475
16062,0,0,85,0,-85
16063,1,1,387,1403,1016
16064,1,0,112,0,-112
16065,1,1,482,1489,1007
16066,1,0,94,0,-94
16067,1,0,11,0,-11
16068,1,0,20,0,-20
16069,0,0,3,0,-3
16070,1,1,503,1508,1005
16071,1,1,354,1246,892
16072,1,0,15,0,-15
16073,1,0,3,0,-3
16074,1,1,1258,2298,1040
16075,1,1,244,1222,978
16076,1,1,812,1764,952
16077,0,0,2,0,-2
16078,0,0,3,0,-3
16079,1,0,105,0,-105
16080,0,0,64,0,-64
16081,0,0,58,0,-58
16082,0,0,4,0,-4
16083,1,1,232,1744,1512
16084,1,1,75,1201,1126
16085,1,0,0,0,0
16086,1,0,3,0,-3
16087,0,0,18,0,-18
16088,1,1,698,1443,745
16089,1,0,89,0,-89
16090,1,1,917,1784,867
16091,1,0,60,0,-60
16092,1,1,78,1530,1452
16093,0,0,62,0,-62
16094,0,0,17,0,-17
16095,1,1,1705,1624,-81
16096,0,0,9,0,-9
16097,1,0,60,0,-60
16098,1,0,69,0,-69
16099,1,1,858,1344,486
16100,0,0,71,0,-71
16101,0,0,24,0,-24
16102,1,1,21,1337,1316
16103,1,1,106,1902,1796
16104,0,0,106,0,-106
16105,1,0,6,0,-6
16106,1,0,30,0,-30
16107,1,0,17,0,-17
16108,1,0,34,0,-34
16109,1,0,1,0,-1
16110,1,1,256,1430,1174
16111,0,0,11,0,-11
16112,1,1,242,1232,990
16113,1,1,190,1287,1097
16114,1,0,43,0,-43
16115,0,0,16,0,-16
16116,1,0,79,0,-79
16117,0,0,236,0,-236
16118,1,0,59,0,-59
16119,1,1,309,1260,951
16120,0,0,36,0,-36
16121,0,0,3,0,-3
16122,1,0,119,0,-119
16123,1,1,649,1334,685
16124,1,0,29,0,-29
16125,0,0,58,0,-58
16126,1,1,394,1877,1483
16127,0,0,0,0,0
16128,1,0,35,0,-35
16129,0,0,67,0,-67
16130,1,0,0,0,0
16131,0,0,4,0,-4
16132,1,1,366,1377,1011
16133,1,0,6,0,-6
16134,1,1,579,1491,912
16135,0,0,13,0,-13
16136,1,1,347,1352,1005
16137,0,0,34,0,-34
16138,1,0,38,0,-38
16139,1,1,124,2470,2346
16140,1,1,1010,1368,358
16141,1,1,518,1894,1376
16142,1,0,60,0,-60
16143,1,0,59,0,-59
16144,1,0,8,0,-8
16145,0,0,29,0,-29
16146,1,0,22,0,-22
16147,0,0,25,0,-25
16148,0,0,104,0,-104
16149,1,0,53,0,-53
16150,1,1,869,1568,699
16151,1,1,775,1283,508
16152,1,1,601,1419,818
16153,0,0,20,0,-20
16154,0,0,13,0,-13
16155,1,0,25,0,-25
16156,0,0,13,0,-13
16157,1,1,653,1262,609
16158,0,0,8,0,-8
16159,0,0,22,0,-22
16160,1,0,15,0,-15
16161,0,0,43,0,-43
16162,0,0,94,0,-94
16163,1,1,433,2109,1676
16164,1,1,389,2124,1735
16165,1,1,89,2166,2077
16166,1,1,2089,1348,-741
16167,1,0,41,0,-41
16168,1,0,53,0,-53
16169,0,0,0,0,0
16170,1,1,613,1225,612
16171,0,0,4,0,-4
16172,1,1,1109,2098,989
16173,0,0,59,0,-59
16174,1,0,17,0,-17
16175,0,0,105,0,-105
16176,1,0,16,0,-16
16177,0,0,64,0,-64
16178,0,0,62,0,-62
16179,1,1,724,1767,1043
16180,0,0,16,0,-16
16181,1,1,1185,1486,301
16182,1,0,6,0,-6
16183,1,0,140,0,-140
16184,0,0,1,0,-1
16185,1,0,91,0,-91
16186,1,0,25,0,-25
16187,0,0,19,0,-19
16188,0,0,253,0,-253
16189,1,1,1975,1515,-460
16190,1,1,85,1815,1730
16191,1,1,1008,1404,396
16192,1,1,703,1302,599
16193,1,0,40,0,-40
16194,1,0,13,0,-13
16195,1,0,21,0,-21
16196,0,0,48,0,-48
16197,1,0,20,0,-20
16198,1,1,198,1387,1189
16199,1,1,390,6968,6578
16200,1,1,673,1231,558
16201,1,1,1293,1269,-24
16202,1,0,28,0,-28
16203,1,1,42,1364,1322
16204,1,1,156,2112,1956
16205,1,0,16,0,-16
16206,0,0,5,0,-5
16207,0,0,56,0,-56
16208,1,0,48,0,-48
16209,1,0,20,0,-20
16210,1,0,35,0,-35
16211,1,0,132,0,-132
16212,1,1,56,1295,1239
16213,1,0,1,0,-1
16214,0,0,51,0,-51
16215,1,0,105,0,-105
16216,1,0,8,0,-8
16217,1,0,13,0,-13
16218,0,0,16,0,-16
16219,1,1,525,1792,1267
16220,0,0,125,0,-125
16221,1,0,7,0,-7
16222,0,0,63,0,-63
16223,1,0,19,0,-19
16224,1,0,31,0,-31
16225,1,1,266,1281,1015
16226,1,0,3,0,-3
16227,0,0,43,0,-43
16228,1,0,183,0,-183
16229,1,0,2,0,-2
16230,0,0,72,0,-72
16231,0,0,15,0,-15
16232,1,0,82,0,-82
16233,0,0,123,0,-123
16234,1,1,686,1476,790
16235,0,0,29,0,-29
16236,1,1,2548,1474,-1074
16237,1,0,21,0,-21
16238,1,0,86,0,-86
16239,1,1,205,3671,3466
16240,1,0,186,0,-186
16241,0,0,19,0,-19
16242,1,0,71,0,-71
16243,1,0,119,0,-119
16244,1,1,1330,1361,31
16245,1,0,28,0,-28
16246,0,0,50,0,-50
16247,1,0,4,0,-4
16248,0,0,31,0,-31
16249,1,0,137,0,-137
16250,1,1,119,1251,1132
16251,1,1,619,1261,642
16252,1,1,765,1376,611
16253,0,0,2,0,-2
16254,1,0,140,0,-140
16255,1,1,613,1316,703
16256,1,1,387,1721,1334
16257,0,0,14,0,-14
16258,0,0,77,0,-77
16259,1,0,120,0,-120
16260,1,0,161,0,-161
16261,0,0,10,0,-10
16262,0,0,9,0,-9
16263,0,0,37,0,-37
16264,1,0,14,0,-14
16265,0,0,7,0,-7
16266,0,0,54,0,-54
16267,0,0,89,0,-89
16268,0,0,28,0,-28
16269,0,0,1,0,-1
16270,0,0,14,0,-14
16271,1,1,604,1494,890
16272,1,1,300,1497,1197
16273,0,0,6,0,-6
16274,1,1,184,2124,1940
16275,1,1,119,1568,1449
16276,0,0,72,0,-72
16277,1,0,68,0,-68
16278,1,1,109,1206,1097
16279,1,0,10,0,-10
16280,1,0,21,0,-21
16281,1,0,24,0,-24
16282,1,0,9,0,-9
16283,0,0,12,0,-12
16284,0,0,9,0,-9
16285,0,0,31,0,-31
16286,1,1,971,2685,1714
16287,0,0,28,0,-28
16288,0,0,49,0,-49
16289,1,0,123,0,-123
16290,1,0,15,0,-15
16291,1,0,162,0,-162
16292,1,0,39,0,-39
16293,1,0,14,0,-14
16294,0,0,150,0,-150
16295,1,1,235,1417,1182
16296,1,1,1217,1316,99
16297,0,0,52,0,-52
16298,0,0,11,0,-11
16299,1,1,171,1341,1170
16300,0,0,14,0,-14
16301,0,0,27,0,-27
16302,1,0,273,0,-273
16303,1,1,500,1250,750
16304,1,0,39,0,-39
16305,1,1,1025,1748,723
16306,1,1,2192,1974,-218
16307,1,1,247,1258,1011
16308,1,1,858,1402,544
16309,1,0,23,0,-23
16310,0,0,3,0,-3
16311,1,0,65,0,-65
16312,0,0,22,0,-22
16313,0,0,30,0,-30
16314,1,1,85,1205,1120
16315,0,0,51,0,-51
16316,1,1,1431,1983,552
16317,0,0,1,0,-1
16318,1,0,182,0,-182
16319,1,0,3,0,-3
16320,0,0,12,0,-12
16321,1,1,671,1318,647
16322,1,0,17,0,-17
16323,1,0,13,0,-13
16324,1,0,49,0,-49
16325,0,0,110,0,-110
16326,1,0,36,0,-36
16327,1,1,761,1248,487
16328,1,0,52,0,-52
16329,1,0,158,0,-158
16330,1,1,717,1301,584
16331,0,0,35,0,-35
16332,1,0,20,0,-20
16333,0,0,88,0,-88
16334,1,1,1238,1299,61
16335,1,1,216,1303,1087
16336,1,1,536,1214,678
16337,1,0,88,0,-88
16338,1,0,35,0,-35
16339,0,0,27,0,-27
16340,1,1,353,1584,1231
16341,0,0,0,0,0
16342,1,1,59,1277,1218
16343,0,0,116,0,-116
16344,0,0,113,0,-113
16345,1,0,10,0,-10
16346,0,0,59,0,-59
16347,1,0,5,0,-5
16348,0,0,67,0,-67
16349,1,0,17,0,-17
16350,1,0,118,0,-118
16351,0,0,23,0,-23
16352,0,0,8,0,-8
16353,1,1,154,1426,1272
16354,1,1,45,1282,1237
16355,1,1,407,1368,961
16356,1,0,47,0,-47
16357,1,1,52,1737,1685
16358,0,0,194,0,-194
16359,1,1,564,1232,668
16360,1,0,36,0,-36
16361,1,0,68,0,-68
16362,0,0,50,0,-50
16363,0,0,16,0,-16
16364,0,0,20,0,-20
16365,1,0,31,0,-31
16366,0,0,28,0,-28
16367,1,1,774,1294,520
16368,1,0,16,0,-16
16369,1,1,143,1946,1803
16370,1,1,768,1746,978
16371,1,1,250,1222,972
16372,0,0,23,0,-23
16373,1,0,22,0,-22
16374,1,1,48,2743,2695
16375,1,1,829,1310,481
16376,0,0,69,0,-69
16377,0,0,21,0,-21
16378,0,0,40,0,-40
16379,1,0,31,0,-31
16380,1,1,175,1773,1598
16381,1,0,9,0,-9
16382,1,0,6,0,-6
16383,0,0,45,0,-45
16384,0,0,44,0,-44
16385,1,0,48,0,-48
16386,0,0,21,0,-21
16387,0,0,5,0,-5
16388,1,0,4,0,-4
16389,0,0,12,0,-12
16390,0,0,37,0,-37
16391,1,1,341,1549,1208
16392,0,0,157,0,-157
16393,1,0,16,0,-16
16394,1,0,42,0,-42
16395,0,0,10,0,-10
16396,1,1,617,1648,1031
16397,0,0,19,0,-19
16398,1,1,219,1220,1001
16399,0,0,157,0,-157
16400,1,1,1479,1309,-170
16401,1,1,884,1216,332
16402,0,0,0,0,0
16403,1,0,0,0,0
16404,0,0,0,0,0
16405,1,1,127,1494,1367
16406,1,0,151,0,-151
16407,0,0,43,0,-43
16408,0,0,118,0,-118
16409,1,1,891,1233,342
16410,1,1,58,1347,1289
16411,1,0,4,0,-4
16412,1,1,206,1314,1108
16413,1,0,261,0,-261
16414,0,0,8,0,-8
16415,1,0,84,0,-84
16416,1,0,36,0,-36
16417,1,0,25,0,-25
16418,0,0,42,0,-42
16419,1,0,161,0,-161
16420,1,1,69,1742,1673
16421,1,0,66,0,-66
16422,1,0,16,0,-16
16423,0,0,12,0,-12
16424,1,1,912,1212,300
16425,1,1,897,2034,1137
16426,0,0,21,0,-21
16427,0,0,12,0,-12
16428,0,0,8,0,-8
16429,1,1,272,1534,1262
16430,0,0,39,0,-39
16431,0,0,123,0,-123
16432,0,0,25,0,-25
16433,0,0,40,0,-40
16434,0,0,29,0,-29
16435,0,0,15,0,-15
16436,1,0,12,0,-12
16437,0,0,0,0,0
16438,1,1,765,1676,911
16439,0,0,7,0,-7
16440,1,1,1456,2701,1245
16441,1,0,211,0,-211
16442,0,0,12,0,-12
16443,1,0,75,0,-75
16444,1,0,17,0,-17
16445,1,0,2,0,-2
16446,1,0,13,0,-13
16447,1,1,763,3420,2657
16448,1,1,420,1358,938
16449,1,0,14,0,-14
16450,1,0,0,0,0
16451,1,1,212,1593,1381
16452,1,1,171,1881,1710
16453,1,1,105,1567,1462
16454,1,0,84,0,-84
16455,1,0,52,0,-52
16456,1,0,228,0,-228
16457,0,0,28,0,-28
16458,1,0,23,0,-23
16459,1,1,305,1229,924
16460,1,1,94,1940,1846
16461,1,1,165,1272,1107
16462,0,0,21,0,-21
16463,0,0,9,0,-9
16464,1,1,107,1440,1333
16465,0,0,5,0,-5
16466,0,0,44,0,-44
16467,0,0,24,0,-24
16468,1,1,994,2516,1522
16469,0,0,13,0,-13
16470,1,1,72,1376,1304
16471,1,0,87,0,-87
16472,1,1,431,1250,819
16473,1,0,40,0,-40
16474,0,0,36,0,-36
16475,1,0,4,0,-4
16476,0,0,5,0,-5
16477,0,0,24,0,-24
16478,1,0,18,0,-18
16479,1,1,276,1399,1123
16480,1,1,123,1683,1560
16481,0,0,9,0,-9
16482,1,1,1838,1212,-626
16483,0,0,10,0,-10
16484,1,0,22,0,-22
16485,1,1,342,1309,967
16486,1,1,766,1757,991
16487,0,0,17,0,-17
16488,0,0,160,0,-160
16489,1,0,12,0,-12
16490,1,1,277,2039,1762
16491,1,0,33,0,-33
16492,1,1,285,1751,1466
16493,1,0,15,0,-15
16494,0,0,0,0,0
16495,1,0,35,0,-35
16496,0,0,23,0,-23
16497,1,1,499,1247,748
16498,1,1,178,2117,1939
16499,1,1,1094,1200,106
16500,1,1,323,1341,1018
16501,0,0,67,0,-67
16502,0,0,72,0,-72
16503,1,1,153,1237,1084
16504,1,0,1,0,-1
16505,0,0,1,0,-1
16506,1,1,584,1219,635
16507,0,0,68,0,-68
16508,0,0,16,0,-16
16509,1,1,547,1578,1031
16510,0,0,273,0,-273
16511,1,0,2,0,-2
16512,1,0,47,0,-47
16513,1,0,27,0,-27
16514,0,0,71,0,-71
16515,0,0,185,0,-185
16516,0,0,171,0,-171
16517,0,0,27,0,-27
16518,1,0,47,0,-47
16519,0,0,25,0,-25
16520,1,1,812,1229,417
16521,1,1,341,1230,889
16522,1,1,729,1288,559
16523,0,0,6,0,-6
16524,1,1,121,1267,1146
16525,1,0,102,0,-102
16526,1,1,1612,1310,-302
16527,1,0,41,0,-41
16528,0,0,71,0,-71
16529,1,0,79,0,-79
16530,0,0,57,0,-57
16531,0,0,14,0,-14
16532,0,0,33,0,-33
16533,1,0,31,0,-31
16534,1,1,127,1371,1244
16535,1,1,305,1450,1145
16536,0,0,42,0,-42
16537,1,0,93,0,-93
16538,1,1,264,1450,1186
16539,1,1,816,1455,639
16540,0,0,8,0,-8
16541,1,1,274,1270,996
16542,0,0,23,0,-23
16543,1,1,815,1420,605
16544,1,0,20,0,-20
16545,1,1,2835,1287,-1548
16546,0,0,3,0,-3
16547,1,0,10,0,-10
16548,0,0,6,0,-6
16549,1,1,279,1329,1050
16550,1,1,1103,1408,305
16551,0,0,37,0,-37
16552,1,0,17,0,-17
16553,1,1,72,2072,2000
16554,0,0,63,0,-63
16555,1,0,17,0,-17
16556,1,0,9,0,-9
16557,1,1,44,1498,1454
16558,0,0,82,0,-82
16559,1,0,3,0,-3
16560,1,0,12,0,-12
16561,1,0,8,0,-8
16562,0,0,25,0,-25
16563,1,0,20,0,-20
16564,1,0,7,0,-7
16565,1,1,386,1305,919
16566,0,0,66,0,-66
16567,0,0,20,0,-20
16568,1,0,224,0,-224
16569,1,0,13,0,-13
16570,0,0,47,0,-47
16571,1,1,246,1299,1053
16572,1,1,379,1930,1551
16573,1,0,69,0,-69
16574,0,0,65,0,-65
16575,0,0,40,0,-40
16576,0,0,16,0,-16
16577,0,0,77,0,-77
16578,1,1,1830,1460,-370
16579,0,0,2,0,-2
16580,1,0,24,0,-24
16581,1,0,23,0,-23
16582,0,0,85,0,-85
16583,1,1,341,1409,1068
16584,0,0,16,0,-16
16585,0,0,32,0,-32
16586,1,1,204,1362,1158
16587,1,1,579,1235,656
16588,1,1,315,1516,1201
16589,0,0,29,0,-29
16590,1,1,932,2174,1242
16591,0,0,157,0,-157
16592,1,0,50,0,-50
16593,1,1,401,1385,984
16594,1,0,7,0,-7
16595,0,0,12,0,-12
16596,1,0,8,0,-8
16597,0,0,17,0,-17
16598,1,1,458,3329,2871
16599,0,0,52,0,-52
16600,1,1,588,1252,664
16601,1,0,7,0,-7
16602,0,0,23,0,-23
16603,1,0,2,0,-2
16604,0,0,40,0,-40
16605,0,0,20,0,-20
16606,1,0,48,0,-48
16607,0,0,21,0,-21
16608,0,0,72,0,-72
16609,1,1,83,1385,1302
16610,1,1,562,1395,833
16611,0,0,12,0,-12
16612,1,0,66,0,-66
16613,1,1,1454,1236,-218
16614,0,0,26,0,-26
16615,0,0,197,0,-197
16616,0,0,122,0,-122
16617,1,0,25,0,-25
16618,0,0,34,0,-34
16619,1,1,2136,1516,-620
16620,0,0,8,0,-8
16621,1,0,14,0,-14
16622,1,1,57,1747,1690
16623,1,0,23,0,-23
16624,1,0,38,0,-38
16625,0,0,40,0,-40
16626,1,0,33,0,-33
16627,0,0,87,0,-87
16628,0,0,46,0,-46
16629,1,0,26,0,-26
16630,1,1,943,1263,320
16631,1,1,1151,1353,202
16632,0,0,27,0,-27
16633,1,1,218,1722,1504
16634,1,0,66,0,-66
16635,1,1,877,1209,332
16636,1,0,7,0,-7
16637,1,1,134,1506,1372
16638,1,1,496,1506,1010
16639,0,0,104,0,-104
16640,0,0,77,0,-77
16641,1,0,44,0,-44
16642,0,0,46,0,-46
16643,1,1,350,2338,1988
16644,1,0,90,0,-90
16645,1,0,102,0,-102
16646,0,0,69,0,-69
16647,1,0,90,0,-90
16648,0,0,62,0,-62
16649,1,0,65,0,-65
16650,1,0,12,0,-12
16651,1,0,112,0,-112
16652,0,0,34,0,-34
16653,1,0,28,0,-28
16654,0,0,6,0,-6
16655,1,1,465,1234,769
16656,1,0,35,0,-35
16657,1,0,14,0,-14
16658,1,0,12,0,-12
16659,1,0,90,0,-90
16660,1,0,61,0,-61
16661,1,0,45,0,-45
16662,0,0,22,0,-22
16663,0,0,8,0,-8
16664,0,0,1,0,-1
16665,1,0,75,0,-75
16666,1,1,256,1302,1046
16667,1,1,374,1506,1132
16668,0,0,17,0,-17
16669,1,1,868,1209,341
16670,0,0,81,0,-81
16671,1,0,68,0,-68
16672,0,0,22,0,-22
16673,0,0,21,0,-21
16674,1,1,233,1414,1181
16675,1,0,37,0,-37
16676,0,0,2,0,-2
16677,1,1,59,1370,1311
16678,0,0,6,0,-6
16679,1,0,5,0,-5
16680,0,0,22,0,-22
16681,1,0,21,0,-21
16682,0,0,14,0,-14
16683,0,0,49,0,-49
16684,1,1,782,1398,616
16685,0,0,49,0,-49
16686,1,1,194,1309,1115
16687,0,0,5,0,-5
16688,1,1,185,1331,1146
16689,0,0,75,0,-75
16690,0,0,57,0,-57
16691,1,0,14,0,-14
16692,1,0,8,0,-8
16693,0,0,95,0,-95
16694,1,0,136,0,-136
16695,0,0,19,0,-19
16696,1,1,111,1270,1159
16697,0,0,46,0,-46
16698,1,1,172,2083,1911
16699,0,0,58,0,-58
16700,1,0,62,0,-62
16701,1,0,21,0,-21
16702,0,0,15,0,-15
16703,1,1,794,1845,1051
16704,1,0,72,0,-72
16705,1,1,833,1291,458
16706,0,0,7,0,-7
16707,0,0,194,0,-194
16708,1,0,73,0,-73
16709,0,0,124,0,-124
16710,1,1,546,1560,1014
16711,1,1,1292,1268,-24
16712,1,1,146,1432,1286
16713,1,1,3359,1266,-2093
16714,0,0,134,0,-134
16715,0,0,273,0,-273
16716,1,0,84,0,-84
16717,1,1,713,1790,1077
16718,1,1,360,1556,1196
16719,0,0,116,0,-116
16720,1,1,488,1262,774
16721,1,1,109,2061,1952
16722,1,0,5,0,-5
16723,1,1,281,1359,1078
16724,0,0,130,0,-130
16725,0,0,26,0,-26
16726,1,1,1460,1384,-76
16727,1,0,21,0,-21
16728,0,0,126,0,-126
16729,0,0,6,0,-6
16730,1,0,66,0,-66
16731,1,1,415,1384,969
16732,1,1,187,1217,1030
16733,1,0,41,0,-41
16734,1,0,21,0,-21
16735,0,0,3,0,-3
16736,1,1,467,1812,1345
16737,1,0,44,0,-44
16738,0,0,0,0,0
16739,0,0,10,0,-10
16740,1,0,16,0,-16
16741,0,0,5,0,-5
16742,1,0,1,0,-1
16743,0,0,14,0,-14
16744,0,0,204,0,-204
16745,0,0,8,0,-8
16746,0,0,132,0,-132
16747,0,0,93,0,-93
16748,1,1,324,2310,1986
16749,0,0,114,0,-114
16750,1,0,77,0,-77
16751,0,0,26,0,-26
16752,1,1,601,1309,708
16753,1,0,16,0,-16
16754,0,0,1,0,-1
16755,0,0,9,0,-9
16756,1,1,981,1463,482
16757,0,0,165,0,-165
16758,1,0,16,0,-16
16759,1,0,3,0,-3
16760,1,0,14,0,-14
16761,1,1,80,1381,1301
16762,0,0,64,0,-64
16763,1,1,868,1636,768
16764,1,0,72,0,-72
16765,0,0,17,0,-17
16766,0,0,61,0,-61
16767,0,0,89,0,-89
16768,0,0,52,0,-52
16769,0,0,2,0,-2
16770,1,1,213,1509,1296
16771,0,0,16,0,-16
16772,0,0,117,0,-117
16773,0,0,13,0,-13
16774,1,1,67,1291,1224
16775,1,0,29,0,-29
16776,0,0,8,0,-8
16777,1,1,753,1234,481
16778,0,0,151,0,-151
16779,1,1,1020,1500,480
16780,0,0,137,0,-137
16781,1,0,36,0,-36
16782,1,1,442,1700,1258
16783,0,0,79,0,-79
16784,1,0,77,0,-77
16785,0,0,23,0,-23
16786,0,0,13,0,-13
16787,0,0,36,0,-36
16788,0,0,14,0,-14
16789,0,0,51,0,-51
16790,1,1,136,1297,1161
16791,0,0,15,0,-15
16792,0,0,212,0,-212
16793,0,0,84,0,-84
16794,1,0,26,0,-26
16795,1,0,49,0,-49
16796,0,0,126,0,-126
16797,0,0,51,0,-51
16798,1,0,5,0,-5
16799,1,0,15,0,-15
16800,0,0,3,0,-3
16801,1,0,32,0,-32
16802,1,0,27,0,-27
16803,0,0,5,0,-5
16804,0,0,62,0,-62
16805,0,0,72,0,-72
16806,1,1,1106,1714,608
16807,1,1,233,1978,1745
16808,1,1,557,1251,694
16809,0,0,29,0,-29
16810,1,0,85,0,-85
16811,1,0,17,0,-17
16812,1,0,4,0,-4
16813,0,0,77,0,-77
16814,0,0,1,0,-1
16815,1,1,583,1734,1151
16816,0,0,95,0,-95
16817,0,0,46,0,-46
16818,1,0,24,0,-24
16819,0,0,154,0,-154
16820,0,0,129,0,-129
16821,1,0,13,0,-13
16822,0,0,32,0,-32
16823,1,0,20,0,-20
16824,1,0,59,0,-59
16825,1,1,451,1231,780
16826,0,0,90,0,-90
16827,1,1,527,2743,2216
16828,0,0,14,0,-14
16829,0,0,0,0,0
16830,1,0,1,0,-1
16831,0,0,85,0,-85
16832,0,0,12,0,-12
16833,1,0,96,0,-96
16834,1,1,917,1300,383
16835,1,1,196,1322,1126
16836,0,0,26,0,-26
16837,1,1,1975,1302,-673
16838,0,0,1,0,-1
16839,1,0,6,0,-6
16840,0,0,18,0,-18
16841,0,0,26,0,-26
16842,1,0,60,0,-60
16843,0,0,38,0,-38
16844,1,0,10,0,-10
16845,1,0,16,0,-16
16846,0,0,43,0,-43
16847,1,1,918,1726,808
16848,1,1,642,1442,800
16849,0,0,59,0,-59
16850,0,0,13,0,-13
16851,0,0,45,0,-45
16852,0,0,9,0,-9
16853,1,1,342,1281,939
16854,1,0,80,0,-80
16855,1,1,34,2374,2340
16856,1,0,70,0,-70
16857,0,0,12,0,-12
16858,1,0,7,0,-7
16859,1,1,254,1263,1009
16860,1,0,7,0,-7
16861,1,0,158,0,-158
16862,0,0,66,0,-66
16863,1,0,13,0,-13
16864,0,0,9,0,-9
16865,0,0,8,0,-8
16866,0,0,38,0,-38
16867,1,0,90,0,-90
16868,0,0,9,0,-9
16869,1,0,7,0,-7
16870,0,0,46,0,-46
16871,0,0,2,0,-2
16872,1,1,424,1380,956
16873,1,1,464,1475,1011
16874,1,0,106,0,-106
16875,0,0,24,0,-24
16876,1,0,18,0,-18
16877,1,0,2,0,-2
16878,0,0,139,0,-139
16879,1,0,20,0,-20
16880,1,1,76,1275,1199
16881,0,0,26,0,-26
16882,0,0,22,0,-22
16883,0,0,65,0,-65
16884,1,1,707,1206,499
16885,1,1,370,1223,853
16886,1,1,614,1363,749
16887,1,0,15,0,-15
16888,0,0,34,0,-34
16889,0,0,41,0,-41
16890,1,1,217,1323,1106
16891,0,0,30,0,-30
16892,0,0,77,0,-77
16893,1,1,648,3165,2517
16894,0,0,130,0,-130
16895,0,0,15,0,-15
16896,1,0,81,0,-81
16897,1,0,15,0,-15
16898,1,0,48,0,-48
16899,1,1,155,1701,1546
16900,1,0,20,0,-20
16901,0,0,296,0,-296
16902,1,1,577,1421,844
16903,1,1,172,1302,1130
16904,1,1,257,1271,1014
16905,0,0,98,0,-98
16906,1,0,45,0,-45
16907,0,0,15,0,-15
16908,0,0,102,0,-102
16909,1,0,18,0,-18
16910,0,0,105,0,-105
16911,1,0,3,0,-3
16912,1,1,808,1444,636
16913,1,0,19,0,-19
16914,1,1,374,1340,966
16915,0,0,107,0,-107
16916,1,0,31,0,-31
16917,0,0,10,0,-10
16918,1,1,444,1826,1382
16919,1,1,49,1445,1396
16920,1,0,26,0,-26
16921,1,0,84,0,-84
16922,0,0,62,0,-62
16923,0,0,15,0,-15
16924,0,0,2,0,-2
16925,0,0,15,0,-15
16926,1,1,506,1301,795
16927,0,0,36,0,-36
16928,0,0,1,0,-1
16929,1,0,35,0,-35
16930,1,1,283,1860,1577
16931,1,1,389,1371,982
16932,0,0,13,0,-13
16933,0,0,1,0,-1
16934,1,1,1006,1592,586
16935,1,0,60,0,-60
16936,0,0,100,0,-100
16937,1,1,462,1556,1094
16938,1,1,806,1343,537
16939,0,0,9,0,-9
16940,0,0,8,0,-8
16941,0,0,10,0,-10
16942,1,1,519,3159,2640
16943,0,0,23,0,-23
16944,0,0,39,0,-39
16945,1,1,506,1227,721
16946,0,0,19,0,-19
16947,0,0,28,0,-28
16948,1,1,379,1379,1000
16949,1,1,196,1596,1400
16950,1,1,1070,1534,464
16951,0,0,84,0,-84
16952,0,0,93,0,-93
16953,1,1,179,2185,2006
16954,1,0,41,0,-41
16955,0,0,121,0,-121
16956,0,0,79,0,-79
16957,1,1,256,1265,1009
16958,1,0,18,0,-18
16959,1,1,428,1700,1272
16960,0,0,98,0,-98
16961,0,0,85,0,-85
16962,0,0,116,0,-116
16963,1,0,4,0,-4
16964,1,0,44,0,-44
16965,1,1,190,1300,1110
16966,1,1,396,1333,937
16967,1,0,9,0,-9
16968,0,0,242,0,-242
16969,0,0,20,0,-20
16970,1,0,73,0,-73
16971,1,1,339,2165,1826
16972,0,0,56,0,-56
16973,1,1,400,2041,1641
16974,0,0,34,0,-34
16975,0,0,64,0,-64
16976,0,0,42,0,-42
16977,0,0,10,0,-10
16978,1,1,304,1257,953
16979,1,1,350,2537,2187
16980,1,1,550,1215,665
16981,1,1,123,1275,1152
16982,0,0,132,0,-132
16983,0,0,22,0,-22
16984,0,0,59,0,-59
16985,0,0,52,0,-52
16986,1,1,1224,1227,3
16987,1,1,268,2688,2420
16988,0,0,5,0,-5
16989,1,1,734,1404,670
16990,0,0,68,0,-68
16991,0,0,14,0,-14
16992,0,0,25,0,-25
16993,1,1,200,1335,1135
16994,0,0,50,0,-50
16995,0,0,37,0,-37
16996,1,0,35,0,-35
16997,0,0,108,0,-108
16998,1,1,59,1264,1205
16999,1,0,23,0,-23
17000,1,0,39,0,-39
17001,1,1,72,1622,1550
17002,0,0,61,0,-61
17003,1,0,5,0,-5
17004,1,1,120,1224,1104
17005,1,0,7,0,-7
17006,0,0,13,0,-13
17007,1,0,4,0,-4
17008,1,1,459,1289,830
17009,1,1,676,1341,665
17010,0,0,99,0,-99
17011,1,0,27,0,-27
17012,1,1,160,1340,1180
17013,0,0,20,0,-20
17014,1,0,164,0,-164
17015,0,0,10,0,-10
17016,1,1,414,1244,830
17017,0,0,41,0,-41
17018,0,0,43,0,-43
17019,0,0,19,0,-19
17020,0,0,35,0,-35
17021,1,0,50,0,-50
17022,1,0,42,0,-42
17023,1,1,869,1624,755
17024,1,1,80,2404,2324
17025,1,0,55,0,-55
17026,1,1,536,3258,2722
17027,1,1,206,1686,1480
17028,0,0,18,0,-18
17029,0,0,89,0,-89
17030,0,0,6,0,-6
17031,0,0,85,0,-85
17032,1,1,62,1346,1284
17033,1,1,38,1796,1758
17034,1,0,41,0,-41
17035,1,0,45,0,-45
17036,1,0,52,0,-52
17037,1,0,108,0,-108
17038,0,0,38,0,-38
17039,0,0,78,0,-78
17040,1,0,74,0,-74
17041,1,1,125,1205,1080
17042,1,1,159,2241,2082
17043,0,0,7,0,-7
17044,1,0,91,0,-91
17045,1,0,26,0,-26
17046,1,0,100,0,-100
17047,0,0,25,0,-25
17048,1,0,9,0,-9
17049,0,0,5,0,-5
17050,0,0,8,0,-8
17051,1,1,383,1529,1146
17052,1,0,191,0,-191
17053,1,0,19,0,-19
17054,1,1,183,1741,1558
17055,1,1,632,1448,816
17056,0,0,12,0,-12
17057,0,0,77,0,-77
17058,1,1,774,1323,549
17059,0,0,30,0,-30
17060,1,1,688,1349,661
17061,1,1,118,1876,1758
17062,1,1,279,1452,1173
17063,1,1,20,1206,1186
17064,1,0,2,0,-2
17065,1,1,2972,1424,-1548
17066,0,0,85,0,-85
17067,1,0,63,0,-63
17068,0,0,36,0,-36
17069,1,1,1545,1534,-11
17070,0,0,15,0,-15
17071,1,0,22,0,-22
17072,1,0,7,0,-7
17073,0,0,29,0,-29
17074,0,0,108,0,-108
17075,1,0,36,0,-36
17076,1,0,16,0,-16
17077,1,0,33,0,-33
17078,1,1,823,1204,381
17079,0,0,39,0,-39
17080,1,1,82,1649,1567
17081,0,0,68,0,-68
17082,1,1,268,1410,1142
17083,1,0,14,0,-14
17084,1,0,60,0,-60
17085,1,1,414,1330,916
17086,0,0,18,0,-18
17087,1,0,11,0,-11
17088,0,0,10,0,-10
17089,1,1,2199,1592,-607
17090,1,1,254,1353,1099
17091,1,1,364,1305,941
17092,1,0,84,0,-84
17093,1,0,85,0,-85
17094,0,0,138,0,-138
17095,1,1,405,1360,955
17096,1,0,11,0,-11
17097,1,1,1158,1499,341
17098,1,0,42,0,-42
17099,0,0,56,0,-56
17100,0,0,28,0,-28
17101,0,0,167,0,-167
17102,1,1,620,2360,1740
17103,0,0,5,0,-5
17104,1,1,144,1282,1138
17105,1,0,25,0,-25
17106,0,0,87,0,-87
17107,0,0,81,0,-81
17108,0,0,59,0,-59
17109,1,1,136,1310,1174
17110,1,0,18,0,-18
17111,0,0,2,0,-2
17112,1,1,1612,1315,-297
17113,1,0,64,0,-64
17114,1,1,2620,1581,-1039
17115,0,0,26,0,-26
17116,0,0,144,0,-144
17117,0,0,13,0,-13
17118,0,0,22,0,-22
17119,0,0,9,0,-9
17120,0,0,14,0,-14
17121,1,0,36,0,-36
17122,1,1,227,1821,1594
17123,0,0,85,0,-85
17124,0,0,75,0,-75
17125,1,1,323,1350,1027
17126,1,0,8,0,-8
17127,0,0,0,0,0
17128,1,0,24,0,-24
17129,1,1,814,1262,448
17130,1,1,999,1475,476
17131,1,1,143,1335,1192
17132,1,1,402,1202,800
17133,0,0,15,0,-15
17134,0,0,78,0,-78
17135,1,1,281,1860,1579
17136,1,0,79,0,-79
17137,0,0,1,0,-1
17138,0,0,25,0,-25
17139,1,0,10,0,-10
17140,0,0,54,0,-54
17141,0,0,94,0,-94
17142,1,0,7,0,-7
17143,1,0,7,0,-7
17144,0,0,4,0,-4
17145,0,0,54,0,-54
17146,1,0,115,0,-115
17147,1,1,122,1241,1119
17148,1,0,38,0,-38
17149,1,1,238,1627,1389
17150,1,0,134,0,-134
17151,0,0,28,0,-28
17152,0,0,58,0,-58
17153,1,1,119,1641,1522
17154,1,0,57,0,-57
17155,1,1,383,1693,1310
17156,1,1,70,1890,1820
17157,1,1,282,2868,2586
17158,1,0,11,0,-11
17159,1,1,264,1670,1406
17160,1,1,306,1324,1018
17161,1,0,41,0,-41
17162,1,1,293,1329,1036
17163,0,0,30,0,-30
17164,1,1,1074,1350,276
17165,0,0,16,0,-16
17166,1,0,1,0,-1
17167,1,1,74,1464,1390
17168,0,0,39,0,-39
17169,0,0,75,0,-75
17170,1,1,618,1233,615
17171,0,0,112,0,-112
17172,0,0,133,0,-133
17173,1,1,552,1214,662
17174,1,1,249,5315,5066
17175,0,0,21,0,-21
17176,0,0,13,0,-13
17177,1,1,914,1714,800
17178,0,0,4,0,-4
17179,1,1,469,1242,773
17180,0,0,27,0,-27
17181,1,1,1408,1779,371
17182,1,0,150,0,-150
17183,1,0,46,0,-46
17184,0,0,106,0,-106
17185,1,0,55,0,-55
17186,1,1,1265,1447,182
17187,0,0,41,0,-41
17188,0,0,20,0,-20
17189,1,0,2,0,-2
17190,0,0,9,0,-9
17191,1,1,216,1568,1352
17192,0,0,26,0,-26
17193,1,0,2,0,-2
17194,1,0,13,0,-13
17195,0,0,20,0,-20
17196,0,0,43,0,-43
17197,0,0,11,0,-11
17198,1,0,29,0,-29
17199,0,0,40,0,-40
17200,0,0,30,0,-30
17201,1,1,157,1318,1161
17202,1,0,56,0,-56
17203,0,0,25,0,-25
17204,0,0,24,0,-24
17205,1,0,39,0,-39
17206,1,0,8,0,-8
17207,0,0,92,0,-92
17208,0,0,26,0,-26
17209,0,0,78,0,-78
17210,1,0,35,0,-35
17211,0,0,11,0,-11
17212,1,0,16,0,-16
17213,1,0,102,0,-102
17214,1,0,41,0,-41
17215,1,0,21,0,-21
17216,1,1,380,1217,837
17217,0,0,9,0,-9
17218,1,1,361,1312,951
17219,1,1,929,1560,631
17220,1,1,93,4724,4631
17221,1,1,406,1419,1013
17222,1,0,1,0,-1
17223,0,0,11,0,-11
17224,1,1,366,1321,955
17225,0,0,3,0,-3
17226,1,1,73,1278,1205
17227,0,0,50,0,-50
17228,1,0,28,0,-28
17229,0,0,36,0,-36
17230,0,0,28,0,-28
17231,1,1,392,2649,2257
17232,1,1,1536,1723,187
17233,0,0,36,0,-36
17234,1,0,71,0,-71
17235,1,0,8,0,-8
17236,1,0,3,0,-3
17237,0,0,32,0,-32
17238,0,0,33,0,-33
17239,1,1,503,1464,961
17240,1,1,544,3321,2777
17241,1,0,15,0,-15
17242,1,0,7,0,-7
17243,1,0,9,0,-9
17244,0,0,51,0,-51
17245,0,0,27,0,-27
17246,0,0,29,0,-29
17247,0,0,55,0,-55
17248,1,1,878,1554,676
17249,1,0,12,0,-12
17250,0,0,10,0,-10
17251,0,0,57,0,-57
17252,1,1,1218,1615,397
17253,1,0,44,0,-44
17254,1,1,1231,1595,364
17255,0,0,84,0,-84
17256,1,1,345,1618,1273
17257,1,1,201,1502,1301
17258,1,1,160,1279,1119
17259,0,0,40,0,-40
17260,1,1,254,2291,2037
17261,1,0,115,0,-115
17262,0,0,141,0,-141
17263,1,0,7,0,-7
17264,0,0,21,0,-21
17265,1,1,1117,1987,870
17266,1,0,58,0,-58
17267,1,1,181,1410,1229
17268,1,0,10,0,-10
17269,0,0,52,0,-52
17270,1,0,4,0,-4
17271,1,0,46,0,-46
17272,1,1,890,1384,494
17273,1,0,6,0,-6
17274,0,0,30,0,-30
17275,0,0,4,0,-4
17276,1,0,266,0,-266
17277,1,1,535,1442,907
17278,0,0,20,0,-20
17279,0,0,2,0,-2
17280,1,1,654,1559,905
17281,1,0,25,0,-25
17282,0,0,48,0,-48
17283,1,1,1410,1458,48
17284,1,1,1246,1523,277
17285,1,1,83,1508,1425
17286,0,0,122,0,-122
17287,1,1,211,1378,1167
17288,1,0,51,0,-51
17289,1,1,18,1841,1823
17290,1,1,246,1308,1062
17291,1,0,73,0,-73
17292,1,1,2379,1293,-1086
17293,0,0,8,0,-8
17294,1,1,29,1440,1411
17295,1,0,36,0,-36
17296,1,1,689,1214,525
17297,0,0,147,0,-147
17298,0,0,68,0,-68
17299,0,0,15,0,-15
17300,0,0,37,0,-37
17301,1,0,5,0,-5
17302,1,1,746,1300,554
17303,0,0,34,0,-34
17304,1,1,591,1694,1103
17305,0,0,82,0,-82
17306,0,0,2,0,-2
17307,0,0,43,0,-43
17308,1,0,3,0,-3
17309,1,0,150,0,-150
17310,1,0,71,0,-71
17311,1,0,237,0,-237
17312,1,0,87,0,-87
17313,0,0,26,0,-26
17314,1,1,586,2055,1469
17315,0,0,71,0,-71
17316,0,0,185,0,-185
17317,0,0,4,0,-4
17318,1,1,372,1845,1473
17319,0,0,18,0,-18
17320,1,0,7,0,-7
17321,1,1,536,1345,809
17322,1,1,295,1798,1503
17323,1,0,28,0,-28
17324,0,0,294,0,-294
17325,0,0,188,0,-188
17326,0,0,16,0,-16
17327,0,0,204,0,-204
17328,0,0,63,0,-63
17329,1,1,644,1607,963
17330,1,0,17,0,-17
17331,0,0,182,0,-182
17332,0,0,28,0,-28
17333,0,0,11,0,-11
17334,0,0,28,0,-28
17335,1,0,178,0,-178
17336,1,1,68,1205,1137
17337,1,0,37,0,-37
17338,1,1,439,2974,2535
17339,0,0,10,0,-10
17340,1,0,73,0,-73
17341,1,0,12,0,-12
17342,0,0,25,0,-25
17343,1,0,149,0,-149
17344,0,0,6,0,-6
17345,1,0,8,0,-8
17346,1,1,306,1203,897
17347,1,1,170,1941,1771
17348,0,0,67,0,-67
17349,0,0,7,0,-7
17350,0,0,61,0,-61
17351,1,1,450,1877,1427
17352,1,1,96,2586,2490
17353,0,0,12,0,-12
17354,1,1,18,1243,1225
17355,1,1,234,2232,1998
17356,0,0,5,0,-5
17357,1,0,21,0,-21
17358,1,1,445,1439,994
17359,1,0,88,0,-88
17360,1,1,305,1671,1366
17361,0,0,42,0,-42
17362,1,0,64,0,-64
17363,0,0,29,0,-29
17364,1,0,78,0,-78
17365,1,1,766,1349,583
17366,0,0,12,0,-12
17367,0,0,24,0,-24
17368,0,0,63,0,-63
17369,1,1,1198,1275,77
17370,0,0,17,0,-17
17371,0,0,126,0,-126
17372,0,0,44,0,-44
17373,1,0,157,0,-157
17374,0,0,101,0,-101
17375,1,1,535,2017,1482
17376,0,0,9,0,-9
17377,1,0,22,0,-22
17378,0,0,77,0,-77
17379,1,0,39,0,-39
17380,0,0,3,0,-3
17381,1,1,350,1228,878
17382,0,0,14,0,-14
17383,0,0,0,0,0
17384,1,0,25,0,-25
17385,1,1,651,1386,735
17386,1,0,20,0,-20
17387,0,0,67,0,-67
17388,0,0,11,0,-11
17389,0,0,98,0,-98
17390,0,0,80,0,-80
17391,1,0,5,0,-5
17392,1,1,98,2259,2161
17393,1,1,936,3073,2137
17394,0,0,47,0,-47
17395,0,0,135,0,-135
17396,0,0,52,0,-52
17397,0,0,7,0,-7
17398,1,0,14,0,-14
17399,1,0,85,0,-85
17400,0,0,58,0,-58
17401,1,1,932,1251,319
17402,1,0,121,0,-121
17403,1,0,3,0,-3
17404,1,1,187,1398,1211
17405,1,0,9,0,-9
17406,0,0,4,0,-4
17407,1,1,102,1709,1607
17408,1,0,59,0,-59
17409,1,1,261,1212,951
17410,1,1,461,1398,937
17411,0,0,73,0,-73
17412,1,0,29,0,-29
17413,1,0,24,0,-24
17414,1,1,424,5211,4787
17415,1,1,321,1566,1245
17416,1,0,54,0,-54
17417,1,1,424,1378,954
17418,0,0,42,0,-42
17419,0,0,0,0,0
17420,1,0,259,0,-259
17421,1,0,33,0,-33
17422,1,1,476,1293,817
17423,0,0,97,0,-97
17424,1,1,987,1324,337
17425,1,0,49,0,-49
17426,0,0,7,0,-7
17427,1,1,23,1666,1643
17428,1,1,506,1205,699
17429,0,0,41,0,-41
17430,0,0,32,0,-32
17431,0,0,39,0,-39
17432,0,0,94,0,-94
17433,1,0,27,0,-27
17434,1,1,2478,1427,-1051
17435,1,1,204,4396,4192
17436,1,1,388,5563,5175
17437,0,0,55,0,-55
17438,1,0,121,0,-121
17439,1,1,170,2010,1840
17440,1,0,54,0,-54
17441,1,1,389,1268,879
17442,1,0,62,0,-62
17443,1,0,4,0,-4
17444,1,0,29,0,-29
17445,1,1,135,1225,1090
17446,0,0,23,0,-23
17447,1,1,31,1361,1330
17448,0,0,6,0,-6
17449,1,1,553,1519,966
17450,0,0,23,0,-23
17451,1,0,29,0,-29
17452,0,0,258,0,-258
17453,0,0,21,0,-21
17454,0,0,61,0,-61
17455,0,0,16,0,-16
17456,1,0,126,0,-126
17457,1,1,559,1683,1124
17458,1,1,1832,1898,66
17459,1,1,281,3153,2872
17460,0,0,19,0,-19
17461,1,0,212,0,-212
17462,1,1,523,1522,999
17463,1,1,794,1311,517
17464,1,1,202,1566,1364
17465,1,1,784,1406,622
17466,0,0,111,0,-111
17467,1,1,381,1305,924
17468,1,1,370,1241,871
17469,1,0,22,0,-22
17470,0,0,54,0,-54
17471,1,0,82,0,-82
17472,1,1,178,1550,1372
17473,0,0,123,0,-123
17474,1,1,612,1872,1260
17475,1,0,104,0,-104
17476,1,0,34,0,-34
17477,1,0,65,0,-65
17478,1,0,38,0,-38
17479,0,0,57,0,-57
17480,1,1,275,1223,948
17481,1,0,58,0,-58
17482,0,0,31,0,-31
17483,0,0,74,0,-74
17484,1,1,128,1466,1338
17485,0,0,61,0,-61
17486,1,1,2183,1207,-976
17487,1,0,156,0,-156
17488,1,0,105,0,-105
17489,1,0,53,0,-53
17490,1,0,70,0,-70
17491,1,1,744,1245,501
17492,1,0,14,0,-14
17493,1,0,56,0,-56
17494,0,0,49,0,-49
17495,0,0,21,0,-21
17496,1,0,83,0,-83
17497,0,0,59,0,-59
17498,0,0,18,0,-18
17499,1,1,897,1299,402
17500,1,0,17,0,-17
17501,0,0,4,0,-4
17502,0,0,102,0,-102
17503,0,0,2,0,-2
17504,0,0,14,0,-14
17505,1,0,7,0,-7
17506,1,0,35,0,-35
17507,1,1,682,1244,562
17508,1,0,5,0,-5
17509,0,0,98,0,-98
17510,1,1,481,1453,972
17511,1,0,37,0,-37
17512,1,1,432,2189,1757
17513,1,0,31,0,-31
17514,0,0,110,0,-110
17515,0,0,22,0,-22
17516,1,0,74,0,-74
17517,0,0,1,0,-1
17518,0,0,0,0,0
17519,0,0,40,0,-40
17520,0,0,64,0,-64
17521,1,0,163,0,-163
17522,1,0,129,0,-129
17523,1,0,48,0,-48
17524,0,0,45,0,-45
17525,1,1,1047,1226,179
17526,1,1,245,1836,1591
17527,1,1,152,1304,1152
17528,1,0,33,0,-33
17529,1,0,116,0,-116
17530,1,1,1005,1289,284
17531,1,1,1246,1993,747
17532,1,1,294,1562,1268
17533,1,0,104,0,-104
17534,0,0,64,0,-64
17535,0,0,1,0,-1
17536,0,0,114,0,-114
17537,1,1,164,1220,1056
17538,0,0,13,0,-13
17539,1,1,329,1376,1047
17540,0,0,25,0,-25
17541,1,0,5,0,-5
17542,0,0,277,0,-277
17543,1,1,144,1231,1087
17544,0,0,0,0,0
17545,1,1,987,1710,723
17546,1,1,251,1312,1061
17547,0,0,238,0,-238
17548,1,1,41,1457,1416
17549,1,1,667,1622,955
17550,1,1,320,1347,1027
17551,1,1,1033,1560,527
17552,0,0,76,0,-76
17553,1,0,12,0,-12
17554,1,1,116,1266,1150
17555,1,0,77,0,-77
17556,0,0,22,0,-22
17557,0,0,48,0,-48
17558,0,0,49,0,-49
17559,0,0,1,0,-1
17560,1,1,348,1222,874
17561,0,0,24,0,-24
17562,0,0,91,0,-91
17563,0,0,61,0,-61
17564,0,0,57,0,-57
17565,0,0,81,0,-81
17566,0,0,112,0,-112
17567,1,0,36,0,-36
17568,0,0,25,0,-25
17569,1,1,250,1275,1025
17570,1,0,132,0,-132
17571,1,0,4,0,-4
17572,0,0,28,0,-28
17573,1,0,10,0,-10
17574,1,0,1,0,-1
17575,1,0,71,0,-71
17576,0,0,31,0,-31
17577,0,0,104,0,-104
17578,0,0,27,0,-27
17579,0,0,11,0,-11
17580,0,0,135,0,-135
17581,0,0,18,0,-18
17582,1,1,1572,1295,-277
17583,0,0,21,0,-21
17584,1,1,476,1340,864
17585,1,0,1,0,-1
17586,0,0,373,0,-373
17587,0,0,66,0,-66
17588,0,0,12,0,-12
17589,1,1,1370,1246,-124
17590,1,1,575,1541,966
17591,0,0,73,0,-73
17592,1,1,478,1733,1255
17593,1,1,332,1627,1295
17594,1,0,12,0,-12
17595,1,0,54,0,-54
17596,0,0,66,0,-66
17597,0,0,67,0,-67
17598,1,0,22,0,-22
17599,0,0,43,0,-43
17600,0,0,54,0,-54
17601,0,0,9,0,-9
17602,1,1,301,2232,1931
17603,1,1,1056,1579,523
17604,1,1,831,1676,845
17605,0,0,46,0,-46
17606,1,1,190,1515,1325
17607,1,1,2220,1206,-1014
17608,1,0,0,0,0
17609,0,0,57,0,-57
17610,1,0,5,0,-5
17611,0,0,69,0,-69
17612,1,0,104,0,-104
17613,1,1,2651,1393,-1258
17614,1,1,327,1413,1086
17615,0,0,61,0,-61
17616,1,1,149,1697,1548
17617,1,0,52,0,-52
17618,1,0,32,0,-32
17619,0,0,26,0,-26
17620,0,0,75,0,-75
17621,0,0,73,0,-73
17622,1,1,1097,1479,382
17623,1,0,34,0,-34
17624,1,0,52,0,-52
17625,0,0,7,0,-7
17626,0,0,187,0,-187
17627,1,1,182,1455,1273
17628,1,0,7,0,-7
17629,1,0,6,0,-6
17630,0,0,79,0,-79
17631,0,0,14,0,-14
17632,1,1,777,2006,1229
17633,1,1,60,1349,1289
17634,1,0,35,0,-35
17635,1,0,37,0,-37
17636,1,0,15,0,-15
17637,0,0,51,0,-51
17638,1,0,19,0,-19
17639,1,1,99,1691,1592
17640,0,0,103,0,-103
17641,1,0,86,0,-86
17642,0,0,17,0,-17
17643,0,0,25,0,-25
17644,1,1,663,1254,591
17645,1,0,9,0,-9
17646,0,0,109,0,-109
17647,1,1,147,2230,2083
17648,1,0,42,0,-42
17649,0,0,16,0,-16
17650,1,0,2,0,-2
17651,0,0,10,0,-10
17652,1,1,131,2465,2334
17653,1,0,11,0,-11
17654,1,1,323,1857,1534
17655,1,1,884,1530,646
17656,1,1,60,1223,1163
17657,1,0,30,0,-30
17658,1,1,2089,1268,-821
17659,0,0,9,0,-9
17660,0,0,76,0,-76
17661,1,0,90,0,-90
17662,0,0,0,0,0
17663,0,0,64,0,-64
17664,0,0,43,0,-43
17665,0,0,156,0,-156
17666,1,1,449,1863,1414
17667,0,0,7,0,-7
17668,0,0,13,0,-13
17669,1,0,27,0,-27
17670,0,0,40,0,-40
17671,1,0,29,0,-29
17672,0,0,6,0,-6
17673,0,0,18,0,-18
17674,1,1,357,1727,1370
17675,1,1,337,1258,921
17676,0,0,1,0,-1
17677,1,1,97,1423,1326
17678,0,0,2,0,-2
17679,0,0,48,0,-48
17680,0,0,213,0,-213
17681,1,0,13,0,-13
17682,0,0,41,0,-41
17683,1,0,7,0,-7
17684,1,1,321,1348,1027
17685,1,0,8,0,-8
17686,1,1,2223,1337,-886
17687,0,0,187,0,-187
17688,0,0,164,0,-164
17689,0,0,98,0,-98
17690,0,0,16,0,-16
17691,1,1,29,1633,1604
17692,0,0,30,0,-30
17693,0,0,139,0,-139
17694,1,1,1014,1354,340
17695,1,1,166,1275,1109
17696,1,1,1149,1291,142
17697,0,0,36,0,-36
17698,0,0,44,0,-44
17699,1,0,5,0,-5
17700,0,0,65,0,-65
17701,1,1,97,2067,1970
17702,1,1,302,1642,1340
17703,1,0,3,0,-3
17704,0,0,3,0,-3
17705,1,0,1,0,-1
17706,1,1,1249,1336,87
17707,1,1,398,1730,1332
17708,1,0,126,0,-126
17709,1,0,110,0,-110
17710,1,1,994,1401,407
17711,1,1,1242,1628,386
17712,1,1,51,1663,1612
17713,1,1,463,1363,900
17714,1,1,493,1968,1475
17715,1,1,437,1484,1047
17716,1,0,49,0,-49
17717,1,1,1081,1343,262
17718,1,0,190,0,-190
17719,1,1,1073,1424,351
17720,0,0,41,0,-41
17721,1,0,51,0,-51
17722,1,0,76,0,-76
17723,1,1,187,1658,1471
17724,1,1,295,1863,1568
17725,1,0,27,0,-27
17726,1,1,400,1298,898
17727,1,0,137,0,-137
17728,0,0,101,0,-101
17729,0,0,60,0,-60
17730,0,0,23,0,-23
17731,1,1,186,1222,1036
17732,1,1,211,1657,1446
17733,0,0,13,0,-13
17734,1,1,123,1829,1706
17735,0,0,27,0,-27
17736,0,0,23,0,-23
17737,1,0,101,0,-101
17738,1,0,8,0,-8
17739,1,0,16,0,-16
17740,1,0,61,0,-61
17741,1,0,10,0,-10
17742,1,0,62,0,-62
17743,1,1,2016,1203,-813
17744,1,0,36,0,-36
17745,0,0,52,0,-52
17746,0,0,20,0,-20
17747,0,0,22,0,-22
17748,0,0,16,0,-16
17749,1,0,14,0,-14
17750,1,0,8,0,-8
17751,0,0,3,0,-3
17752,0,0,8,0,-8
17753,0,0,59,0,-59
17754,1,0,152,0,-152
17755,0,0,3,0,-3
17756,1,1,2260,1464,-796
17757,1,0,16,0,-16
17758,1,1,775,1213,438
17759,0,0,6,0,-6
17760,1,1,739,2054,1315
17761,0,0,0,0,0
17762,1,0,65,0,-65
17763,1,0,36,0,-36
17764,1,1,583,1279,696
17765,0,0,87,0,-87
17766,1,1,558,1316,758
17767,0,0,65,0,-65
17768,1,0,62,0,-62
17769,1,1,630,1992,1362
17770,1,0,15,0,-15
17771,0,0,126,0,-126
17772,1,0,57,0,-57
17773,0,0,12,0,-12
17774,1,1,313,1648,1335
17775,0,0,102,0,-102
17776,1,0,34,0,-34
17777,1,1,177,1321,1144
17778,1,1,760,1416,656
17779,1,0,105,0,-105
17780,1,1,388,2085,1697
17781,1,1,56,1951,1895
17782,1,0,108,0,-108
17783,0,0,12,0,-12
17784,1,1,34,1534,1500
17785,0,0,14,0,-14
17786,1,0,66,0,-66
17787,1,1,76,1263,1187
17788,0,0,17,0,-17
17789,1,0,20,0,-20
17790,1,1,333,2461,2128
17791,1,0,19,0,-19
17792,0,0,120,0,-120
17793,1,0,207,0,-207
17794,0,0,76,0,-76
17795,0,0,37,0,-37
17796,0,0,11,0,-11
17797,0,0,70,0,-70
17798,0,0,71,0,-71
17799,1,1,28,1238,1210
17800,1,0,40,0,-40
17801,0,0,1,0,-1
17802,0,0,37,0,-37
17803,1,0,4,0,-4
17804,1,1,799,1256,457
17805,1,0,1,0,-1
17806,1,1,548,1247,699
17807,0,0,34,0,-34
17808,1,0,118,0,-118
17809,0,0,107,0,-107
17810,0,0,92,0,-92
17811,1,0,16,0,-16
17812,1,1,232,2121,1889
17813,0,0,15,0,-15
17814,0,0,41,0,-41
17815,1,1,335,1343,1008
17816,1,1,368,1363,995
17817,1,1,265,1328,1063
17818,0,0,97,0,-97
17819,0,0,66,0,-66
17820,1,1,923,1295,372
17821,1,0,55,0,-55
17822,1,0,66,0,-66
17823,0,0,58,0,-58
17824,1,0,146,0,-146
17825,0,0,15,0,-15
17826,0,0,101,0,-101
17827,0,0,26,0,-26
17828,0,0,33,0,-33
17829,1,0,4,0,-4
17830,0,0,78,0,-78
17831,1,0,22,0,-22
17832,0,0,48,0,-48
17833,1,1,256,1412,1156
17834,1,1,772,1220,448
17835,0,0,43,0,-43
17836,1,0,49,0,-49
17837,1,1,606,1397,791
17838,1,1,248,1372,1124
17839,1,1,732,1408,676
17840,1,1,459,1326,867
17841,0,0,37,0,-37
17842,0,0,52,0,-52
17843,1,1,133,1505,1372
17844,1,1,803,1446,643
17845,0,0,2,0,-2
17846,1,1,287,1553,1266
17847,0,0,31,0,-31
17848,1,0,203,0,-203
17849,0,0,36,0,-36
17850,0,0,4,0,-4
17851,1,1,340,1224,884
17852,1,0,62,0,-62
17853,1,0,35,0,-35
17854,0,0,7,0,-7
17855,1,0,24,0,-24
17856,0,0,108,0,-108
17857,0,0,29,0,-29
17858,1,1,44,1698,1654
17859,1,0,128,0,-128
17860,0,0,14,0,-14
17861,0,0,38,0,-38
17862,0,0,69,0,-69
17863,1,1,376,1209,833
17864,1,0,35,0,-35
17865,1,1,427,1211,784
17866,1,0,20,0,-20
17867,1,1,401,2996,2595
17868,1,0,36,0,-36
17869,0,0,136,0,-136
17870,1,1,259,1373,1114
17871,1,1,164,1298,1134
17872,0,0,43,0,-43
17873,1,0,116,0,-116
17874,0,0,78,0,-78
17875,1,0,209,0,-209
17876,0,0,36,0,-36
17877,1,0,47,0,-47
17878,0,0,34,0,-34
17879,1,0,36,0,-36
17880,1,1,89,1624,1535
17881,1,0,52,0,-52
17882,0,0,6,0,-6
17883,0,0,177,0,-177
17884,1,1,1160,1527,367
17885,0,0,92,0,-92
17886,1,0,117,0,-117
17887,1,1,106,1416,1310
17888,1,0,54,0,-54
17889,1,1,272,1303,1031
17890,0,0,64,0,-64
17891,1,1,190,1486,1296
17892,1,0,9,0,-9
17893,0,0,152,0,-152
17894,1,1,164,1366,1202
17895,0,0,114,0,-114
17896,0,0,27,0,-27
17897,1,1,1177,1215,38
17898,1,1,489,2803,2314
17899,0,0,70,0,-70
17900,1,1,2040,1294,-746
17901,1,0,70,0,-70
17902,0,0,88,0,-88
17903,0,0,58,0,-58
17904,0,0,6,0,-6
17905,0,0,10,0,-10
17906,1,0,11,0,-11
17907,0,0,56,0,-56
17908,0,0,4,0,-4
17909,0,0,109,0,-109
17910,1,1,290,2103,1813
17911,0,0,77,0,-77
17912,0,0,1,0,-1
17913,0,0,70,0,-70
17914,1,0,77,0,-77
17915,1,1,927,1684,757
17916,1,0,131,0,-131
17917,0,0,42,0,-42
17918,0,0,30,0,-30
17919,1,0,139,0,-139
17920,1,1,1856,1278,-578
17921,1,0,26,0,-26
17922,1,1,322,1420,1098
17923,0,0,32,0,-32
17924,0,0,77,0,-77
17925,1,0,25,0,-25
17926,0,0,67,0,-67
17927,1,0,78,0,-78
17928,1,1,737,1593,856
17929,1,0,58,0,-58
17930,0,0,56,0,-56
17931,0,0,9,0,-9
17932,1,1,1004,1251,247
17933,0,0,35,0,-35
17934,0,0,24,0,-24
17935,1,1,644,1257,613
17936,1,0,7,0,-7
17937,1,0,88,0,-88
17938,0,0,101,0,-101
17939,0,0,26,0,-26
17940,1,1,644,1335,691
17941,1,0,126,0,-126
17942,1,0,48,0,-48
17943,1,1,629,1927,1298
17944,1,0,24,0,-24
17945,1,0,17,0,-17
17946,1,0,0,0,0
17947,1,0,65,0,-65
17948,0,0,7,0,-7
17949,0,0,10,0,-10
17950,0,0,2,0,-2
17951,1,0,84,0,-84
17952,1,0,11,0,-11
17953,1,0,47,0,-47
17954,1,1,145,1608,1463
17955,0,0,16,0,-16
17956,0,0,160,0,-160
17957,0,0,5,0,-5
17958,0,0,4,0,-4
17959,0,0,7,0,-7
17960,1,1,576,1732,1156
17961,1,0,16,0,-16
17962,0,0,100,0,-100
17963,1,0,128,0,-128
17964,1,1,1929,2095,166
17965,1,1,1778,1874,96
17966,1,1,858,1233,375
17967,1,0,1,0,-1
17968,0,0,48,0,-48
17969,1,0,12,0,-12
17970,0,0,73,0,-73
17971,1,1,940,1480,540
17972,0,0,6,0,-6
17973,0,0,30,0,-30
17974,1,1,1274,1610,336
17975,1,1,197,2399,2202
17976,1,1,291,1362,1071
17977,1,1,1066,1369,303
17978,1,1,61,2982,2921
17979,0,0,58,0,-58
17980,0,0,55,0,-55
17981,1,0,6,0,-6
17982,0,0,20,0,-20
17983,0,0,20,0,-20
17984,1,1,210,1336,1126
17985,0,0,52,0,-52
17986,1,1,1356,1472,116
17987,1,1,402,2021,1619
17988,0,0,1,0,-1
17989,1,0,93,0,-93
17990,1,1,336,1216,880
17991,1,0,24,0,-24
17992,1,0,77,0,-77
17993,1,0,12,0,-12
17994,0,0,79,0,-79
17995,1,0,30,0,-30
17996,0,0,34,0,-34
17997,1,1,1985,2406,421
17998,1,0,19,0,-19
17999,0,0,1,0,-1
18000,1,1,21,1297,1276
18001,1,0,39,0,-39
18002,1,0,67,0,-67
18003,0,0,14,0,-14
18004,1,0,10,0,-10
18005,1,0,2,0,-2
18006,0,0,75,0,-75
18007,1,1,1095,1584,489
18008,1,1,1393,1366,-27
18009,1,0,5,0,-5
18010,1,0,3,0,-3
18011,1,1,470,2298,1828
18012,1,1,2096,1641,-455
18013,1,1,456,1286,830
18014,0,0,57,0,-57
18015,1,0,8,0,-8
18016,0,0,65,0,-65
18017,0,0,5,0,-5
18018,1,0,23,0,-23
18019,0,0,22,0,-22
18020,1,0,59,0,-59
18021,1,1,332,1458,1126
18022,0,0,8,0,-8
18023,1,0,20,0,-20
18024,0,0,18,0,-18
18025,1,0,18,0,-18
18026,0,0,29,0,-29
18027,1,1,105,1265,1160
18028,0,0,44,0,-44
18029,0,0,7,0,-7
18030,1,1,31,1980,1949
18031,0,0,57,0,-57
18032,1,0,24,0,-24
18033,1,0,22,0,-22
18034,1,0,18,0,-18
18035,0,0,53,0,-53
18036,1,1,249,1445,1196
18037,1,0,21,0,-21
18038,0,0,49,0,-49
18039,1,0,111,0,-111
18040,1,1,142,1483,1341
18041,1,1,334,1259,925
18042,0,0,0,0,0
18043,1,1,1538,1267,-271
18044,1,0,26,0,-26
18045,0,0,2,0,-2
18046,1,1,1197,2290,1093
18047,0,0,15,0,-15
18048,1,0,36,0,-36
18049,1,1,202,1334,1132
18050,1,1,314,1329,1015
18051,0,0,161,0,-161
18052,1,1,286,1974,1688
18053,0,0,28,0,-28
18054,1,1,314,1780,1466
18055,0,0,85,0,-85
18056,1,0,57,0,-57
18057,1,1,530,1645,1115
18058,0,0,30,0,-30
18059,1,1,375,3037,2662
18060,1,0,89,0,-89
18061,1,1,91,1412,1321
18062,0,0,15,0,-15
18063,1,1,1041,1720,679
18064,1,1,109,1929,1820
18065,1,1,587,1530,943
18066,0,0,42,0,-42
18067,1,1,200,1500,1300
18068,1,1,35,1445,1410
18069,0,0,136,0,-136
18070,0,0,3,0,-3
18071,0,0,7,0,-7
18072,1,0,29,0,-29
18073,1,1,402,1203,801
18074,1,0,5,0,-5
18075,0,0,51,0,-51
18076,1,0,27,0,-27
18077,0,0,57,0,-57
18078,0,0,15,0,-15
18079,1,1,489,1275,786
18080,1,1,228,1366,1138
18081,1,0,10,0,-10
18082,1,1,609,1297,688
18083,0,0,7,0,-7
18084,1,1,561,1490,929
18085,1,0,31,0,-31
18086,1,1,1455,1286,-169
18087,1,1,155,1418,1263
18088,0,0,8,0,-8
18089,0,0,52,0,-52
18090,0,0,58,0,-58
18091,1,0,26,0,-26
18092,0,0,32,0,-32
18093,0,0,8,0,-8
18094,1,0,13,0,-13
18095,0,0,164,0,-164
18096,1,0,38,0,-38
18097,1,1,1019,1272,253
18098,0,0,15,0,-15
18099,1,0,48,0,-48
18100,1,0,51,0,-51
18101,1,1,466,1263,797
18102,1,0,119,0,-119
18103,0,0,8,0,-8
18104,0,0,108,0,-108
18105,0,0,19,0,-19
18106,0,0,15,0,-15
18107,1,1,2105,1214,-891
18108,0,0,8,0,-8
18109,1,1,887,1811,924
18110,0,0,1,0,-1
18111,0,0,171,0,-171
18112,1,0,39,0,-39
18113,1,0,136,0,-136
18114,1,1,266,1366,1100
18115,0,0,21,0,-21
18116,1,0,85,0,-85
18117,0,0,39,0,-39
18118,1,0,7,0,-7
18119,1,1,280,1295,1015
18120,0,0,112,0,-112
18121,0,0,25,0,-25
18122,1,1,470,1695,1225
18123,0,0,3,0,-3
18124,1,1,136,1309,1173
18125,1,1,233,1232,999
18126,1,1,155,1948,1793
18127,1,0,14,0,-14
18128,1,1,258,1503,1245
18129,0,0,18,0,-18
18130,0,0,4,0,-4
18131,1,0,14,0,-14
18132,1,1,569,1705,1136
18133,0,0,153,0,-153
18134,1,1,1966,1814,-152
18135,1,0,23,0,-23
18136,1,1,571,1220,649
18137,1,1,51,1240,1189
18138,1,1,323,1521,1198
18139,0,0,1,0,-1
18140,1,0,11,0,-11
18141,1,0,13,0,-13
18142,0,0,25,0,-25
18143,0,0,24,0,-24
18144,0,0,73,0,-73
18145,1,1,45,1275,1230
18146,1,0,14,0,-14
18147,1,1,344,1290,946
18148,1,1,71,1686,1615
18149,1,1,572,1324,752
18150,1,0,52,0,-52
18151,0,0,31,0,-31
18152,0,0,28,0,-28
18153,1,1,353,1223,870
18154,1,0,6,0,-6
18155,0,0,66,0,-66
18156,0,0,20,0,-20
18157,1,1,503,1229,726
18158,1,0,80,0,-80
18159,1,0,7,0,-7
18160,0,0,0,0,0
18161,1,0,22,0,-22
18162,0,0,50,0,-50
18163,1,0,59,0,-59
18164,1,1,1212,1883,671
18165,1,0,20,0,-20
18166,1,0,11,0,-11
18167,1,1,175,1303,1128
18168,1,0,11,0,-11
18169,1,0,93,0,-93
18170,0,0,45,0,-45
18171,0,0,6,0,-6
18172,1,0,131,0,-131
18173,1,0,18,0,-18
18174,0,0,14,0,-14
18175,0,0,10,0,-10
18176,0,0,0,0,0
18177,1,0,25,0,-25
18178,0,0,116,0,-116
18179,1,0,45,0,-45
18180,1,1,341,1255,914
18181,0,0,12,0,-12
18182,1,0,67,0,-67
18183,1,1,98,1452,1354
18184,1,1,677,1483,806
18185,1,0,23,0,-23
18186,1,1,1103,1545,442
18187,1,0,48,0,-48
18188,1,0,21,0,-21
18189,1,0,2,0,-2
18190,1,1,141,1418,1277
18191,0,0,56,0,-56
18192,0,0,86,0,-86
18193,1,0,70,0,-70
18194,1,0,108,0,-108
18195,0,0,20,0,-20
18196,1,1,946,1253,307
18197,0,0,31,0,-31
18198,1,1,134,1266,1132
18199,1,1,156,1477,1321
18200,0,0,16,0,-16
18201,1,1,1003,1959,956
18202,0,0,38,0,-38
18203,1,0,3,0,-3
18204,1,0,48,0,-48
18205,0,0,188,0,-188
18206,1,1,376,2830,2454
18207,1,0,25,0,-25
18208,0,0,56,0,-56
18209,0,0,15,0,-15
18210,1,0,37,0,-37
18211,0,0,43,0,-43
18212,0,0,5,0,-5
18213,1,1,698,1285,587
18214,0,0,104,0,-104
18215,1,1,773,1336,563
18216,1,1,358,1256,898
18217,1,1,1129,1680,551
18218,1,1,698,1244,546
18219,1,1,208,1250,1042
18220,0,0,118,0,-118
18221,0,0,105,0,-105
18222,1,1,640,1473,833
18223,0,0,43,0,-43
18224,0,0,4,0,-4
18225,0,0,163,0,-163
18226,1,1,500,2049,1549
18227,1,0,67,0,-67
18228,0,0,116,0,-116
18229,0,0,2,0,-2
18230,0,0,70,0,-70
18231,0,0,54,0,-54
18232,0,0,12,0,-12
18233,0,0,92,0,-92
18234,1,0,6,0,-6
18235,1,1,672,1609,937
18236,1,0,7,0,-7
18237,1,1,251,1314,1063
18238,1,0,141,0,-141
18239,1,0,28,0,-28
18240,0,0,12,0,-12
18241,0,0,18,0,-18
18242,1,0,12,0,-12
18243,1,0,204,0,-204
18244,1,0,35,0,-35
18245,0,0,172,0,-172
18246,1,0,52,0,-52
18247,1,0,89,0,-89
18248,1,0,194,0,-194
18249,1,1,300,1448,1148
18250,0,0,70,0,-70
18251,1,0,59,0,-59
18252,1,1,804,1448,644
18253,1,1,1705,1656,-49
18254,1,1,483,1391,908
18255,1,0,82,0,-82
18256,0,0,71,0,-71
18257,1,1,1010,1230,220
18258,1,0,113,0,-113
18259,1,0,21,0,-21
18260,0,0,68,0,-68
18261,1,1,939,1246,307
18262,0,0,116,0,-116
18263,1,1,204,1312,1108
18264,0,0,84,0,-84
18265,1,1,149,1240,1091
18266,1,0,150,0,-150
18267,0,0,16,0,-16
18268,0,0,263,0,-263
18269,0,0,14,0,-14
18270,1,1,36,1239,1203
18271,1,0,173,0,-173
18272,0,0,24,0,-24
18273,1,1,1494,2196,702
18274,1,1,326,1320,994
18275,0,0,294,0,-294
18276,0,0,162,0,-162
18277,1,1,430,1271,841
18278,1,1,816,1445,629
18279,1,0,45,0,-45
18280,0,0,44,0,-44
18281,0,0,44,0,-44
18282,0,0,7,0,-7
18283,0,0,17,0,-17
18284,1,0,56,0,-56
18285,0,0,5,0,-5
18286,1,0,20,0,-20
18287,0,0,43,0,-43
18288,1,1,754,1300,546
18289,0,0,57,0,-57
18290,1,0,14,0,-14
18291,1,0,73,0,-73
18292,1,0,14,0,-14
18293,1,0,12,0,-12
18294,1,1,352,1528,1176
18295,0,0,198,0,-198
18296,1,1,283,1725,1442
18297,1,1,466,1744,1278
18298,0,0,5,0,-5
18299,1,1,277,1284,1007
18300,1,1,828,1361,533
18301,0,0,147,0,-147
18302,0,0,39,0,-39
18303,0,0,116,0,-116
18304,1,1,123,1200,1077
18305,0,0,40,0,-40
18306,1,1,1137,1344,207
18307,1,1,1529,2633,1104
18308,1,1,142,1357,1215
18309,1,1,178,1328,1150
18310,1,0,86,0,-86
18311,0,0,33,0,-33
18312,1,1,236,1840,1604
18313,0,0,31,0,-31
18314,1,0,18,0,-18
18315,1,1,260,1227,967
18316,1,1,259,1202,943
18317,0,0,30,0,-30
18318,1,1,1016,1386,370
18319,0,0,16,0,-16
18320,1,1,851,1382,531
18321,0,0,50,0,-50
18322,0,0,8,0,-8
18323,0,0,107,0,-107
18324,1,0,7,0,-7
18325,1,0,16,0,-16
18326,1,1,299,1781,1482
18327,0,0,97,0,-97
18328,1,0,1,0,-1
18329,0,0,14,0,-14
18330,0,0,31,0,-31
18331,0,0,48,0,-48
18332,1,0,6,0,-6
18333,1,0,78,0,-78
18334,0,0,32,0,-32
18335,1,0,130,0,-130
18336,1,0,60,0,-60
18337,1,0,31,0,-31
18338,1,0,65,0,-65
18339,1,0,83,0,-83
18340,0,0,7,0,-7
18341,1,0,20,0,-20
18342,1,0,6,0,-6
18343,0,0,212,0,-212
18344,0,0,141,0,-141
18345,0,0,14,0,-14
18346,0,0,82,0,-82
18347,0,0,104,0,-104
18348,0,0,11,0,-11
18349,1,0,53,0,-53
18350,1,0,77,0,-77
18351,1,1,983,2150,1167
18352,1,0,8,0,-8
18353,1,1,820,1504,684
18354,0,0,33,0,-33
18355,0,0,8,0,-8
18356,1,0,13,0,-13
18357,1,1,869,1344,475
18358,0,0,4,0,-4
18359,1,0,67,0,-67
18360,1,1,54,1241,1187
18361,1,0,10,0,-10
18362,1,0,42,0,-42
18363,1,0,37,0,-37
18364,1,0,9,0,-9
18365,0,0,2,0,-2
18366,1,0,29,0,-29
18367,1,1,136,2232,2096
18368,0,0,40,0,-40
18369,1,1,400,1246,846
18370,1,1,1201,1416,215
18371,1,1,233,1342,1109
18372,1,0,22,0,-22
18373,1,0,28,0,-28
18374,1,1,1108,1237,129
18375,0,0,37,0,-37
18376,0,0,4,0,-4
18377,1,0,21,0,-21
18378,1,1,451,1390,939
18379,0,0,6,0,-6
18380,0,0,48,0,-48
18381,0,0,18,0,-18
18382,1,1,628,1216,588
18383,1,0,11,0,-11
18384,0,0,9,0,-9
18385,0,0,38,0,-38
18386,1,1,470,1328,858
18387,1,1,1019,1331,312
18388,0,0,40,0,-40
18389,1,1,86,1266,1180
18390,1,1,515,2029,1514
18391,1,0,2,0,-2
18392,0,0,32,0,-32
18393,1,1,342,1737,1395
18394,0,0,11,0,-11
18395,0,0,27,0,-27
18396,1,0,37,0,-37
18397,1,1,32,1243,1211
18398,1,0,56,0,-56
18399,0,0,118,0,-118
18400,0,0,53,0,-53
18401,0,0,7,0,-7
18402,1,1,1758,1208,-550
18403,1,0,11,0,-11
18404,1,1,98,2315,2217
18405,1,0,52,0,-52
18406,0,0,16,0,-16
18407,1,1,543,1909,1366
18408,0,0,31,0,-31
18409,0,0,62,0,-62
18410,0,0,61,0,-61
18411,0,0,51,0,-51
18412,0,0,109,0,-109
18413,0,0,13,0,-13
18414,1,0,71,0,-71
18415,0,0,22,0,-22
18416,0,0,63,0,-63
18417,0,0,60,0,-60
18418,1,0,9,0,-9
18419,0,0,144,0,-144
18420,0,0,13,0,-13
18421,0,0,0,0,0
18422,1,0,80,0,-80
18423,1,1,707,1628,921
18424,1,0,20,0,-20
18425,0,0,48,0,-48
18426,1,1,1552,1683,131
18427,0,0,8,0,-8
18428,0,0,3,0,-3
18429,1,1,71,1237,1166
18430,1,1,1879,2457,578
18431,0,0,181,0,-181
18432,0,0,66,0,-66
18433,1,1,896,1463,567
18434,1,0,31,0,-31
18435,1,1,1146,1389,243
18436,1,0,45,0,-45
18437,1,1,1818,1338,-480
18438,1,0,26,0,-26
18439,1,0,8,0,-8
18440,0,0,9,0,-9
18441,1,0,113,0,-113
18442,1,0,89,0,-89
18443,0,0,14,0,-14
18444,0,0,8,0,-8
18445,1,0,4,0,-4
18446,1,1,640,1347,707
18447,0,0,25,0,-25
18448,0,0,94,0,-94
18449,1,0,7,0,-7
18450,1,1,191,3034,2843
18451,0,0,77,0,-77
18452,1,1,705,1324,619
18453,0,0,84,0,-84
18454,0,0,1,0,-1
18455,1,1,175,1236,1061
18456,0,0,31,0,-31
18457,1,0,26,0,-26
18458,0,0,42,0,-42
18459,0,0,43,0,-43
18460,1,0,97,0,-97
18461,0,0,126,0,-126
18462,0,0,56,0,-56
18463,1,1,430,1471,1041
18464,1,1,1102,1391,289
18465,0,0,23,0,-23
18466,1,0,60,0,-60
18467,0,0,6,0,-6
18468,1,1,592,1657,1065
18469,1,0,29,0,-29
18470,0,0,85,0,-85
18471,0,0,45,0,-45
18472,0,0,31,0,-31
18473,1,0,60,0,-60
18474,1,0,4,0,-4
18475,1,0,0,0,0
18476,1,0,5,0,-5
18477,0,0,13,0,-13
18478,1,0,23,0,-23
18479,0,0,16,0,-16
18480,0,0,1,0,-1
18481,0,0,43,0,-43
18482,1,0,26,0,-26
18483,0,0,22,0,-22
18484,1,0,1,0,-1
18485,1,1,826,1231,405
18486,0,0,15,0,-15
18487,1,0,267,0,-267
18488,0,0,32,0,-32
18489,1,0,259,0,-259
18490,0,0,80,0,-80
18491,1,0,27,0,-27
18492,1,0,25,0,-25
18493,1,1,28,1532,1504
18494,0,0,0,0,0
18495,1,1,2668,3670,1002
18496,1,1,508,1554,1046
18497,0,0,80,0,-80
18498,0,0,136,0,-136
18499,1,1,193,1273,1080
18500,1,0,5,0,-5
18501,1,0,12,0,-12
18502,0,0,54,0,-54
18503,1,1,71,1250,1179
18504,1,1,162,1426,1264
18505,1,1,35,1582,1547
18506,1,1,1221,1380,159
18507,0,0,29,0,-29
18508,1,0,17,0,-17
18509,0,0,56,0,-56
18510,0,0,60,0,-60
18511,1,1,159,1532,1373
18512,1,0,71,0,-71
18513,0,0,33,0,-33
18514,1,0,23,0,-23
18515,0,0,25,0,-25
18516,0,0,149,0,-149
18517,1,1,16,1257,1241
18518,0,0,40,0,-40
18519,1,1,1312,1479,167
18520,1,1,1186,2039,853
18521,0,0,138,0,-138
18522,1,0,19,0,-19
18523,1,1,116,1339,1223
18524,1,1,640,1276,636
18525,0,0,67,0,-67
18526,0,0,6,0,-6
18527,1,0,212,0,-212
18528,0,0,61,0,-61
18529,1,1,194,2108,1914
18530,0,0,42,0,-42
18531,0,0,39,0,-39
18532,0,0,73,0,-73
18533,1,1,361,1253,892
18534,0,0,31,0,-31
18535,1,0,19,0,-19
18536,1,1,1109,1577,468
18537,0,0,8,0,-8
18538,0,0,83,0,-83
18539,0,0,104,0,-104
18540,0,0,97,0,-97
18541,0,0,19,0,-19
18542,0,0,5,0,-5
18543,1,1,1148,1784,636
18544,1,1,561,1807,1246
18545,0,0,66,0,-66
18546,1,0,110,0,-110
18547,1,0,76,0,-76
18548,1,1,754,1256,502
18549,0,0,58,0,-58
18550,0,0,5,0,-5
18551,1,0,13,0,-13
18552,0,0,25,0,-25
18553,0,0,183,0,-183
18554,0,0,231,0,-231
18555,0,0,0,0,0
18556,1,1,825,1374,549
18557,1,0,5,0,-5
18558,1,0,4,0,-4
18559,0,0,108,0,-108
18560,0,0,30,0,-30
18561,0,0,39,0,-39
18562,1,1,1202,1547,345
18563,0,0,77,0,-77
18564,0,0,133,0,-133
18565,1,1,632,2193,1561
18566,0,0,12,0,-12
18567,1,1,749,1248,499
18568,1,0,115,0,-115
18569,0,0,43,0,-43
18570,1,0,49,0,-49
18571,1,1,810,1212,402
18572,0,0,91,0,-91
18573,0,0,12,0,-12
18574,1,1,136,1585,1449
18575,1,1,64,1901,1837
18576,0,0,62,0,-62
18577,0,0,19,0,-19
18578,0,0,51,0,-51
18579,1,0,216,0,-216
18580,0,0,6,0,-6
18581,1,1,1144,2223,1079
18582,0,0,52,0,-52
18583,0,0,82,0,-82
18584,0,0,67,0,-67
18585,0,0,0,0,0
18586,0,0,1,0,-1
18587,0,0,151,0,-151
18588,1,0,39,0,-39
18589,1,0,41,0,-41
18590,1,1,98,2306,2208
18591,1,0,73,0,-73
18592,0,0,12,0,-12
18593,1,0,27,0,-27
18594,1,0,58,0,-58
18595,0,0,112,0,-112
18596,1,0,28,0,-28
18597,0,0,10,0,-10
18598,1,0,75,0,-75
18599,1,1,55,1501,1446
18600,1,0,9,0,-9
18601,1,1,661,1200,539
18602,1,1,358,2228,1870
18603,1,1,272,1697,1425
18604,1,0,43,0,-43
18605,1,0,39,0,-39
18606,0,0,40,0,-40
18607,0,0,45,0,-45
18608,0,0,34,0,-34
18609,0,0,25,0,-25
18610,0,0,14,0,-14
18611,1,1,335,1333,998
18612,1,0,37,0,-37
18613,1,1,398,1307,909
18614,0,0,3,0,-3
18615,1,1,324,1316,992
18616,1,0,5,0,-5
18617,0,0,43,0,-43
18618,1,0,34,0,-34
18619,1,0,8,0,-8
18620,0,0,24,0,-24
18621,1,0,47,0,-47
18622,0,0,70,0,-70
18623,1,0,82,0,-82
18624,0,0,2,0,-2
18625,1,1,494,1231,737
18626,1,1,131,1480,1349
18627,1,1,298,1263,965
18628,0,0,69,0,-69
18629,0,0,12,0,-12
18630,1,1,349,2347,1998
18631,1,1,148,10054,9906
18632,0,0,2,0,-2
18633,0,0,13,0,-13
18634,1,1,821,1226,405
18635,0,0,4,0,-4
18636,0,0,0,0,0
18637,1,0,15,0,-15
18638,1,1,220,2490,2270
18639,1,1,271,1947,1676
18640,0,0,52,0,-52
18641,0,0,4,0,-4
18642,0,0,34,0,-34
18643,0,0,7,0,-7
18644,1,1,1371,1321,-50
18645,1,1,520,1411,891
18646,1,1,184,2023,1839
18647,1,0,5,0,-5
18648,1,0,5,0,-5
18649,1,0,78,0,-78
18650,1,1,418,1441,1023
18651,1,0,71,0,-71
18652,1,1,82,1792,1710
18653,1,1,1533,1601,68
18654,1,0,13,0,-13
18655,1,1,162,1272,1110
18656,0,0,9,0,-9
18657,0,0,166,0,-166
18658,0,0,7,0,-7
18659,0,0,39,0,-39
18660,1,0,310,0,-310
18661,0,0,20,0,-20
18662,0,0,40,0,-40
18663,1,1,406,1205,799
18664,0,0,26,0,-26
18665,1,0,62,0,-62
18666,1,1,199,1369,1170
18667,0,0,124,0,-124
18668,1,1,410,1215,805
18669,1,1,85,1418,1333
18670,0,0,0,0,0
18671,1,0,72,0,-72
18672,1,0,44,0,-44
18673,1,0,35,0,-35
18674,0,0,85,0,-85
18675,1,0,52,0,-52
18676,1,1,742,1530,788
18677,1,0,31,0,-31
18678,0,0,94,0,-94
18679,1,0,43,0,-43
18680,1,1,540,1370,830
18681,0,0,11,0,-11
18682,1,1,551,1373,822
18683,1,1,84,1600,1516
18684,1,0,41,0,-41
18685,1,1,343,1491,1148
18686,1,0,29,0,-29
18687,0,0,149,0,-149
18688,1,1,497,2950,2453
18689,0,0,24,0,-24
18690,1,0,60,0,-60
18691,1,1,129,1651,1522
18692,0,0,89,0,-89
18693,1,0,1,0,-1
18694,0,0,13,0,-13
18695,1,0,105,0,-105
18696,1,1,601,1862,1261
18697,1,0,3,0,-3
18698,1,1,2955,1855,-1100
18699,1,1,628,2127,1499
18700,1,0,145,0,-145
18701,0,0,10,0,-10
18702,1,0,7,0,-7
18703,1,1,1536,1511,-25
18704,1,0,162,0,-162
18705,1,1,148,1477,1329
18706,1,1,1292,3826,2534
18707,0,0,24,0,-24
18708,1,0,72,0,-72
18709,1,0,30,0,-30
18710,0,0,2,0,-2
18711,1,1,700,1210,510
18712,1,0,2,0,-2
18713,0,0,86,0,-86
18714,1,0,33,0,-33
18715,1,0,45,0,-45
18716,1,0,7,0,-7
18717,0,0,57,0,-57
18718,0,0,21,0,-21
18719,1,0,62,0,-62
18720,0,0,233,0,-233
18721,1,0,35,0,-35
18722,1,0,43,0,-43
18723,0,0,14,0,-14
18724,1,0,49,0,-49
18725,0,0,18,0,-18
18726,0,0,31,0,-31
18727,0,0,13,0,-13
18728,1,1,1001,2144,1143
18729,1,0,183,0,-183
18730,1,0,16,0,-16
18731,1,1,740,1219,479
18732,0,0,3,0,-3
18733,1,1,914,1272,358
18734,0,0,82,0,-82
18735,1,1,890,1319,429
18736,1,0,6,0,-6
18737,1,1,292,1239,947
18738,0,0,65,0,-65
18739,0,0,29,0,-29
18740,0,0,9,0,-9
18741,0,0,64,0,-64
18742,1,0,46,0,-46
18743,1,0,14,0,-14
18744,1,1,496,1910,1414
18745,1,1,38,1469,1431
18746,1,0,116,0,-116
18747,0,0,108,0,-108
18748,0,0,18,0,-18
18749,0,0,7,0,-7
18750,1,1,645,1408,763
18751,1,1,53,1992,1939
18752,1,0,52,0,-52
18753,0,0,215,0,-215
18754,1,1,523,1358,835
18755,1,0,8,0,-8
18756,0,0,17,0,-17
18757,1,1,929,1534,605
18758,0,0,6,0,-6
18759,0,0,43,0,-43
18760,0,0,54,0,-54
18761,1,1,800,1609,809
18762,0,0,22,0,-22
18763,1,0,1,0,-1
18764,1,1,392,1485,1093
18765,1,1,1018,1407,389
18766,1,0,66,0,-66
18767,1,0,42,0,-42
18768,1,1,12,1577,1565
18769,1,0,44,0,-44
18770,0,0,107,0,-107
18771,0,0,55,0,-55
18772,1,1,416,1507,1091
18773,1,1,209,1286,1077
18774,1,0,30,0,-30
18775,0,0,80,0,-80
18776,1,1,181,1480,1299
18777,1,0,13,0,-13
18778,0,0,31,0,-31
18779,0,0,3,0,-3
18780,0,0,56,0,-56
18781,1,1,274,1929,1655
18782,1,0,66,0,-66
18783,0,0,42,0,-42
18784,1,1,461,1226,765
18785,0,0,1,0,-1
18786,0,0,4,0,-4
18787,0,0,33,0,-33
18788,1,0,119,0,-119
18789,0,0,34,0,-34
18790,1,0,93,0,-93
18791,0,0,16,0,-16
18792,0,0,19,0,-19
18793,0,0,40,0,-40
18794,0,0,9,0,-9
18795,1,0,50,0,-50
18796,0,0,3,0,-3
18797,0,0,52,0,-52
18798,1,1,249,1616,1367
18799,1,0,73,0,-73
18800,1,0,60,0,-60
18801,0,0,24,0,-24
18802,1,0,1,0,-1
18803,1,0,122,0,-122
18804,1,0,42,0,-42
18805,1,1,761,1626,865
18806,1,0,17,0,-17
18807,0,0,51,0,-51
18808,0,0,1,0,-1
18809,1,1,805,1814,1009
18810,1,0,84,0,-84
18811,1,0,101,0,-101
18812,1,0,35,0,-35
18813,0,0,38,0,-38
18814,1,0,30,0,-30
18815,0,0,37,0,-37
18816,1,0,58,0,-58
18817,1,1,918,2034,1116
18818,1,1,271,1812,1541
18819,1,1,127,1511,1384
18820,0,0,26,0,-26
18821,0,0,1,0,-1
18822,1,1,1201,1229,28
18823,1,0,63,0,-63
18824,0,0,52,0,-52
18825,1,0,36,0,-36
18826,0,0,3,0,-3
18827,1,0,60,0,-60
18828,1,0,63,0,-63
18829,0,0,4,0,-4
18830,0,0,92,0,-92
18831,0,0,103,0,-103
18832,1,0,19,0,-19
18833,0,0,43,0,-43
18834,1,0,24,0,-24
18835,1,1,245,1239,994
18836,0,0,43,0,-43
18837,0,0,9,0,-9
18838,1,0,17,0,-17
18839,1,0,95,0,-95
18840,1,0,40,0,-40
18841,1,1,200,1247,1047
18842,1,1,430,1303,873
18843,0,0,19,0,-19
18844,0,0,36,0,-36
18845,1,0,78,0,-78
18846,1,1,559,1438,879
18847,0,0,20,0,-20
18848,1,1,783,1431,648
18849,1,0,60,0,-60
18850,0,0,29,0,-29
18851,0,0,2,0,-2
18852,1,1,381,2404,2023
18853,1,0,16,0,-16
18854,1,1,369,1372,1003
18855,1,0,108,0,-108
18856,1,0,53,0,-53
18857,1,0,21,0,-21
18858,1,0,188,0,-188
18859,0,0,94,0,-94
18860,1,0,138,0,-138
18861,1,1,1168,2847,1679
18862,0,0,3,0,-3
18863,1,0,17,0,-17
18864,1,1,809,1549,740
18865,1,0,9,0,-9
18866,0,0,65,0,-65
18867,0,0,19,0,-19
18868,1,1,563,1670,1107
18869,1,0,45,0,-45
18870,1,1,1976,1279,-697
18871,0,0,32,0,-32
18872,0,0,76,0,-76
18873,1,0,37,0,-37
18874,1,0,70,0,-70
18875,1,1,59,1242,1183
18876,1,0,15,0,-15
18877,0,0,0,0,0
18878,0,0,50,0,-50
18879,1,0,24,0,-24
18880,0,0,56,0,-56
18881,1,1,250,1388,1138
18882,0,0,82,0,-82
18883,1,1,219,1726,1507
18884,0,0,12,0,-12
18885,0,0,45,0,-45
18886,1,1,500,2645,2145
18887,0,0,17,0,-17
18888,1,1,301,1369,1068
18889,1,0,51,0,-51
18890,0,0,94,0,-94
18891,0,0,5,0,-5
18892,1,1,193,1309,1116
18893,0,0,94,0,-94
18894,1,1,694,1361,667
18895,1,0,53,0,-53
18896,0,0,113,0,-113
18897,0,0,34,0,-34
18898,0,0,131,0,-131
18899,0,0,58,0,-58
18900,1,0,49,0,-49
18901,0,0,0,0,0
18902,1,1,904,2041,1137
18903,1,0,12,0,-12
18904,0,0,0,0,0
18905,1,1,544,2575,2031
18906,0,0,27,0,-27
18907,1,1,1128,1379,251
18908,0,0,8,0,-8
18909,1,1,775,1251,476
18910,1,0,1,0,-1
18911,0,0,96,0,-96
18912,1,1,89,1806,1717
18913,0,0,42,0,-42
18914,1,1,1101,1644,543
18915,0,0,42,0,-42
18916,0,0,21,0,-21
18917,0,0,83,0,-83
18918,0,0,82,0,-82
18919,1,0,31,0,-31
18920,1,0,2,0,-2
18921,1,1,173,1395,1222
18922,1,1,199,1321,1122
18923,1,0,46,0,-46
18924,1,0,175,0,-175
18925,1,1,84,1327,1243
18926,0,0,65,0,-65
18927,1,1,883,1365,482
18928,1,0,34,0,-34
18929,1,1,750,3981,3231
18930,0,0,75,0,-75
18931,1,0,44,0,-44
18932,1,1,1785,1267,-518
18933,0,0,20,0,-20
18934,0,0,130,0,-130
18935,1,0,87,0,-87
18936,0,0,33,0,-33
18937,1,1,718,1287,569
18938,1,1,78,1481,1403
18939,0,0,135,0,-135
18940,1,1,614,1915,1301
18941,0,0,37,0,-37
18942,0,0,207,0,-207
18943,1,0,0,0,0
18944,1,1,1851,1754,-97
18945,0,0,5,0,-5
18946,1,0,55,0,-55
18947,1,1,552,1788,1236
18948,1,0,123,0,-123
18949,1,1,740,1544,804
18950,1,1,641,1383,742
18951,1,0,36,0,-36
18952,1,1,605,1334,729
18953,1,1,432,1741,1309
18954,1,1,161,1348,1187
18955,1,0,37,0,-37
18956,1,0,19,0,-19
18957,0,0,36,0,-36
18958,1,1,37,1516,1479
18959,1,0,30,0,-30
18960,1,1,2131,1274,-857
18961,0,0,27,0,-27
18962,1,1,547,2468,1921
18963,1,0,49,0,-49
18964,1,1,347,1614,1267
18965,0,0,65,0,-65
18966,0,0,3,0,-3
18967,1,0,24,0,-24
18968,1,0,64,0,-64
18969,1,0,4,0,-4
18970,0,0,44,0,-44
18971,0,0,149,0,-149
18972,0,0,13,0,-13
18973,0,0,32,0,-32
18974,0,0,33,0,-33
18975,1,1,340,1675,1335
18976,1,0,38,0,-38
18977,0,0,62,0,-62
18978,1,0,62,0,-62
18979,1,1,217,1234,1017
18980,0,0,27,0,-27
18981,1,0,15,0,-15
18982,1,0,121,0,-121
18983,1,0,3,0,-3
18984,1,1,294,1230,936
18985,0,0,47,0,-47
18986,1,0,24,0,-24
18987,0,0,21,0,-21
18988,1,1,281,1268,987
18989,1,0,5,0,-5
18990,1,0,67,0,-67
18991,1,0,77,0,-77
18992,1,1,212,1680,1468
18993,1,0,13,0,-13
18994,1,0,75,0,-75
18995,1,0,382,0,-382
18996,1,0,19,0,-19
18997,1,0,60,0,-60
18998,1,0,173,0,-173
18999,1,0,7,0,-7
19000,1,0,15,0,-15
19001,1,1,531,1452,921
19002,1,0,6,0,-6
19003,1,1,110,1690,1580
19004,1,0,2,0,-2
19005,1,1,356,1411,1055
19006,1,0,83,0,-83
19007,0,0,15,0,-15
19008,0,0,53,0,-53
19009,1,1,237,1475,1238
19010,1,0,15,0,-15
19011,0,0,10,0,-10
19012,1,1,245,1389,1144
19013,1,1,133,1601,1468
19014,1,1,470,1405,935
19015,0,0,68,0,-68
19016,1,0,21,0,-21
19017,0,0,89,0,-89
19018,1,0,151,0,-151
19019,0,0,4,0,-4
19020,0,0,63,0,-63
19021,1,0,3,0,-3
19022,1,1,61,1224,1163
19023,1,0,31,0,-31
19024,1,0,11,0,-11
19025,1,0,10,0,-10
19026,1,1,840,1551,711
19027,1,0,89,0,-89
19028,1,1,508,1435,927
19029,1,1,313,1342,1029
19030,1,1,111,1295,1184
19031,1,1,246,1609,1363
19032,1,1,683,1350,667
19033,1,1,461,2059,1598
19034,0,0,103,0,-103
19035,0,0,22,0,-22
19036,0,0,11,0,-11
19037,0,0,10,0,-10
19038,1,1,136,1262,1126
19039,0,0,25,0,-25
19040,1,0,96,0,-96
19041,1,0,15,0,-15
19042,0,0,71,0,-71
19043,1,1,277,1574,1297
19044,0,0,71,0,-71
19045,1,1,127,2837,2710
19046,1,1,71,1503,1432
19047,1,0,88,0,-88
19048,1,1,448,1830,1382
19049,1,1,661,1953,1292
19050,1,1,284,1568,1284
19051,1,0,0,0,0
19052,1,1,339,1224,885
19053,1,1,500,1379,879
19054,1,0,7,0,-7
19055,1,1,1078,2059,981
19056,1,0,7,0,-7
19057,1,0,23,0,-23
19058,1,1,85,1572,1487
19059,0,0,35,0,-35
19060,0,0,66,0,-66
19061,1,0,2,0,-2
19062,1,0,182,0,-182
19063,0,0,11,0,-11
19064,1,1,1377,2627,1250
19065,0,0,9,0,-9
19066,0,0,8,0,-8
19067,0,0,36,0,-36
19068,1,0,49,0,-49
19069,0,0,53,0,-53
19070,1,0,2,0,-2
19071,0,0,57,0,-57
19072,0,0,53,0,-53
19073,0,0,21,0,-21
19074,1,0,1,0,-1
19075,0,0,124,0,-124
19076,0,0,13,0,-13
19077,1,1,981,2725,1744
19078,0,0,64,0,-64
19079,1,0,51,0,-51
19080,0,0,16,0,-16
19081,0,0,17,0,-17
19082,0,0,8,0,-8
19083,0,0,34,0,-34
19084,1,0,32,0,-32
19085,0,0,66,0,-66
19086,1,1,1172,1336,164
19087,0,0,13,0,-13
19088,0,0,3,0,-3
19089,1,0,278,0,-278
19090,1,1,408,1254,846
19091,1,0,101,0,-101
19092,1,0,41,0,-41
19093,1,1,622,1396,774
19094,1,0,5,0,-5
19095,1,1,713,2273,1560
19096,1,1,246,1555,1309
19097,0,0,79,0,-79
19098,1,1,153,1887,1734
19099,1,0,60,0,-60
19100,0,0,5,0,-5
19101,1,1,528,1262,734
19102,0,0,55,0,-55
19103,1,0,130,0,-130
19104,0,0,27,0,-27
19105,0,0,83,0,-83
19106,1,1,618,1280,662
19107,1,0,25,0,-25
19108,1,0,61,0,-61
19109,0,0,21,0,-21
19110,1,1,52,4526,4474
19111,0,0,149,0,-149
19112,0,0,25,0,-25
19113,0,0,25,0,-25
19114,1,0,199,0,-199
19115,0,0,91,0,-91
19116,1,1,329,1344,1015
19117,0,0,118,0,-118
19118,1,1,76,1230,1154
19119,0,0,29,0,-29
19120,0,0,40,0,-40
19121,1,0,73,0,-73
19122,1,0,14,0,-14
19123,1,0,35,0,-35
19124,1,1,679,1257,578
19125,0,0,13,0,-13
19126,1,0,47,0,-47
19127,1,0,30,0,-30
19128,0,0,12,0,-12
19129,0,0,293,0,-293
19130,0,0,45,0,-45
19131,1,1,617,1927,1310
19132,1,0,51,0,-51
19133,1,0,116,0,-116
19134,1,1,297,2244,1947
19135,1,1,795,1502,707
19136,1,0,31,0,-31
19137,1,0,17,0,-17
19138,1,0,147,0,-147
19139,0,0,38,0,-38
19140,0,0,73,0,-73
19141,0,0,219,0,-219
19142,1,1,1349,1527,178
19143,1,1,398,2446,2048
19144,1,0,27,0,-27
19145,0,0,99,0,-99
19146,1,1,272,2601,2329
19147,1,1,1111,1706,595
19148,1,0,50,0,-50
19149,1,1,189,1252,1063
19150,1,1,618,1564,946
19151,1,0,8,0,-8
19152,1,1,970,1782,812
19153,0,0,78,0,-78
19154,0,0,51,0,-51
19155,1,1,816,1259,443
19156,0,0,31,0,-31
19157,1,1,215,1255,1040
19158,0,0,7,0,-7
19159,1,1,1008,2989,1981
19160,0,0,48,0,-48
19161,0,0,4,0,-4
19162,0,0,25,0,-25
19163,1,0,2,0,-2
19164,1,0,29,0,-29
19165,0,0,9,0,-9
19166,0,0,16,0,-16
19167,0,0,101,0,-101
19168,1,0,38,0,-38
19169,1,1,37,1673,1636
19170,1,1,539,1268,729
19171,1,0,323,0,-323
19172,1,1,458,1281,823
19173,0,0,20,0,-20
19174,1,0,78,0,-78
19175,0,0,168,0,-168
19176,1,1,700,1284,584
19177,1,1,104,1244,1140
19178,1,0,29,0,-29
19179,0,0,204,0,-204
19180,0,0,124,0,-124
19181,0,0,3,0,-3
19182,1,0,28,0,-28
19183,1,0,40,0,-40
19184,1,1,242,1273,1031
19185,1,0,46,0,-46
19186,1,1,233,1321,1088
19187,1,1,1027,1263,236
19188,0,0,44,0,-44
19189,0,0,8,0,-8
19190,1,0,117,0,-117
19191,1,0,57,0,-57
19192,1,0,49,0,-49
19193,1,0,49,0,-49
19194,0,0,5,0,-5
19195,0,0,41,0,-41
19196,1,1,28,1977,1949
19197,0,0,33,0,-33
19198,1,0,11,0,-11
19199,0,0,12,0,-12
19200,1,1,210,1861,1651
19201,1,0,0,0,0
19202,0,0,280,0,-280
19203,0,0,28,0,-28
19204,0,0,68,0,-68
19205,1,1,2362,1248,-1114
19206,1,0,3,0,-3
19207,1,0,0,0,0
19208,1,0,22,0,-22
19209,1,0,2,0,-2
19210,1,1,854,1476,622
19211,1,0,50,0,-50
19212,1,0,20,0,-20
19213,1,1,510,1357,847
19214,1,1,241,2938,2697
19215,0,0,9,0,-9
19216,0,0,29,0,-29
19217,0,0,41,0,-41
19218,1,1,622,1495,873
19219,0,0,1,0,-1
19220,0,0,1,0,-1
19221,0,0,44,0,-44
19222,1,0,107,0,-107
19223,1,0,19,0,-19
19224,0,0,6,0,-6
19225,1,1,387,1840,1453
19226,0,0,82,0,-82
19227,0,0,90,0,-90
19228,1,1,278,1390,1112
19229,0,0,17,0,-17
19230,1,0,3,0,-3
19231,0,0,29,0,-29
19232,1,0,61,0,-61
19233,1,1,668,2138,1470
19234,0,0,19,0,-19
19235,0,0,22,0,-22
19236,1,1,649,1445,796
19237,1,0,30,0,-30
19238,0,0,38,0,-38
19239,1,0,2,0,-2
19240,0,0,5,0,-5
19241,1,1,708,1758,1050
19242,0,0,37,0,-37
19243,1,1,83,1495,1412
19244,1,0,50,0,-50
19245,0,0,11,0,-11
19246,0,0,40,0,-40
19247,1,1,1142,1351,209
19248,0,0,30,0,-30
19249,1,0,73,0,-73
19250,1,0,11,0,-11
19251,0,0,51,0,-51
19252,0,0,54,0,-54
19253,1,1,36,1427,1391
19254,0,0,15,0,-15
19255,1,0,61,0,-61
19256,1,0,37,0,-37
19257,1,1,1144,3539,2395
19258,0,0,41,0,-41
19259,1,1,532,3312,2780
19260,0,0,37,0,-37
19261,0,0,11,0,-11
19262,1,0,146,0,-146
19263,1,0,26,0,-26
19264,1,0,42,0,-42
19265,0,0,92,0,-92
19266,0,0,0,0,0
19267,1,1,833,1266,433
19268,0,0,31,0,-31
19269,0,0,75,0,-75
19270,1,0,13,0,-13
19271,1,1,959,1250,291
19272,0,0,58,0,-58
19273,1,1,2135,1739,-396
19274,1,1,187,1289,1102
19275,1,0,0,0,0
19276,1,0,28,0,-28
19277,1,1,591,1883,1292
19278,0,0,27,0,-27
19279,1,1,260,1703,1443
19280,0,0,62,0,-62
19281,1,0,2,0,-2
19282,1,1,389,2041,1652
19283,1,1,853,1371,518
19284,1,0,37,0,-37
19285,1,1,290,1521,1231
19286,1,0,61,0,-61
19287,0,0,90,0,-90
19288,1,0,92,0,-92
19289,1,0,73,0,-73
19290,1,0,185,0,-185
19291,1,1,475,1232,757
19292,1,0,100,0,-100
19293,1,1,223,1771,1548
19294,0,0,14,0,-14
19295,1,1,896,1311,415
19296,1,1,859,1244,385
19297,1,0,2,0,-2
19298,1,1,1235,1393,158
19299,0,0,20,0,-20
19300,1,1,1087,1260,173
19301,1,0,49,0,-49
19302,1,0,15,0,-15
19303,1,0,85,0,-85
19304,1,1,61,1400,1339
19305,0,0,26,0,-26
19306,1,1,481,1282,801
19307,1,0,12,0,-12
19308,1,1,514,2535,2021
19309,0,0,67,0,-67
19310,1,1,472,2091,1619
19311,0,0,13,0,-13
19312,0,0,23,0,-23
19313,1,0,169,0,-169
19314,0,0,63,0,-63
19315,0,0,40,0,-40
19316,1,1,39,2479,2440
19317,0,0,119,0,-119
19318,0,0,23,0,-23
19319,1,1,458,1449,991
19320,1,1,2719,1235,-1484
19321,1,0,14,0,-14
19322,1,1,181,1226,1045
19323,1,0,41,0,-41
19324,1,1,936,2181,1245
19325,1,0,47,0,-47
19326,1,0,5,0,-5
19327,1,1,380,1806,1426
19328,1,1,218,1554,1336
19329,0,0,24,0,-24
19330,1,1,159,1293,1134
19331,1,0,23,0,-23
19332,1,1,320,1885,1565
19333,1,1,499,1555,1056
19334,1,1,1446,1426,-20
19335,1,0,21,0,-21
19336,0,0,2,0,-2
19337,1,0,40,0,-40
19338,0,0,94,0,-94
19339,0,0,4,0,-4
19340,1,0,60,0,-60
19341,1,0,2,0,-2
19342,1,0,108,0,-108
19343,0,0,11,0,-11
19344,1,1,69,1515,1446
19345,0,0,29,0,-29
19346,1,1,647,1250,603
19347,1,0,67,0,-67
19348,1,1,110,1269,1159
19349,0,0,6,0,-6
19350,0,0,4,0,-4
19351,1,0,53,0,-53
19352,1,0,3,0,-3
19353,0,0,7,0,-7
19354,0,0,5,0,-5
19355,0,0,16,0,-16
19356,1,1,348,2356,2008
19357,0,0,155,0,-155
19358,1,0,5,0,-5
19359,0,0,79,0,-79
19360,1,0,13,0,-13
19361,0,0,1,0,-1
19362,1,0,97,0,-97
19363,0,0,82,0,-82
19364,0,0,60,0,-60
19365,1,1,681,1350,669
19366,1,1,585,1806,1221
19367,0,0,62,0,-62
19368,0,0,104,0,-104
19369,1,0,104,0,-104
19370,0,0,51,0,-51
19371,1,1,58,1232,1174
19372,1,1,634,1211,577
19373,1,0,49,0,-49
19374,1,1,64,1871,1807
19375,1,1,1108,1299,191
19376,0,0,26,0,-26
19377,1,0,91,0,-91
19378,0,0,16,0,-16
19379,1,0,92,0,-92
19380,1,0,10,0,-10
19381,1,0,57,0,-57
19382,0,0,7,0,-7
19383,0,0,3,0,-3
19384,1,0,205,0,-205
19385,1,0,22,0,-22
19386,0,0,13,0,-13
19387,1,1,180,1390,1210
19388,1,1,421,3201,2780
19389,1,0,46,0,-46
19390,0,0,53,0,-53
19391,1,1,662,1938,1276
19392,1,1,2207,1340,-867
19393,0,0,59,0,-59
19394,0,0,19,0,-19
19395,1,0,134,0,-134
19396,1,0,20,0,-20
19397,1,1,78,1393,1315
19398,0,0,17,0,-17
19399,1,1,231,1287,1056
19400,1,1,180,1774,1594
19401,1,1,518,1641,1123
19402,0,0,24,0,-24
19403,1,0,264,0,-264
19404,1,0,110,0,-110
19405,0,0,90,0,-90
19406,1,0,73,0,-73
19407,0,0,97,0,-97
19408,0,0,17,0,-17
19409,1,1,1003,1457,454
19410,0,0,41,0,-41
19411,1,1,572,1558,986
19412,1,0,41,0,-41
19413,0,0,52,0,-52
19414,0,0,37,0,-37
19415,0,0,112,0,-112
19416,1,0,83,0,-83
19417,0,0,7,0,-7
19418,0,0,81,0,-81
19419,0,0,160,0,-160
19420,1,0,0,0,0
19421,0,0,9,0,-9
19422,1,0,41,0,-41
19423,1,0,2,0,-2
19424,1,1,51,1410,1359
19425,1,1,707,1617,910
19426,0,0,1,0,-1
19427,1,0,25,0,-25
19428,1,1,37,1220,1183
19429,0,0,10,0,-10
19430,0,0,12,0,-12
19431,0,0,112,0,-112
19432,0,0,103,0,-103
19433,0,0,51,0,-51
19434,1,1,331,1395,1064
19435,0,0,20,0,-20
19436,1,1,346,2029,1683
19437,0,0,24,0,-24
19438,1,1,493,2212,1719
19439,1,1,148,2232,2084
19440,1,1,60,2508,2448
19441,1,0,0,0,0
19442,1,0,30,0,-30
19443,1,1,370,1441,1071
19444,1,0,33,0,-33
19445,1,1,148,2343,2195
19446,1,0,24,0,-24
19447,0,0,51,0,-51
19448,1,0,12,0,-12
19449,0,0,24,0,-24
19450,0,0,15,0,-15
19451,1,1,289,1281,992
19452,1,1,185,1481,1296
19453,1,0,7,0,-7
19454,1,0,10,0,-10
19455,0,0,7,0,-7
19456,0,0,91,0,-91
19457,0,0,351,0,-351
19458,0,0,18,0,-18
19459,0,0,14,0,-14
19460,1,1,280,1645,1365
19461,0,0,39,0,-39
19462,1,1,724,1338,614
19463,0,0,10,0,-10
19464,1,1,154,1314,1160
19465,0,0,26,0,-26
19466,0,0,7,0,-7
19467,1,0,18,0,-18
19468,0,0,79,0,-79
19469,1,0,28,0,-28
19470,0,0,57,0,-57
19471,1,0,17,0,-17
19472,0,0,0,0,0
19473,0,0,104,0,-104
19474,0,0,15,0,-15
19475,0,0,68,0,-68
19476,0,0,32,0,-32
19477,0,0,3,0,-3
19478,1,1,466,1350,884
19479,0,0,57,0,-57
19480,0,0,31,0,-31
19481,0,0,9,0,-9
19482,1,0,44,0,-44
19483,1,1,624,1548,924
19484,0,0,52,0,-52
19485,1,1,351,1440,1089
19486,0,0,15,0,-15
19487,0,0,25,0,-25
19488,0,0,28,0,-28
19489,1,0,140,0,-140
19490,1,0,46,0,-46
19491,1,1,1858,1263,-595
19492,1,1,7,1242,1235
19493,0,0,80,0,-80
19494,1,0,180,0,-180
19495,1,1,361,1541,1180
19496,1,1,174,1644,1470
19497,1,1,119,1241,1122
19498,0,0,43,0,-43
19499,1,0,4,0,-4
19500,1,1,616,1546,930
19501,1,0,88,0,-88
19502,1,1,494,1843,1349
19503,1,0,140,0,-140
19504,1,1,1145,1674,529
19505,1,0,55,0,-55
19506,1,1,1279,1585,306
19507,0,0,3,0,-3
19508,0,0,36,0,-36
19509,0,0,56,0,-56
19510,1,0,83,0,-83
19511,1,1,119,1408,1289
19512,1,0,69,0,-69
19513,1,1,445,1210,765
19514,1,1,87,1354,1267
19515,0,0,31,0,-31
19516,1,1,738,2047,1309
19517,1,1,725,1273,548
19518,0,0,17,0,-17
19519,1,1,218,1376,1158
19520,1,1,768,1692,924
19521,0,0,26,0,-26
19522,1,1,736,1958,1222
19523,1,1,663,1754,1091
19524,1,0,1,0,-1
19525,1,1,1255,1438,183
19526,1,0,39,0,-39
19527,1,1,2384,1300,-1084
19528,1,0,52,0,-52
19529,0,0,127,0,-127
19530,1,1,232,1618,1386
19531,1,0,37,0,-37
19532,0,0,29,0,-29
19533,0,0,41,0,-41
19534,1,1,56,1425,1369
19535,0,0,163,0,-163
19536,1,1,497,1207,710
19537,0,0,95,0,-95
19538,1,1,93,1456,1363
19539,0,0,42,0,-42
19540,1,0,7,0,-7
19541,0,0,14,0,-14
19542,0,0,103,0,-103
19543,1,1,843,1754,911
19544,1,1,1004,2574,1570
19545,1,0,52,0,-52
19546,1,1,794,1447,653
19547,1,1,79,2205,2126
19548,1,0,44,0,-44
19549,0,0,118,0,-118
19550,0,0,89,0,-89
19551,1,1,2320,2038,-282
19552,1,1,1199,1435,236
19553,1,0,41,0,-41
19554,1,1,300,1687,1387
19555,1,0,65,0,-65
19556,0,0,21,0,-21
19557,1,0,49,0,-49
19558,0,0,61,0,-61
19559,1,0,15,0,-15
19560,0,0,4,0,-4
19561,1,0,67,0,-67
19562,0,0,14,0,-14
19563,1,1,220,1347,1127
19564,0,0,53,0,-53
19565,0,0,17,0,-17
19566,1,1,996,1440,444
19567,0,0,68,0,-68
19568,1,1,559,1923,1364
19569,1,1,103,1405,1302
19570,0,0,18,0,-18
19571,1,0,37,0,-37
19572,1,1,316,1243,927
19573,1,1,329,1550,1221
19574,0,0,51,0,-51
19575,1,1,2369,2809,440
19576,0,0,86,0,-86
19577,1,0,6,0,-6
19578,1,0,115,0,-115
19579,1,0,65,0,-65
19580,1,0,64,0,-64
19581,0,0,33,0,-33
19582,1,1,768,1340,572
19583,1,0,111,0,-111
19584,1,1,374,1371,997
19585,0,0,33,0,-33
19586,1,0,79,0,-79
19587,1,1,674,1229,555
19588,1,1,196,2201,2005
19589,0,0,24,0,-24
19590,0,0,4,0,-4
19591,1,1,155,1361,1206
19592,0,0,0,0,0
19593,0,0,83,0,-83
19594,1,1,960,1455,495
19595,0,0,1,0,-1
19596,1,0,58,0,-58
19597,1,1,187,1932,1745
19598,1,0,0,0,0
19599,1,0,21,0,-21
19600,0,0,155,0,-155
19601,1,0,205,0,-205
19602,1,1,170,1210,1040
19603,1,1,124,2134,2010
19604,1,0,1,0,-1
19605,1,1,1393,1499,106
19606,1,0,15,0,-15
19607,0,0,48,0,-48
19608,0,0,50,0,-50
19609,1,1,982,2945,1963
19610,1,1,791,1268,477
19611,0,0,18,0,-18
19612,0,0,4,0,-4
19613,1,0,0,0,0
19614,0,0,121,0,-121
19615,0,0,11,0,-11
19616,1,1,396,1785,1389
19617,1,1,267,1252,985
19618,0,0,27,0,-27
19619,1,0,27,0,-27
19620,1,0,153,0,-153
19621,0,0,36,0,-36
19622,0,0,26,0,-26
19623,0,0,39,0,-39
19624,0,0,7,0,-7
19625,1,0,8,0,-8
19626,1,0,46,0,-46
19627,1,0,51,0,-51
19628,0,0,47,0,-47
19629,0,0,153,0,-153
19630,1,1,1070,1815,745
19631,0,0,67,0,-67
19632,1,0,22,0,-22
19633,0,0,112,0,-112
19634,0,0,113,0,-113
19635,1,0,91,0,-91
19636,1,0,62,0,-62
19637,1,1,179,1519,1340
19638,0,0,20,0,-20
19639,1,1,195,1313,1118
19640,1,1,519,1339,820
19641,1,1,235,1311,1076
19642,1,1,157,1367,1210
19643,0,0,32,0,-32
19644,0,0,7,0,-7
19645,1,0,69,0,-69
19646,0,0,77,0,-77
19647,0,0,94,0,-94
19648,1,1,90,1788,1698
19649,1,1,934,1419,485
19650,0,0,1,0,-1
19651,0,0,107,0,-107
19652,1,0,22,0,-22
19653,1,1,465,1442,977
19654,1,0,8,0,-8
19655,0,0,96,0,-96
19656,0,0,16,0,-16
19657,0,0,1,0,-1
19658,1,0,14,0,-14
19659,0,0,93,0,-93
19660,1,1,306,1268,962
19661,0,0,46,0,-46
19662,1,0,4,0,-4
19663,0,0,13,0,-13
19664,1,0,44,0,-44
19665,1,1,1378,1296,-82
19666,1,0,7,0,-7
19667,1,1,1666,1608,-58
19668,0,0,26,0,-26
19669,0,0,167,0,-167
19670,1,0,46,0,-46
19671,0,0,11,0,-11
19672,1,0,2,0,-2
19673,1,1,1224,1502,278
19674,1,0,105,0,-105
19675,1,0,66,0,-66
19676,0,0,41,0,-41
19677,1,1,110,1778,1668
19678,1,0,14,0,-14
19679,1,1,1074,1217,143
19680,1,0,45,0,-45
19681,1,1,430,1510,1080
19682,0,0,70,0,-70
19683,1,0,42,0,-42
19684,1,1,393,1308,915
19685,1,1,1401,1713,312
19686,0,0,73,0,-73
19687,1,0,47,0,-47
19688,1,1,54,1315,1261
19689,0,0,6,0,-6
19690,1,1,66,1288,1222
19691,0,0,81,0,-81
19692,1,1,314,2184,1870
19693,1,0,10,0,-10
19694,0,0,7,0,-7
19695,0,0,12,0,-12
19696,0,0,16,0,-16
19697,1,1,930,1343,413
19698,1,0,34,0,-34
19699,1,1,1049,1422,373
19700,1,0,141,0,-141
19701,1,0,28,0,-28
19702,1,1,38,1350,1312
19703,1,0,22,0,-22
19704,0,0,68,0,-68
19705,0,0,104,0,-104
19706,0,0,110,0,-110
19707,1,0,86,0,-86
19708,0,0,10,0,-10
19709,1,0,5,0,-5
19710,1,1,527,2454,1927
19711,1,0,10,0,-10
19712,0,0,35,0,-35
19713,1,0,20,0,-20
19714,1,1,293,1245,952
19715,1,1,368,1220,852
19716,0,0,14,0,-14
19717,1,0,66,0,-66
19718,1,0,17,0,-17
19719,0,0,5,0,-5
19720,0,0,12,0,-12
19721,1,0,0,0,0
19722,0,0,71,0,-71
19723,1,0,7,0,-7
19724,0,0,3,0,-3
19725,0,0,72,0,-72
19726,1,1,75,1856,1781
19727,1,0,48,0,-48
19728,1,1,77,1487,1410
19729,1,0,169,0,-169
19730,1,1,46,2543,2497
19731,0,0,13,0,-13
19732,0,0,8,0,-8
19733,1,0,19,0,-19
19734,1,1,2156,1449,-707
19735,1,1,835,1512,677
19736,1,1,577,1328,751
19737,1,1,398,1868,1470
19738,1,0,26,0,-26
19739,0,0,83,0,-83
19740,1,1,197,1237,1040
19741,0,0,131,0,-131
19742,0,0,31,0,-31
19743,1,0,104,0,-104
19744,0,0,72,0,-72
19745,0,0,153,0,-153
19746,1,1,346,1261,915
19747,0,0,27,0,-27
19748,1,1,144,1233,1089
19749,1,0,42,0,-42
19750,1,0,25,0,-25
19751,1,1,101,1636,1535
19752,0,0,91,0,-91
19753,1,1,363,1268,905
19754,0,0,60,0,-60
19755,1,0,4,0,-4
19756,1,1,401,1967,1566
19757,1,1,298,1710,1412
19758,0,0,2,0,-2
19759,1,1,286,1566,1280
19760,0,0,6,0,-6
19761,1,0,82,0,-82
19762,0,0,16,0,-16
19763,0,0,81,0,-81
19764,0,0,74,0,-74
19765,0,0,39,0,-39
19766,0,0,75,0,-75
19767,0,0,68,0,-68
19768,0,0,0,0,0
19769,0,0,24,0,-24
19770,0,0,0,0,0
19771,1,1,171,2242,2071
19772,1,0,0,0,0
19773,0,0,11,0,-11
19774,1,0,51,0,-51
19775,1,1,642,1724,1082
19776,1,0,104,0,-104
19777,1,0,95,0,-95
19778,0,0,105,0,-105
19779,1,1,908,1747,839
19780,1,1,918,1382,464
19781,0,0,19,0,-19
19782,1,1,2026,1328,-698
19783,1,1,378,1201,823
19784,1,1,293,1712,1419
19785,1,0,63,0,-63
19786,1,0,8,0,-8
19787,0,0,45,0,-45
19788,1,0,19,0,-19
19789,1,1,1460,1205,-255
19790,1,0,47,0,-47
19791,1,1,264,1206,942
19792,0,0,15,0,-15
19793,1,0,110,0,-110
19794,1,1,1124,1211,87
19795,1,1,245,1233,988
19796,1,1,492,1527,1035
19797,1,1,1271,1273,2
19798,0,0,155,0,-155
19799,1,1,436,1491,1055
19800,1,0,24,0,-24
19801,1,0,83,0,-83
19802,0,0,6,0,-6
19803,1,1,193,1279,1086
19804,0,0,222,0,-222
19805,1,0,19,0,-19
19806,0,0,3,0,-3
19807,0,0,2,0,-2
19808,1,1,480,1309,829
19809,1,0,46,0,-46
19810,0,0,26,0,-26
19811,1,1,696,1399,703
19812,1,0,49,0,-49
19813,0,0,23,0,-23
19814,1,1,515,1238,723
19815,1,0,12,0,-12
19816,0,0,17,0,-17
19817,1,1,32,1257,1225
19818,1,0,197,0,-197
19819,1,1,302,1366,1064
19820,1,0,1,0,-1
19821,0,0,51,0,-51
19822,0,0,150,0,-150
19823,1,0,122,0,-122
19824,0,0,75,0,-75
19825,1,1,147,1267,1120
19826,1,1,189,1224,1035
19827,1,1,292,1380,1088
19828,0,0,0,0,0
19829,1,1,485,1294,809
19830,1,1,1780,1720,-60
19831,1,1,1194,2131,937
19832,0,0,24,0,-24
19833,1,1,49,1227,1178
19834,1,0,21,0,-21
19835,0,0,73,0,-73
19836,1,1,426,1323,897
19837,0,0,18,0,-18
19838,1,1,232,1583,1351
19839,1,0,49,0,-49
19840,0,0,53,0,-53
19841,1,0,46,0,-46
19842,1,0,34,0,-34
19843,0,0,168,0,-168
19844,0,0,42,0,-42
19845,0,0,42,0,-42
19846,1,0,17,0,-17
19847,1,0,50,0,-50
19848,1,0,14,0,-14
19849,1,1,686,1793,1107
19850,1,0,18,0,-18
19851,0,0,7,0,-7
19852,0,0,81,0,-81
19853,0,0,108,0,-108
19854,1,0,101,0,-101
19855,1,1,481,1431,950
19856,1,0,30,0,-30
19857,0,0,15,0,-15
19858,0,0,28,0,-28
19859,0,0,59,0,-59
19860,0,0,13,0,-13
19861,1,0,61,0,-61
19862,1,1,3520,1340,-2180
19863,1,0,94,0,-94
19864,0,0,57,0,-57
19865,0,0,12,0,-12
19866,1,1,88,1344,1256
19867,1,0,57,0,-57
19868,0,0,82,0,-82
19869,0,0,0,0,0
19870,1,1,352,1466,1114
19871,1,1,1710,1443,-267
19872,0,0,43,0,-43
19873,1,0,3,0,-3
19874,1,1,1009,1245,236
19875,1,1,313,1347,1034
19876,0,0,120,0,-120
19877,1,0,32,0,-32
19878,1,1,214,1549,1335
19879,1,0,179,0,-179
19880,0,0,0,0,0
19881,0,0,5,0,-5
19882,1,0,85,0,-85
19883,0,0,6,0,-6
19884,0,0,5,0,-5
19885,1,0,0,0,0
19886,1,1,1106,2096,990
19887,0,0,9,0,-9
19888,0,0,145,0,-145
19889,0,0,26,0,-26
19890,1,1,495,1436,941
19891,1,1,1287,1308,21
19892,0,0,92,0,-92
19893,0,0,5,0,-5
19894,1,0,148,0,-148
19895,1,0,79,0,-79
19896,1,1,916,1375,459
19897,1,0,11,0,-11
19898,1,1,83,1470,1387
19899,1,1,123,3287,3164
19900,0,0,135,0,-135
19901,1,1,301,1440,1139
19902,1,1,577,1425,848
19903,0,0,147,0,-147
19904,1,1,117,1235,1118
19905,0,0,3,0,-3
19906,1,1,572,1446,874
19907,1,0,59,0,-59
19908,0,0,116,0,-116
19909,1,0,186,0,-186
19910,1,1,121,1524,1403
19911,1,1,543,1463,920
19912,0,0,10,0,-10
19913,1,1,919,1270,351
19914,0,0,63,0,-63
19915,1,1,198,1431,1233
19916,1,0,106,0,-106
19917,0,0,81,0,-81
19918,0,0,51,0,-51
19919,1,0,164,0,-164
19920,0,0,33,0,-33
19921,0,0,9,0,-9
19922,1,1,1102,1962,860
19923,1,0,25,0,-25
19924,1,1,228,1352,1124
19925,1,0,26,0,-26
19926,1,0,44,0,-44
19927,0,0,28,0,-28
19928,0,0,77,0,-77
19929,1,0,2,0,-2
19930,1,1,334,2128,1794
19931,0,0,13,0,-13
19932,1,0,76,0,-76
19933,0,0,2,0,-2
19934,0,0,8,0,-8
19935,0,0,30,0,-30
19936,0,0,6,0,-6
19937,1,1,105,1271,1166
19938,1,0,14,0,-14
19939,0,0,138,0,-138
19940,0,0,75,0,-75
19941,0,0,13,0,-13
19942,1,0,14,0,-14
19943,1,1,1098,1581,483
19944,1,1,652,1440,788
19945,1,0,113,0,-113
19946,1,0,25,0,-25
19947,1,0,81,0,-81
19948,0,0,120,0,-120
19949,1,1,202,4087,3885
19950,1,0,1,0,-1
19951,1,0,12,0,-12
19952,0,0,22,0,-22
19953,0,0,23,0,-23
19954,0,0,141,0,-141
19955,1,1,795,1983,1188
19956,1,0,130,0,-130
19957,0,0,19,0,-19
19958,0,0,33,0,-33
19959,1,1,9,1274,1265
19960,0,0,27,0,-27
19961,1,0,28,0,-28
19962,0,0,103,0,-103
19963,0,0,4,0,-4
19964,0,0,31,0,-31
19965,0,0,15,0,-15
19966,1,0,17,0,-17
19967,1,1,1689,1601,-88
19968,1,1,1179,1404,225
19969,0,0,96,0,-96
19970,0,0,50,0,-50
19971,1,1,639,1571,932
19972,1,1,571,2448,1877
19973,1,0,63,0,-63
19974,1,0,10,0,-10
19975,1,0,74,0,-74
19976,1,0,62,0,-62
19977,1,1,386,2141,1755
19978,0,0,70,0,-70
19979,1,0,11,0,-11
19980,1,1,188,1201,1013
19981,1,1,546,1272,726
19982,0,0,13,0,-13
19983,0,0,7,0,-7
19984,1,1,165,1499,1334
19985,1,0,28,0,-28
19986,0,0,15,0,-15
19987,1,0,24,0,-24
19988,0,0,8,0,-8
19989,1,1,153,2860,2707
19990,1,1,147,1242,1095
19991,1,0,26,0,-26
19992,0,0,17,0,-17
19993,1,0,27,0,-27
19994,1,1,137,1237,1100
19995,1,1,1145,1377,232
19996,1,0,109,0,-109
19997,1,1,416,1465,1049
19998,1,0,35,0,-35
19999,1,0,12,0,-12
20000,0,0,39,0,-39
20001,1,1,179,1332,1153
20002,0,0,1,0,-1
20003,1,1,287,1994,1707
20004,0,0,6,0,-6
20005,1,1,154,1259,1105
20006,1,1,31,2455,2424
20007,0,0,48,0,-48
20008,1,0,8,0,-8
20009,0,0,16,0,-16
20010,0,0,1,0,-1
20011,0,0,82,0,-82
20012,1,1,735,1235,500
20013,1,0,25,0,-25
20014,0,0,16,0,-16
20015,1,0,60,0,-60
20016,1,1,818,1208,390
20017,0,0,28,0,-28
20018,1,1,305,1699,1394
20019,0,0,12,0,-12
20020,0,0,41,0,-41
20021,1,0,73,0,-73
20022,1,1,20,1689,1669
20023,0,0,93,0,-93
20024,0,0,134,0,-134
20025,1,1,598,1518,920
20026,0,0,5,0,-5
20027,1,0,51,0,-51
20028,1,1,208,1255,1047
20029,0,0,44,0,-44
20030,1,0,177,0,-177
20031,1,1,944,1411,467
20032,1,1,1881,1548,-333
20033,1,0,51,0,-51
20034,1,1,1207,1281,74
20035,1,0,60,0,-60
20036,0,0,143,0,-143
20037,1,0,26,0,-26
20038,0,0,28,0,-28
20039,1,1,606,1671,1065
20040,1,1,799,1236,437
20041,1,1,115,1215,1100
20042,1,0,22,0,-22
20043,1,1,37,1679,1642
20044,1,1,123,1207,1084
20045,1,0,5,0,-5
20046,1,1,852,2882,2030
20047,0,0,40,0,-40
20048,1,1,570,1735,1165
20049,1,1,73,1882,1809
20050,0,0,94,0,-94
20051,1,0,10,0,-10
20052,1,1,2,2364,2362
20053,1,0,20,0,-20
20054,0,0,109,0,-109
20055,0,0,86,0,-86
20056,0,0,27,0,-27
20057,1,0,192,0,-192
20058,1,0,60,0,-60
20059,1,0,99,0,-99
20060,0,0,1,0,-1
20061,0,0,1,0,-1
20062,1,0,50,0,-50
20063,1,0,96,0,-96
20064,1,0,52,0,-52
20065,0,0,66,0,-66
20066,1,0,33,0,-33
20067,1,1,642,1684,1042
20068,1,0,3,0,-3
20069,0,0,43,0,-43
20070,1,1,699,1253,554
20071,1,1,1434,1209,-225
20072,1,1,168,1233,1065
20073,1,0,83,0,-83
20074,1,1,165,1212,1047
20075,0,0,37,0,-37
20076,1,1,316,1549,1233
20077,1,0,55,0,-55
20078,1,1,124,2313,2189
20079,1,1,589,1285,696
20080,1,0,79,0,-79
20081,1,1,435,2040,1605
20082,0,0,2,0,-2
20083,1,0,42,0,-42
20084,0,0,217,0,-217
20085,0,0,131,0,-131
20086,0,0,61,0,-61
20087,0,0,179,0,-179
20088,1,0,60,0,-60
20089,1,1,549,1207,658
20090,1,1,21,1358,1337
20091,1,1,494,1200,706
20092,1,0,64,0,-64
20093,1,1,153,1705,1552
20094,1,0,5,0,-5
20095,0,0,37,0,-37
20096,0,0,15,0,-15
20097,1,1,195,1536,1341
20098,0,0,28,0,-28
20099,1,0,23,0,-23
20100,0,0,28,0,-28
20101,1,1,89,1216,1127
20102,0,0,3,0,-3
20103,0,0,12,0,-12
20104,0,0,81,0,-81
20105,1,1,74,1222,1148
20106,0,0,87,0,-87
20107,0,0,9,0,-9
20108,1,1,42,1508,1466
20109,0,0,28,0,-28
20110,0,0,39,0,-39
20111,1,1,645,2155,1510
20112,1,1,58,1761,1703
20113,1,0,15,0,-15
20114,1,1,248,1988,1740
20115,1,1,491,1426,935
20116,0,0,13,0,-13
20117,1,0,15,0,-15
20118,0,0,20,0,-20
20119,1,1,2170,1374,-796
20120,1,0,68,0,-68
20121,1,0,115,0,-115
20122,1,1,536,1441,905
20123,0,0,251,0,-251
20124,1,1,276,3471,3195
20125,1,0,67,0,-67
20126,0,0,15,0,-15
20127,1,1,508,1264,756
20128,0,0,1,0,-1
20129,1,1,153,1825,1672
20130,1,1,563,1419,856
20131,1,0,118,0,-118
20132,1,1,211,1712,1501
20133,0,0,42,0,-42
20134,0,0,27,0,-27
20135,1,1,233,1311,1078
20136,1,0,130,0,-130
20137,0,0,103,0,-103
20138,1,1,109,1232,1123
20139,1,0,35,0,-35
20140,1,0,68,0,-68
20141,1,1,564,2969,2405
20142,0,0,27,0,-27
20143,0,0,1,0,-1
20144,0,0,90,0,-90
20145,1,0,13,0,-13
20146,1,1,1120,1226,106
20147,1,0,172,0,-172
20148,1,0,17,0,-17
20149,1,0,26,0,-26
20150,1,1,132,1307,1175
20151,0,0,1,0,-1
20152,1,1,526,1361,835
20153,0,0,45,0,-45
20154,0,0,139,0,-139
20155,1,0,65,0,-65
20156,1,1,1020,1808,788
20157,0,0,72,0,-72
20158,1,1,276,1271,995
20159,0,0,52,0,-52
20160,0,0,52,0,-52
20161,1,0,169,0,-169
20162,0,0,37,0,-37
20163,1,0,8,0,-8
20164,0,0,23,0,-23
20165,1,0,186,0,-186
20166,1,0,136,0,-136
20167,1,0,36,0,-36
20168,0,0,38,0,-38
20169,1,1,585,1238,653
20170,1,0,21,0,-21
20171,1,0,6,0,-6
20172,0,0,13,0,-13
20173,1,0,15,0,-15
20174,1,1,136,1233,1097
20175,1,1,1231,1361,130
20176,1,1,532,1788,1256
20177,1,0,2,0,-2
20178,1,0,1,0,-1
20179,1,1,349,1778,1429
20180,0,0,8,0,-8
20181,1,1,104,1443,1339
20182,1,1,558,1223,665
20183,1,0,3,0,-3
20184,1,1,553,1343,790
20185,0,0,1,0,-1
20186,1,1,636,3711,3075
20187,1,1,107,1352,1245
20188,1,0,196,0,-196
20189,0,0,4,0,-4
20190,0,0,29,0,-29
20191,1,0,76,0,-76
20192,1,0,8,0,-8
20193,0,0,45,0,-45
20194,1,0,12,0,-12
20195,1,0,0,0,0
20196,1,1,146,1379,1233
20197,0,0,117,0,-117
20198,0,0,78,0,-78
20199,1,0,12,0,-12
20200,1,1,366,1700,1334
20201,1,1,297,1204,907
20202,1,1,31,2611,2580
20203,1,1,532,1401,869
20204,1,0,0,0,0
20205,0,0,124,0,-124
20206,1,0,5,0,-5
20207,0,0,2,0,-2
20208,1,1,121,2157,2036
20209,1,1,666,1703,1037
20210,1,1,479,1209,730
20211,1,1,714,1248,534
20212,1,1,2219,1211,-1008
20213,0,0,69,0,-69
20214,1,1,65,1420,1355
20215,0,0,101,0,-101
20216,0,0,74,0,-74
20217,0,0,11,0,-11
20218,0,0,93,0,-93
20219,1,0,3,0,-3
20220,1,0,2,0,-2
20221,0,0,55,0,-55
20222,1,0,7,0,-7
20223,0,0,1,0,-1
20224,0,0,14,0,-14
20225,0,0,87,0,-87
20226,0,0,29,0,-29
20227,1,0,4,0,-4
20228,1,1,754,1547,793
20229,0,0,13,0,-13
20230,0,0,12,0,-12
20231,0,0,131,0,-131
20232,1,1,146,1369,1223
20233,0,0,7,0,-7
20234,1,0,150,0,-150
20235,0,0,12,0,-12
20236,0,0,1,0,-1
20237,1,0,16,0,-16
20238,0,0,78,0,-78
20239,0,0,59,0,-59
20240,1,0,103,0,-103
20241,1,0,34,0,-34
20242,0,0,130,0,-130
20243,1,0,9,0,-9
20244,0,0,81,0,-81
20245,0,0,24,0,-24
20246,1,1,233,1782,1549
20247,0,0,5,0,-5
20248,1,1,1443,1211,-232
20249,1,0,91,0,-91
20250,1,0,2,0,-2
20251,1,1,1295,2089,794
20252,0,0,35,0,-35
20253,0,0,95,0,-95
20254,1,1,239,1667,1428
20255,1,0,10,0,-10
20256,1,0,71,0,-71
20257,0,0,59,0,-59
20258,0,0,91,0,-91
20259,1,1,244,1477,1233
20260,1,1,343,1556,1213
20261,1,1,380,2985,2605
20262,1,0,11,0,-11
20263,0,0,10,0,-10
20264,1,1,463,1487,1024
20265,1,1,965,1583,618
20266,1,1,272,1229,957
20267,1,1,862,1577,715
20268,1,1,291,1397,1106
20269,0,0,35,0,-35
20270,0,0,26,0,-26
20271,1,1,1911,1845,-66
20272,1,1,226,1264,1038
20273,0,0,82,0,-82
20274,0,0,7,0,-7
20275,0,0,121,0,-121
20276,1,1,1594,1694,100
20277,0,0,46,0,-46
20278,0,0,86,0,-86
20279,1,0,14,0,-14
20280,1,1,1111,1282,171
20281,1,0,2,0,-2
20282,0,0,5,0,-5
20283,1,1,267,1897,1630
20284,1,0,20,0,-20
20285,1,0,34,0,-34
20286,0,0,15,0,-15
20287,0,0,46,0,-46
20288,1,1,311,1830,1519
20289,1,0,78,0,-78
20290,1,1,724,1428,704
20291,0,0,12,0,-12
20292,1,1,1113,1328,215
20293,1,1,97,1828,1731
20294,0,0,20,0,-20
20295,0,0,18,0,-18
20296,1,1,400,1348,948
20297,1,0,124,0,-124
20298,0,0,136,0,-136
20299,1,1,129,1544,1415
20300,0,0,12,0,-12
20301,1,1,373,1233,860
20302,1,1,755,1413,658
20303,1,1,555,1380,825
20304,0,0,22,0,-22
20305,1,0,54,0,-54
20306,0,0,56,0,-56
20307,1,1,159,1889,1730
20308,1,0,101,0,-101
20309,1,1,239,1241,1002
20310,1,0,97,0,-97
20311,1,0,166,0,-166
20312,1,1,146,2574,2428
20313,1,0,91,0,-91
20314,0,0,39,0,-39
20315,1,1,932,2631,1699
20316,0,0,12,0,-12
20317,1,0,95,0,-95
20318,0,0,62,0,-62
20319,0,0,6,0,-6
20320,1,1,206,1315,1109
20321,0,0,8,0,-8
20322,1,0,6,0,-6
20323,0,0,10,0,-10
20324,1,0,81,0,-81
20325,0,0,42,0,-42
20326,1,0,106,0,-106
20327,0,0,169,0,-169
20328,0,0,26,0,-26
20329,1,1,1037,1426,389
20330,0,0,52,0,-52
20331,1,1,404,2023,1619
20332,1,1,1494,1375,-119
20333,1,0,17,0,-17
20334,1,1,316,1342,1026
20335,1,0,64,0,-64
20336,0,0,1,0,-1
20337,0,0,33,0,-33
20338,1,1,243,1891,1648
20339,1,0,214,0,-214
20340,1,1,366,1268,902
20341,1,1,400,1408,1008
20342,1,0,102,0,-102
20343,1,0,10,0,-10
20344,0,0,19,0,-19
20345,0,0,147,0,-147
20346,1,0,31,0,-31
20347,1,1,252,1206,954
20348,1,1,241,2293,2052
20349,0,0,79,0,-79
20350,1,1,485,1316,831
20351,0,0,35,0,-35
20352,1,0,0,0,0
20353,1,0,101,0,-101
20354,1,0,1,0,-1
20355,0,0,126,0,-126
20356,0,0,32,0,-32
20357,1,0,37,0,-37
20358,0,0,92,0,-92
20359,1,1,172,1370,1198
20360,1,0,2,0,-2
20361,0,0,4,0,-4
20362,1,1,773,1647,874
20363,0,0,5,0,-5
20364,1,1,234,1389,1155
20365,1,0,12,0,-12
20366,0,0,5,0,-5
20367,1,1,174,1303,1129
20368,0,0,23,0,-23
20369,1,0,2,0,-2
20370,1,1,1044,1295,251
20371,0,0,26,0,-26
20372,0,0,15,0,-15
20373,1,0,38,0,-38
20374,1,0,7,0,-7
20375,1,0,76,0,-76
20376,1,0,196,0,-196
20377,1,1,386,1373,987
20378,1,0,85,0,-85
20379,1,1,178,1252,1074
20380,1,1,1412,2706,1294
20381,0,0,9,0,-9
20382,1,0,14,0,-14
20383,1,1,22,2596,2574
20384,1,0,193,0,-193
20385,1,0,50,0,-50
20386,1,0,7,0,-7
20387,1,0,12,0,-12
20388,0,0,15,0,-15
20389,0,0,96,0,-96
20390,1,1,561,1214,653
20391,1,0,76,0,-76
20392,1,0,55,0,-55
20393,1,1,246,1291,1045
20394,1,1,2306,1392,-914
20395,1,0,0,0,0
20396,1,0,129,0,-129
20397,1,1,468,1300,832
20398,0,0,66,0,-66
20399,1,0,1,0,-1
20400,1,1,741,1967,1226
20401,0,0,26,0,-26
20402,1,1,421,1590,1169
20403,1,0,9,0,-9
20404,1,0,43,0,-43
20405,1,0,0,0,0
20406,1,1,104,1623,1519
20407,0,0,53,0,-53
20408,0,0,1,0,-1
20409,1,1,352,1450,1098
20410,0,0,92,0,-92
20411,1,1,752,1301,549
20412,0,0,9,0,-9
20413,1,1,218,2386,2168
20414,0,0,66,0,-66
20415,1,0,41,0,-41
20416,1,1,799,1311,512
20417,0,0,6,0,-6
20418,1,0,93,0,-93
20419,1,0,111,0,-111
20420,1,0,23,0,-23
20421,1,0,16,0,-16
20422,0,0,123,0,-123
20423,1,0,2,0,-2
20424,0,0,87,0,-87
20425,0,0,108,0,-108
20426,0,0,29,0,-29
20427,0,0,77,0,-77
20428,1,0,53,0,-53
20429,1,0,39,0,-39
20430,1,0,25,0,-25
20431,0,0,72,0,-72
20432,1,0,36,0,-36
20433,0,0,114,0,-114
20434,1,1,936,1322,386
20435,1,0,77,0,-77
20436,1,1,508,1566,1058
20437,1,1,840,1406,566
20438,1,0,68,0,-68
20439,1,1,50,1201,1151
20440,1,1,663,1576,913
20441,0,0,16,0,-16
20442,0,0,32,0,-32
20443,1,1,621,1347,726
20444,1,0,54,0,-54
20445,1,1,123,1315,1192
20446,1,1,1787,1227,-560
20447,1,0,45,0,-45
20448,1,0,103,0,-103
20449,1,1,121,1250,1129
20450,1,1,445,1565,1120
20451,1,1,182,1422,1240
20452,1,0,13,0,-13
20453,1,0,118,0,-118
20454,1,0,2,0,-2
20455,0,0,2,0,-2
20456,0,0,24,0,-24
20457,1,0,11,0,-11
20458,1,0,6,0,-6
20459,1,1,384,1448,1064
20460,1,1,43,1372,1329
20461,0,0,62,0,-62
20462,1,1,119,1205,1086
20463,1,0,3,0,-3
20464,1,0,22,0,-22
20465,1,0,17,0,-17
20466,1,1,339,1815,1476
20467,1,0,36,0,-36
20468,1,0,52,0,-52
20469,1,0,39,0,-39
20470,1,0,2,0,-2
20471,0,0,29,0,-29
20472,1,0,103,0,-103
20473,1,1,1233,1495,262
20474,0,0,11,0,-11
20475,1,0,88,0,-88
20476,1,1,99,1233,1134
20477,1,1,182,1649,1467
20478,0,0,142,0,-142
20479,1,1,75,2102,2027
20480,1,1,651,1855,1204
20481,1,1,98,1293,1195
20482,1,1,352,1344,992
20483,1,0,6,0,-6
20484,1,0,40,0,-40
20485,1,0,10,0,-10
20486,0,0,30,0,-30
20487,1,0,204,0,-204
20488,1,0,17,0,-17
20489,0,0,21,0,-21
20490,1,1,147,1557,1410
20491,1,1,184,1283,1099
20492,1,0,6,0,-6
20493,1,0,4,0,-4
20494,0,0,19,0,-19
20495,0,0,71,0,-71
20496,0,0,91,0,-91
20497,1,0,27,0,-27
20498,1,0,31,0,-31
20499,0,0,105,0,-105
20500,1,0,67,0,-67
20501,1,0,26,0,-26
20502,0,0,8,0,-8
20503,1,0,57,0,-57
20504,1,0,47,0,-47
20505,0,0,35,0,-35
20506,1,1,871,1879,1008
20507,0,0,47,0,-47
20508,0,0,10,0,-10
20509,1,0,32,0,-32
20510,1,0,61,0,-61
20511,0,0,113,0,-113
20512,0,0,2,0,-2
20513,1,0,85,0,-85
20514,0,0,24,0,-24
20515,0,0,13,0,-13
20516,0,0,74,0,-74
20517,0,0,1,0,-1
20518,1,1,897,1284,387
20519,0,0,36,0,-36
20520,1,0,4,0,-4
20521,1,1,110,1270,1160
20522,0,0,58,0,-58
20523,1,1,276,1282,1006
20524,0,0,26,0,-26
20525,1,1,1162,1873,711
20526,0,0,10,0,-10
20527,1,1,407,1235,828
20528,1,0,13,0,-13
20529,0,0,9,0,-9
20530,1,1,199,1323,1124
20531,0,0,42,0,-42
20532,1,1,470,1468,998
20533,1,1,226,1225,999
20534,0,0,109,0,-109
20535,1,0,127,0,-127
20536,1,1,113,1432,1319
20537,1,0,1,0,-1
20538,1,0,14,0,-14
20539,0,0,17,0,-17
20540,1,1,165,2641,2476
20541,1,0,1,0,-1
20542,1,1,81,1649,1568
20543,1,1,338,1273,935
20544,0,0,0,0,0
20545,1,0,16,0,-16
20546,1,1,200,1969,1769
20547,0,0,93,0,-93
20548,1,0,67,0,-67
20549,1,1,421,1361,940
20550,1,0,186,0,-186
20551,1,0,1,0,-1
20552,1,0,58,0,-58
20553,1,1,32,1281,1249
20554,0,0,36,0,-36
20555,1,0,14,0,-14
20556,1,1,56,1580,1524
20557,0,0,63,0,-63
20558,0,0,5,0,-5
20559,1,1,765,1511,746
20560,1,0,11,0,-11
20561,0,0,9,0,-9
20562,0,0,81,0,-81
20563,1,1,262,1274,1012
20564,0,0,10,0,-10
20565,0,0,18,0,-18
20566,0,0,8,0,-8
20567,0,0,12,0,-12
20568,0,0,8,0,-8
20569,1,0,120,0,-120
20570,0,0,102,0,-102
20571,1,1,780,1414,634
20572,1,1,683,1270,587
20573,0,0,12,0,-12
20574,1,0,80,0,-80
20575,1,0,132,0,-132
20576,0,0,38,0,-38
20577,1,1,1415,1247,-168
20578,1,1,280,1327,1047
20579,0,0,56,0,-56
20580,0,0,0,0,0
20581,0,0,19,0,-19
20582,0,0,44,0,-44
20583,1,1,190,1708,1518
20584,0,0,8,0,-8
20585,0,0,22,0,-22
20586,1,0,108,0,-108
20587,0,0,57,0,-57
20588,0,0,264,0,-264
20589,1,1,155,1600,1445
20590,1,0,53,0,-53
20591,1,0,19,0,-19
20592,0,0,10,0,-10
20593,0,0,65,0,-65
20594,0,0,212,0,-212
20595,0,0,34,0,-34
20596,0,0,4,0,-4
20597,0,0,7,0,-7
20598,0,0,114,0,-114
20599,0,0,8,0,-8
20600,1,1,89,1380,1291
20601,1,1,78,1273,1195
20602,1,1,526,1414,888
20603,0,0,56,0,-56
20604,1,1,357,1915,1558
20605,1,1,233,1455,1222
20606,0,0,76,0,-76
20607,1,1,12,1205,1193
20608,1,0,153,0,-153
20609,1,0,20,0,-20
20610,0,0,8,0,-8
20611,0,0,38,0,-38
20612,0,0,32,0,-32
20613,0,0,53,0,-53
20614,1,0,42,0,-42
20615,0,0,5,0,-5
20616,1,0,42,0,-42
20617,1,0,102,0,-102
20618,1,0,16,0,-16
20619,1,1,1399,1435,36
20620,0,0,54,0,-54
20621,0,0,74,0,-74
20622,0,0,21,0,-21
20623,0,0,14,0,-14
20624,0,0,68,0,-68
20625,0,0,3,0,-3
20626,1,0,0,0,0
20627,0,0,47,0,-47
20628,1,0,119,0,-119
20629,1,0,57,0,-57
20630,0,0,41,0,-41
20631,0,0,8,0,-8
20632,1,0,16,0,-16
20633,1,1,37,1800,1763
20634,0,0,173,0,-173
20635,1,0,196,0,-196
20636,0,0,30,0,-30
20637,1,0,78,0,-78
20638,1,1,54,1203,1149
20639,1,1,702,1643,941
20640,1,0,1,0,-1
20641,1,1,926,1329,403
20642,1,1,494,1320,826
20643,0,0,10,0,-10
20644,0,0,84,0,-84
20645,0,0,27,0,-27
20646,1,1,343,1289,946
20647,0,0,9,0,-9
20648,0,0,51,0,-51
20649,0,0,7,0,-7
20650,1,1,468,1263,795
20651,0,0,56,0,-56
20652,1,0,7,0,-7
20653,1,0,71,0,-71
20654,0,0,6,0,-6
20655,0,0,44,0,-44
20656,0,0,31,0,-31
20657,1,1,391,1768,1377
20658,0,0,115,0,-115
20659,1,1,336,1333,997
20660,1,1,1391,1214,-177
20661,1,0,56,0,-56
20662,0,0,90,0,-90
20663,0,0,131,0,-131
20664,1,1,202,1237,1035
20665,0,0,19,0,-19
20666,0,0,6,0,-6
20667,0,0,35,0,-35
20668,0,0,24,0,-24
20669,1,1,467,1392,925
20670,1,1,26,1211,1185
20671,0,0,24,0,-24
20672,0,0,83,0,-83
20673,1,0,4,0,-4
20674,1,1,662,1540,878
20675,1,0,19,0,-19
20676,1,1,231,1265,1034
20677,0,0,9,0,-9
20678,1,0,78,0,-78
20679,1,1,84,3323,3239
20680,1,1,108,2267,2159
20681,1,1,1079,1792,713
20682,1,1,352,1333,981
20683,0,0,3,0,-3
20684,0,0,25,0,-25
20685,1,1,279,2974,2695
20686,1,1,359,1954,1595
20687,1,0,20,0,-20
20688,0,0,16,0,-16
20689,1,1,849,1298,449
20690,1,0,37,0,-37
20691,1,0,111,0,-111
20692,1,0,16,0,-16
20693,1,0,34,0,-34
20694,0,0,5,0,-5
20695,1,0,89,0,-89
20696,1,1,170,1516,1346
20697,1,0,6,0,-6
20698,1,1,272,1672,1400
20699,1,0,46,0,-46
20700,0,0,43,0,-43
20701,0,0,173,0,-173
20702,0,0,13,0,-13
20703,0,0,1,0,-1
20704,0,0,183,0,-183
20705,1,1,35,2187,2152
20706,1,1,134,1820,1686
20707,1,1,286,1316,1030
20708,0,0,66,0,-66
20709,1,1,314,1476,1162
20710,0,0,15,0,-15
20711,1,1,209,1344,1135
20712,0,0,0,0,0
20713,1,0,63,0,-63
20714,0,0,32,0,-32
20715,1,0,41,0,-41
20716,1,0,32,0,-32
20717,1,0,61,0,-61
20718,0,0,20,0,-20
20719,0,0,20,0,-20
20720,0,0,19,0,-19
20721,1,0,5,0,-5
20722,1,0,12,0,-12
20723,1,1,326,1369,1043
20724,1,0,35,0,-35
20725,0,0,9,0,-9
20726,0,0,4,0,-4
20727,1,1,522,1309,787
20728,1,1,504,1463,959
20729,1,0,28,0,-28
20730,1,0,9,0,-9
20731,0,0,0,0,0
20732,0,0,124,0,-124
20733,0,0,38,0,-38
20734,1,1,274,1211,937
20735,1,0,58,0,-58
20736,1,0,179,0,-179
20737,0,0,29,0,-29
20738,1,1,629,1203,574
20739,1,0,99,0,-99
20740,1,0,175,0,-175
20741,1,0,73,0,-73
20742,1,0,77,0,-77
20743,1,0,121,0,-121
20744,0,0,18,0,-18
20745,0,0,17,0,-17
20746,1,1,483,1633,1150
20747,0,0,66,0,-66
20748,1,0,1,0,-1
20749,1,1,180,1637,1457
20750,1,1,368,1424,1056
20751,0,0,15,0,-15
20752,1,0,171,0,-171
20753,1,1,191,1496,1305
20754,1,1,956,1950,994
20755,1,0,57,0,-57
20756,0,0,58,0,-58
20757,0,0,62,0,-62
20758,1,1,123,1272,1149
20759,1,0,8,0,-8
20760,1,1,32,1428,1396
20761,0,0,14,0,-14
20762,1,1,406,2269,1863
20763,0,0,11,0,-11
20764,1,0,45,0,-45
20765,1,1,726,2811,2085
20766,1,0,71,0,-71
20767,1,1,91,1317,1226
20768,1,1,855,1273,418
20769,1,1,104,2355,2251
20770,0,0,35,0,-35
20771,1,1,1362,2534,1172
20772,1,0,115,0,-115
20773,1,0,22,0,-22
20774,0,0,11,0,-11
20775,0,0,71,0,-71
20776,1,1,298,1356,1058
20777,0,0,24,0,-24
20778,0,0,29,0,-29
20779,1,1,205,2214,2009
20780,1,0,81,0,-81
20781,0,0,56,0,-56
20782,1,1,355,1380,1025
20783,0,0,46,0,-46
20784,0,0,23,0,-23
20785,1,0,7,0,-7
20786,1,1,317,2074,1757
20787,0,0,46,0,-46
20788,1,1,2120,1368,-752
20789,0,0,55,0,-55
20790,1,1,369,1495,1126
20791,0,0,5,0,-5
20792,1,0,14,0,-14
20793,0,0,57,0,-57
20794,1,1,1902,2001,99
20795,1,1,332,1825,1493
20796,1,0,272,0,-272
20797,0,0,53,0,-53
20798,1,1,1370,1579,209
20799,0,0,131,0,-131
20800,1,1,40,1705,1665
20801,1,1,661,1626,965
20802,1,1,1758,1249,-509
20803,0,0,15,0,-15
20804,0,0,14,0,-14
20805,0,0,85,0,-85
20806,1,0,18,0,-18
20807,1,0,34,0,-34
20808,1,1,81,1324,1243
20809,0,0,20,0,-20
20810,0,0,28,0,-28
20811,1,0,28,0,-28
20812,0,0,0,0,0
20813,1,1,239,1599,1360
20814,0,0,7,0,-7
20815,1,0,64,0,-64
20816,1,1,104,1287,1183
20817,1,1,101,1221,1120
20818,1,1,218,1804,1586
20819,0,0,116,0,-116
20820,1,0,52,0,-52
20821,1,1,257,1453,1196
20822,0,0,25,0,-25
20823,0,0,63,0,-63
20824,0,0,39,0,-39
20825,1,0,101,0,-101
20826,1,0,152,0,-152
20827,1,0,24,0,-24
20828,1,1,709,1362,653
20829,0,0,60,0,-60
20830,1,0,8,0,-8
20831,0,0,6,0,-6
20832,0,0,16,0,-16
20833,0,0,17,0,-17
20834,0,0,1,0,-1
20835,1,0,123,0,-123
20836,1,0,24,0,-24
20837,0,0,74,0,-74
20838,0,0,15,0,-15
20839,0,0,23,0,-23
20840,1,0,133,0,-133
20841,1,1,140,1329,1189
20842,1,1,130,1497,1367
20843,0,0,11,0,-11
20844,1,0,52,0,-52
20845,1,1,209,1960,1751
20846,1,1,800,1236,436
20847,0,0,46,0,-46
20848,1,1,425,1230,805
20849,1,1,881,1208,327
20850,1,1,134,1246,1112
20851,1,0,58,0,-58
20852,1,1,606,3583,2977
20853,0,0,139,0,-139
20854,1,0,8,0,-8
20855,1,1,131,2038,1907
20856,1,1,249,1233,984
20857,1,1,172,1840,1668
20858,0,0,60,0,-60
20859,1,1,54,1238,1184
20860,1,0,16,0,-16
20861,0,0,17,0,-17
20862,1,0,91,0,-91
20863,1,1,1022,1848,826
20864,1,0,44,0,-44
20865,1,1,55,1690,1635
20866,1,0,11,0,-11
20867,0,0,35,0,-35
20868,0,0,123,0,-123
20869,0,0,14,0,-14
20870,1,0,8,0,-8
20871,1,1,1145,1475,330
20872,0,0,47,0,-47
20873,1,0,50,0,-50
20874,1,0,16,0,-16
20875,0,0,26,0,-26
20876,0,0,35,0,-35
20877,1,1,521,1714,1193
20878,1,1,100,1264,1164
20879,1,1,299,1211,912
20880,0,0,202,0,-202
20881,0,0,31,0,-31
20882,0,0,47,0,-47
20883,0,0,8,0,-8
20884,1,1,584,1353,769
20885,0,0,46,0,-46
20886,1,1,638,2040,1402
20887,1,0,32,0,-32
20888,0,0,13,0,-13
20889,1,1,1144,1364,220
20890,1,1,345,1229,884
20891,1,0,32,0,-32
20892,1,0,7,0,-7
20893,1,0,67,0,-67
20894,0,0,40,0,-40
20895,1,1,169,1334,1165
20896,1,0,147,0,-147
20897,1,1,1576,1445,-131
20898,1,1,217,1200,983
20899,0,0,132,0,-132
20900,0,0,5,0,-5
20901,0,0,13,0,-13
20902,0,0,8,0,-8
20903,1,1,68,2060,1992
20904,1,1,274,2050,1776
20905,1,0,2,0,-2
20906,0,0,55,0,-55
20907,0,0,58,0,-58
20908,0,0,58,0,-58
20909,1,0,2,0,-2
20910,1,1,612,2003,1391
20911,1,0,34,0,-34
20912,1,1,641,1306,665
20913,1,1,648,1770,1122
20914,0,0,17,0,-17
20915,1,0,58,0,-58
20916,1,0,30,0,-30
20917,0,0,25,0,-25
20918,0,0,17,0,-17
20919,0,0,46,0,-46
20920,0,0,89,0,-89
20921,0,0,10,0,-10
20922,1,0,107,0,-107
20923,0,0,42,0,-42
20924,1,1,727,1520,793
20925,1,1,1220,1582,362
20926,0,0,41,0,-41
20927,0,0,52,0,-52
20928,1,0,2,0,-2
20929,0,0,77,0,-77
20930,1,0,19,0,-19
20931,0,0,30,0,-30
20932,1,1,1296,1312,16
20933,1,1,353,1339,986
20934,0,0,31,0,-31
20935,1,1,875,1379,504
20936,1,0,29,0,-29
20937,1,0,38,0,-38
20938,0,0,35,0,-35
20939,1,0,14,0,-14
20940,1,0,13,0,-13
20941,0,0,37,0,-37
20942,1,0,112,0,-112
20943,0,0,22,0,-22
20944,1,1,215,1303,1088
20945,1,0,8,0,-8
20946,0,0,22,0,-22
20947,0,0,147,0,-147
20948,1,0,8,0,-8
20949,1,1,654,1262,608
20950,0,0,30,0,-30
20951,1,1,2099,1552,-547
20952,1,0,7,0,-7
20953,1,1,546,1312,766
20954,0,0,65,0,-65
20955,0,0,2,0,-2
20956,0,0,31,0,-31
20957,0,0,34,0,-34
20958,1,1,110,1253,1143
20959,0,0,20,0,-20
20960,1,1,328,1258,930
20961,1,1,404,1550,1146
20962,0,0,4,0,-4
20963,0,0,96,0,-96
20964,1,0,82,0,-82
20965,1,0,25,0,-25
20966,0,0,80,0,-80
20967,0,0,28,0,-28
20968,1,0,79,0,-79
20969,0,0,64,0,-64
20970,1,0,12,0,-12
20971,1,1,517,2227,1710
20972,1,0,15,0,-15
20973,1,1,153,1524,1371
20974,1,0,144,0,-144
20975,0,0,172,0,-172
20976,1,0,45,0,-45
20977,1,0,58,0,-58
20978,1,0,20,0,-20
20979,0,0,112,0,-112
20980,0,0,17,0,-17
20981,0,0,45,0,-45
20982,0,0,27,0,-27
20983,0,0,12,0,-12
20984,1,1,74,1673,1599
20985,1,1,197,5657,5460
20986,0,0,15,0,-15
20987,1,1,88,1346,1258
20988,0,0,46,0,-46
20989,0,0,28,0,-28
20990,1,0,35,0,-35
20991,0,0,23,0,-23
20992,1,1,10,1248,1238
20993,1,1,1114,1263,149
20994,1,0,61,0,-61
20995,0,0,4,0,-4
20996,1,1,17,1776,1759
20997,1,0,131,0,-131
20998,0,0,22,0,-22
20999,1,1,893,2930,2037
21000,0,0,43,0,-43
21001,1,1,115,1285,1170
21002,1,1,1004,1703,699
21003,0,0,78,0,-78
21004,0,0,0,0,0
21005,1,1,132,1218,1086
21006,1,0,22,0,-22
21007,0,0,61,0,-61
21008,1,1,207,1822,1615
21009,1,1,266,1243,977
21010,1,0,32,0,-32
21011,1,0,2,0,-2
21012,1,1,183,1214,1031
21013,0,0,21,0,-21
21014,1,0,99,0,-99
21015,0,0,13,0,-13
21016,0,0,131,0,-131
21017,0,0,35,0,-35
21018,1,0,19,0,-19
21019,1,0,57,0,-57
21020,1,0,48,0,-48
21021,0,0,33,0,-33
21022,0,0,0,0,0
21023,1,0,58,0,-58
21024,1,0,44,0,-44
21025,1,0,25,0,-25
21026,1,0,17,0,-17
21027,1,0,30,0,-30
21028,0,0,4,0,-4
21029,0,0,56,0,-56
21030,1,0,39,0,-39
21031,1,1,391,1742,1351
21032,1,1,47,2147,2100
21033,1,0,117,0,-117
21034,1,1,724,1327,603
21035,1,0,8,0,-8
21036,1,1,208,1534,1326
21037,1,1,1207,1333,126
21038,0,0,35,0,-35
21039,0,0,48,0,-48
21040,1,1,616,1343,727
21041,1,1,162,1646,1484
21042,0,0,2,0,-2
21043,1,1,507,1267,760
21044,1,1,753,2030,1277
21045,1,1,1238,1440,202
21046,1,0,38,0,-38
21047,0,0,80,0,-80
21048,1,1,53,1279,1226
21049,0,0,49,0,-49
21050,0,0,13,0,-13
21051,1,1,482,2390,1908
21052,0,0,18,0,-18
21053,1,1,950,1454,504
21054,1,0,30,0,-30
21055,1,1,109,1736,1627
21056,1,0,44,0,-44
21057,1,1,330,1565,1235
21058,0,0,64,0,-64
21059,0,0,34,0,-34
21060,0,0,12,0,-12
21061,0,0,8,0,-8
21062,0,0,71,0,-71
21063,1,0,56,0,-56
21064,1,1,131,1730,1599
21065,0,0,25,0,-25
21066,0,0,74,0,-74
21067,1,1,171,1551,1380
21068,1,0,83,0,-83
21069,1,1,198,1252,1054
21070,1,1,787,1241,454
21071,0,0,0,0,0
21072,1,0,7,0,-7
21073,0,0,2,0,-2
21074,1,1,140,1227,1087
21075,1,0,79,0,-79
21076,1,1,501,1862,1361
21077,0,0,37,0,-37
21078,1,0,111,0,-111
21079,1,1,139,1493,1354
21080,1,0,133,0,-133
21081,0,0,38,0,-38
21082,0,0,60,0,-60
21083,1,0,59,0,-59
21084,1,1,953,3727,2774
21085,0,0,27,0,-27
21086,0,0,54,0,-54
21087,1,0,12,0,-12
21088,0,0,79,0,-79
21089,1,0,16,0,-16
21090,0,0,124,0,-124
21091,0,0,109,0,-109
21092,1,1,1004,1281,277
21093,1,0,2,0,-2
21094,1,0,41,0,-41
21095,1,1,1313,1508,195
21096,1,1,1016,2479,1463
21097,1,0,110,0,-110
21098,1,1,340,1200,860
21099,1,0,13,0,-13
21100,0,0,4,0,-4
21101,1,0,28,0,-28
21102,0,0,2,0,-2
21103,1,1,531,1899,1368
21104,1,0,25,0,-25
21105,0,0,89,0,-89
21106,0,0,170,0,-170
21107,0,0,38,0,-38
21108,1,1,20,2004,1984
21109,1,0,32,0,-32
21110,1,1,268,1960,1692
21111,1,0,33,0,-33
21112,0,0,127,0,-127
21113,1,1,1770,1438,-332
21114,1,1,707,1695,988
21115,0,0,40,0,-40
21116,1,1,280,1206,926
21117,0,0,9,0,-9
21118,0,0,24,0,-24
21119,1,0,16,0,-16
21120,1,0,152,0,-152
21121,1,0,4,0,-4
21122,1,0,86,0,-86
21123,0,0,31,0,-31
21124,1,0,29,0,-29
21125,1,0,55,0,-55
21126,1,0,6,0,-6
21127,0,0,30,0,-30
21128,1,1,79,1912,1833
21129,1,1,881,1366,485
21130,1,1,354,1404,1050
21131,1,1,64,1739,1675
21132,0,0,9,0,-9
21133,0,0,32,0,-32
21134,1,0,3,0,-3
21135,1,1,421,1539,1118
21136,1,0,15,0,-15
21137,0,0,245,0,-245
21138,1,1,660,1269,609
21139,0,0,8,0,-8
21140,1,1,393,1875,1482
21141,0,0,14,0,-14
21142,1,0,5,0,-5
21143,1,1,339,2224,1885
21144,1,0,53,0,-53
21145,1,0,158,0,-158
21146,1,0,256,0,-256
21147,1,0,61,0,-61
21148,0,0,57,0,-57
21149,1,0,26,0,-26
21150,1,0,22,0,-22
21151,0,0,24,0,-24
21152,0,0,54,0,-54
21153,1,1,896,1306,410
21154,1,1,1453,1770,317
21155,1,0,91,0,-91
21156,1,1,57,1476,1419
21157,0,0,10,0,-10
21158,1,0,54,0,-54
21159,0,0,81,0,-81
21160,1,0,362,0,-362
21161,1,1,673,2755,2082
21162,0,0,116,0,-116
21163,0,0,32,0,-32
21164,1,0,26,0,-26
21165,0,0,14,0,-14
21166,1,0,7,0,-7
21167,0,0,29,0,-29
21168,1,1,765,1244,479
21169,0,0,28,0,-28
21170,1,0,0,0,0
21171,0,0,44,0,-44
21172,1,1,470,1276,806
21173,1,0,23,0,-23
21174,0,0,73,0,-73
21175,0,0,14,0,-14
21176,1,0,38,0,-38
21177,1,0,72,0,-72
21178,1,1,927,1341,414
21179,1,0,15,0,-15
21180,1,1,543,1257,714
21181,0,0,128,0,-128
21182,1,1,162,1961,1799
21183,1,0,2,0,-2
21184,0,0,120,0,-120
21185,0,0,104,0,-104
21186,0,0,1,0,-1
21187,0,0,48,0,-48
21188,1,0,3,0,-3
21189,0,0,16,0,-16
21190,1,1,253,1324,1071
21191,1,0,27,0,-27
21192,0,0,86,0,-86
21193,0,0,17,0,-17
21194,1,0,35,0,-35
21195,1,0,6,0,-6
21196,1,0,138,0,-138
21197,1,0,28,0,-28
21198,0,0,1,0,-1
21199,0,0,6,0,-6
21200,0,0,51,0,-51
21201,1,1,300,1391,1091
21202,1,0,14,0,-14
21203,0,0,43,0,-43
21204,0,0,20,0,-20
21205,0,0,103,0,-103
21206,0,0,47,0,-47
21207,0,0,90,0,-90
21208,0,0,81,0,-81
21209,1,1,964,1259,295
21210,0,0,4,0,-4
21211,1,1,182,3969,3787
21212,1,1,234,1286,1052
21213,0,0,55,0,-55
21214,1,1,681,1513,832
21215,0,0,29,0,-29
21216,1,0,4,0,-4
21217,0,0,49,0,-49
21218,0,0,125,0,-125
21219,1,0,200,0,-200
21220,1,0,66,0,-66
21221,0,0,10,0,-10
21222,0,0,7,0,-7
21223,0,0,157,0,-157
21224,1,0,202,0,-202
21225,1,0,14,0,-14
21226,0,0,140,0,-140
21227,1,0,80,0,-80
21228,0,0,26,0,-26
21229,1,1,149,1488,1339
21230,1,1,420,1250,830
21231,1,1,512,1320,808
21232,0,0,44,0,-44
21233,1,1,662,1538,876
21234,0,0,4,0,-4
21235,1,0,8,0,-8
21236,1,0,17,0,-17
21237,1,1,81,1408,1327
21238,1,1,191,2662,2471
21239,0,0,70,0,-70
21240,0,0,82,0,-82
21241,1,0,55,0,-55
21242,1,1,153,1531,1378
21243,1,1,1093,1371,278
21244,1,1,180,1387,1207
21245,1,1,162,1452,1290
21246,1,1,1051,1570,519
21247,0,0,33,0,-33
21248,1,1,428,1210,782
21249,1,0,160,0,-160
21250,0,0,36,0,-36
21251,1,1,173,1393,1220
21252,0,0,52,0,-52
21253,1,0,64,0,-64
21254,1,1,645,1439,794
21255,0,0,82,0,-82
21256,0,0,65,0,-65
21257,1,0,150,0,-150
21258,0,0,30,0,-30
21259,0,0,20,0,-20
21260,0,0,265,0,-265
21261,1,1,142,1254,1112
21262,1,0,15,0,-15
21263,1,1,1803,1530,-273
21264,0,0,152,0,-152
21265,1,0,118,0,-118
21266,1,1,617,2479,1862
21267,1,1,14,1622,1608
21268,0,0,200,0,-200
21269,1,0,39,0,-39
21270,1,1,2508,1947,-561
21271,1,1,736,1260,524
21272,1,0,8,0,-8
21273,1,1,645,1466,821
21274,1,0,23,0,-23
21275,1,1,445,1225,780
21276,1,0,44,0,-44
21277,0,0,13,0,-13
21278,1,0,114,0,-114
21279,0,0,19,0,-19
21280,0,0,96,0,-96
21281,0,0,14,0,-14
21282,0,0,5,0,-5
21283,1,0,88,0,-88
21284,1,0,1,0,-1
21285,0,0,69,0,-69
21286,1,1,593,2018,1425
21287,0,0,66,0,-66
21288,1,1,679,1861,1182
21289,0,0,5,0,-5
21290,0,0,36,0,-36
21291,0,0,170,0,-170
21292,0,0,38,0,-38
21293,1,0,45,0,-45
21294,0,0,104,0,-104
21295,1,1,493,1379,886
21296,1,1,128,1206,1078
21297,1,1,646,2535,1889
21298,1,1,1127,1356,229
21299,0,0,77,0,-77
21300,0,0,41,0,-41
21301,1,0,93,0,-93
21302,0,0,26,0,-26
21303,0,0,61,0,-61
21304,1,0,12,0,-12
21305,0,0,19,0,-19
21306,0,0,89,0,-89
21307,0,0,7,0,-7
21308,0,0,158,0,-158
21309,0,0,175,0,-175
21310,1,0,144,0,-144
21311,0,0,51,0,-51
21312,1,0,33,0,-33
21313,1,0,6,0,-6
21314,0,0,25,0,-25
21315,1,0,34,0,-34
21316,1,1,635,1249,614
21317,1,0,11,0,-11
21318,0,0,117,0,-117
21319,0,0,4,0,-4
21320,1,0,76,0,-76
21321,1,0,33,0,-33
21322,1,0,1,0,-1
21323,0,0,7,0,-7
21324,1,1,1012,1271,259
21325,0,0,0,0,0
21326,1,0,11,0,-11
21327,1,1,698,1252,554
21328,0,0,221,0,-221
21329,0,0,53,0,-53
21330,0,0,18,0,-18
21331,1,1,803,1394,591
21332,1,1,1563,1225,-338
21333,1,0,21,0,-21
21334,0,0,5,0,-5
21335,1,0,28,0,-28
21336,0,0,52,0,-52
21337,1,1,1229,1538,309
21338,1,1,1048,1316,268
21339,1,0,13,0,-13
21340,0,0,21,0,-21
21341,1,0,9,0,-9
21342,1,0,61,0,-61
21343,1,0,4,0,-4
21344,0,0,3,0,-3
21345,1,0,29,0,-29
21346,0,0,263,0,-263
21347,0,0,2,0,-2
21348,1,0,133,0,-133
21349,0,0,28,0,-28
21350,1,1,710,1596,886
21351,0,0,32,0,-32
21352,1,1,120,2517,2397
21353,1,1,141,1436,1295
21354,1,1,280,1549,1269
21355,1,0,18,0,-18
21356,1,0,41,0,-41
21357,1,1,1009,1211,202
21358,1,1,341,1205,864
21359,0,0,72,0,-72
21360,1,1,900,1777,877
21361,1,0,6,0,-6
21362,0,0,34,0,-34
21363,1,1,211,2495,2284
21364,1,0,24,0,-24
21365,0,0,144,0,-144
21366,0,0,151,0,-151
21367,1,1,96,1202,1106
21368,1,0,37,0,-37
21369,1,0,95,0,-95
21370,1,0,74,0,-74
21371,1,0,20,0,-20
21372,0,0,62,0,-62
21373,1,0,118,0,-118
21374,1,0,3,0,-3
21375,0,0,21,0,-21
21376,0,0,66,0,-66
21377,0,0,21,0,-21
21378,1,0,7,0,-7
21379,1,0,143,0,-143
21380,0,0,32,0,-32
21381,1,0,92,0,-92
21382,1,1,426,1252,826
21383,1,1,697,1220,523
21384,1,0,8,0,-8
21385,0,0,9,0,-9
21386,1,0,187,0,-187
21387,0,0,27,0,-27
21388,1,0,3,0,-3
21389,1,1,308,1463,1155
21390,1,0,27,0,-27
21391,0,0,244,0,-244
21392,1,1,987,1785,798
21393,0,0,9,0,-9
21394,0,0,48,0,-48
21395,1,0,41,0,-41
21396,0,0,79,0,-79
21397,1,1,295,1405,1110
21398,1,0,151,0,-151
21399,0,0,96,0,-96
21400,1,0,41,0,-41
21401,1,1,486,1261,775
21402,0,0,40,0,-40
21403,1,1,487,1457,970
21404,0,0,11,0,-11
21405,1,1,664,1312,648
21406,1,0,49,0,-49
21407,0,0,9,0,-9
21408,1,0,31,0,-31
21409,0,0,38,0,-38
21410,0,0,12,0,-12
21411,1,1,227,1398,1171
21412,0,0,90,0,-90
21413,0,0,85,0,-85
21414,1,0,18,0,-18
21415,1,1,170,1313,1143
21416,1,0,248,0,-248
21417,1,0,68,0,-68
21418,1,0,36,0,-36
21419,0,0,19,0,-19
21420,0,0,59,0,-59
21421,1,1,118,1300,1182
21422,0,0,3,0,-3
21423,1,0,36,0,-36
21424,1,1,59,1324,1265
21425,1,1,144,1383,1239
21426,1,1,88,1332,1244
21427,0,0,24,0,-24
21428,1,0,130,0,-130
21429,1,0,15,0,-15
21430,1,1,218,1729,1511
21431,1,1,298,1929,1631
21432,1,0,15,0,-15
21433,1,0,15,0,-15
21434,0,0,41,0,-41
21435,1,1,254,1235,981
21436,0,0,85,0,-85
21437,0,0,27,0,-27
21438,0,0,68,0,-68
21439,1,0,25,0,-25
21440,0,0,92,0,-92
21441,0,0,17,0,-17
21442,1,0,32,0,-32
21443,1,0,29,0,-29
21444,1,1,74,2100,2026
21445,1,1,1968,1342,-626
21446,1,0,21,0,-21
21447,1,0,30,0,-30
21448,0,0,1,0,-1
21449,0,0,5,0,-5
21450,0,0,86,0,-86
21451,0,0,52,0,-52
21452,1,0,63,0,-63
21453,0,0,225,0,-225
21454,1,0,104,0,-104
21455,1,1,253,2067,1814
21456,1,0,13,0,-13
21457,1,0,79,0,-79
21458,1,1,308,1570,1262
21459,0,0,51,0,-51
21460,0,0,76,0,-76
21461,1,0,5,0,-5
21462,0,0,171,0,-171
21463,1,1,273,1327,1054
21464,1,1,546,1256,710
21465,0,0,55,0,-55
21466,1,1,237,1276,1039
21467,0,0,43,0,-43
21468,1,1,191,2017,1826
21469,1,0,148,0,-148
21470,1,1,560,1266,706
21471,1,0,39,0,-39
21472,0,0,49,0,-49
21473,1,1,685,1496,811
21474,1,1,102,1582,1480
21475,1,0,36,0,-36
21476,0,0,37,0,-37
21477,0,0,159,0,-159
21478,1,1,340,1307,967
21479,1,1,562,1553,991
21480,0,0,20,0,-20
21481,0,0,29,0,-29
21482,1,0,111,0,-111
21483,1,0,136,0,-136
21484,1,1,1890,1228,-662
21485,1,0,16,0,-16
21486,1,0,43,0,-43
21487,1,0,121,0,-121
21488,1,1,377,1206,829
21489,0,0,5,0,-5
21490,0,0,4,0,-4
21491,1,1,367,1471,1104
21492,1,0,2,0,-2
21493,0,0,5,0,-5
21494,1,1,2117,1862,-255
21495,1,1,837,1320,483
21496,1,0,30,0,-30
21497,0,0,1,0,-1
21498,1,1,521,1704,1183
21499,1,0,51,0,-51
21500,0,0,22,0,-22
21501,1,1,71,1498,1427
21502,1,0,26,0,-26
21503,1,1,547,1536,989
21504,1,1,435,1846,1411
21505,0,0,31,0,-31
21506,1,0,22,0,-22
21507,0,0,99,0,-99
21508,1,1,485,1286,801
21509,0,0,8,0,-8
21510,0,0,46,0,-46
21511,1,0,3,0,-3
21512,1,0,1,0,-1
21513,1,0,25,0,-25
21514,0,0,50,0,-50
21515,0,0,38,0,-38
21516,0,0,5,0,-5
21517,1,0,3,0,-3
21518,1,1,405,1220,815
21519,1,1,255,2778,2523
21520,1,1,513,1511,998
21521,0,0,28,0,-28
21522,1,0,119,0,-119
21523,0,0,9,0,-9
21524,1,0,46,0,-46
21525,1,0,1,0,-1
21526,1,0,54,0,-54
21527,1,0,12,0,-12
21528,0,0,56,0,-56
21529,1,1,252,2548,2296
21530,1,0,88,0,-88
21531,0,0,26,0,-26
21532,0,0,245,0,-245
21533,0,0,67,0,-67
21534,1,1,345,1594,1249
21535,1,0,36,0,-36
21536,0,0,34,0,-34
21537,0,0,69,0,-69
21538,0,0,143,0,-143
21539,1,1,179,1239,1060
21540,0,0,13,0,-13
21541,1,0,29,0,-29
21542,1,1,453,1452,999
21543,0,0,5,0,-5
21544,1,0,26,0,-26
21545,1,0,7,0,-7
21546,0,0,145,0,-145
21547,0,0,188,0,-188
21548,1,0,42,0,-42
21549,0,0,1,0,-1
21550,0,0,28,0,-28
21551,0,0,52,0,-52
21552,1,1,58,1242,1184
21553,1,0,44,0,-44
21554,1,1,1268,2053,785
21555,1,1,381,1323,942
21556,0,0,39,0,-39
21557,1,1,276,1554,1278
21558,0,0,0,0,0
21559,1,0,17,0,-17
21560,0,0,50,0,-50
21561,1,0,53,0,-53
21562,0,0,17,0,-17
21563,0,0,112,0,-112
21564,0,0,44,0,-44
21565,0,0,67,0,-67
21566,0,0,23,0,-23
21567,0,0,32,0,-32
21568,1,0,1,0,-1
21569,1,0,27,0,-27
21570,1,1,310,1840,1530
21571,1,1,315,1253,938
21572,0,0,42,0,-42
21573,1,1,476,1257,781
21574,1,1,898,2157,1259
21575,1,0,254,0,-254
21576,0,0,31,0,-31
21577,1,0,47,0,-47
21578,1,0,19,0,-19
21579,0,0,7,0,-7
21580,1,0,202,0,-202
21581,0,0,105,0,-105
21582,0,0,12,0,-12
21583,1,0,27,0,-27
21584,1,1,1187,1470,283
21585,1,0,15,0,-15
21586,1,0,7,0,-7
21587,1,0,0,0,0
21588,1,1,612,1621,1009
21589,0,0,42,0,-42
21590,1,0,59,0,-59
21591,1,0,69,0,-69
21592,1,1,150,1438,1288
21593,1,1,99,2315,2216
21594,0,0,82,0,-82
21595,1,1,211,1581,1370
21596,1,1,526,1377,851
21597,1,0,6,0,-6
21598,0,0,20,0,-20
21599,1,1,1528,1571,43
21600,1,1,641,1586,945
21601,1,0,18,0,-18
21602,1,1,474,1611,1137
21603,0,0,122,0,-122
21604,1,1,470,1768,1298
21605,1,1,151,1472,1321
21606,1,1,914,1795,881
21607,1,1,843,1207,364
21608,1,0,31,0,-31
21609,1,0,26,0,-26
21610,0,0,23,0,-23
21611,0,0,14,0,-14
21612,1,1,466,1547,1081
21613,1,1,934,1300,366
21614,0,0,1,0,-1
21615,1,0,9,0,-9
21616,1,1,1312,1511,199
21617,1,0,16,0,-16
21618,1,0,19,0,-19
21619,1,0,39,0,-39
21620,1,1,1273,1204,-69
21621,0,0,64,0,-64
21622,0,0,53,0,-53
21623,1,1,93,1782,1689
21624,1,1,2128,1367,-761
21625,0,0,102,0,-102
21626,1,1,366,1545,1179
21627,1,0,136,0,-136
21628,1,1,139,1724,1585
21629,1,1,24,2408,2384
21630,0,0,48,0,-48
21631,1,0,17,0,-17
21632,0,0,33,0,-33
21633,0,0,16,0,-16
21634,1,1,396,1310,914
21635,1,1,324,1384,1060
21636,0,0,18,0,-18
21637,0,0,124,0,-124
21638,1,0,19,0,-19
21639,1,1,33,4336,4303
21640,1,0,43,0,-43
21641,0,0,309,0,-309
21642,1,1,128,1201,1073
21643,1,0,5,0,-5
21644,0,0,16,0,-16
21645,0,0,183,0,-183
21646,1,0,77,0,-77
21647,0,0,90,0,-90
21648,0,0,12,0,-12
21649,0,0,65,0,-65
21650,1,0,50,0,-50
21651,1,1,699,1250,551
21652,1,0,92,0,-92
21653,0,0,50,0,-50
21654,0,0,189,0,-189
21655,0,0,13,0,-13
21656,1,1,96,1229,1133
21657,1,0,59,0,-59
21658,0,0,198,0,-198
21659,1,0,85,0,-85
21660,1,0,68,0,-68
21661,1,1,667,1435,768
21662,0,0,0,0,0
21663,1,0,22,0,-22
21664,1,0,74,0,-74
21665,0,0,32,0,-32
21666,0,0,165,0,-165
21667,1,1,1051,2032,981
21668,0,0,29,0,-29
21669,1,0,31,0,-31
21670,1,0,0,0,0
21671,0,0,185,0,-185
21672,0,0,93,0,-93
21673,0,0,127,0,-127
21674,0,0,20,0,-20
21675,1,1,957,1238,281
21676,0,0,5,0,-5
21677,0,0,65,0,-65
21678,1,1,760,1364,604
21679,0,0,50,0,-50
21680,1,0,124,0,-124
21681,1,0,42,0,-42
21682,1,0,129,0,-129
21683,0,0,6,0,-6
21684,0,0,129,0,-129
21685,1,1,446,1252,806
21686,0,0,21,0,-21
21687,1,1,844,1214,370
21688,1,1,67,1367,1300
21689,1,1,493,1958,1465
21690,1,0,26,0,-26
21691,1,0,40,0,-40
21692,1,1,422,1482,1060
21693,1,1,792,2596,1804
21694,0,0,2,0,-2
21695,1,0,12,0,-12
21696,0,0,34,0,-34
21697,1,0,30,0,-30
21698,1,0,60,0,-60
21699,1,0,20,0,-20
21700,1,0,156,0,-156
21701,0,0,105,0,-105
21702,0,0,67,0,-67
21703,0,0,44,0,-44
21704,1,1,415,1202,787
21705,0,0,26,0,-26
21706,1,1,397,1673,1276
21707,0,0,1,0,-1
21708,0,0,73,0,-73
21709,1,1,3331,1563,-1768
21710,1,0,43,0,-43
21711,0,0,51,0,-51
21712,0,0,39,0,-39
21713,1,1,345,1735,1390
21714,1,0,61,0,-61
21715,1,0,52,0,-52
21716,0,0,14,0,-14
21717,0,0,52,0,-52
21718,1,0,31,0,-31
21719,0,0,38,0,-38
21720,1,1,1048,1370,322
21721,1,0,2,0,-2
21722,1,1,237,1392,1155
21723,1,1,651,1388,737
21724,1,0,137,0,-137
21725,1,1,162,1281,1119
21726,0,0,6,0,-6
21727,0,0,66,0,-66
21728,1,1,979,2105,1126
21729,0,0,22,0,-22
21730,1,1,386,1349,963
21731,1,0,6,0,-6
21732,0,0,118,0,-118
21733,1,1,995,1211,216
21734,1,0,3,0,-3
21735,0,0,59,0,-59
21736,0,0,106,0,-106
21737,1,0,97,0,-97
21738,1,1,970,1235,265
21739,1,1,1101,1586,485
21740,1,1,455,1245,790
21741,1,1,658,2744,2086
21742,1,1,673,1432,759
21743,1,1,963,2010,1047
21744,1,0,62,0,-62
21745,0,0,152,0,-152
21746,1,0,0,0,0
21747,1,1,72,1219,1147
21748,1,0,19,0,-19
21749,0,0,0,0,0
21750,1,0,17,0,-17
21751,1,0,11,0,-11
21752,1,0,55,0,-55
21753,1,0,81,0,-81
21754,1,1,502,1349,847
21755,0,0,123,0,-123
21756,1,1,214,1556,1342
21757,1,0,15,0,-15
21758,1,1,172,1785,1613
21759,0,0,21,0,-21
21760,1,0,11,0,-11
21761,1,1,94,1219,1125
21762,0,0,28,0,-28
21763,1,0,46,0,-46
21764,1,0,67,0,-67
21765,1,0,7,0,-7
21766,1,1,555,1590,1035
21767,1,1,1818,1217,-601
21768,1,0,1,0,-1
21769,0,0,32,0,-32
21770,1,0,68,0,-68
21771,0,0,33,0,-33
21772,0,0,36,0,-36
21773,1,1,190,2785,2595
21774,0,0,44,0,-44
21775,0,0,26,0,-26
21776,1,0,17,0,-17
21777,1,0,68,0,-68
21778,1,0,7,0,-7
21779,0,0,90,0,-90
21780,1,1,688,1449,761
21781,0,0,35,0,-35
21782,1,1,113,1241,1128
21783,1,1,542,2224,1682
21784,1,1,1010,1482,472
21785,1,1,492,2015,1523
21786,0,0,26,0,-26
21787,0,0,5,0,-5
21788,0,0,88,0,-88
21789,1,1,432,1297,865
21790,1,0,9,0,-9
21791,1,0,12,0,-12
21792,1,0,12,0,-12
21793,1,1,180,1686,1506
21794,1,0,47,0,-47
21795,1,0,6,0,-6
21796,1,1,399,1427,1028
21797,1,0,5,0,-5
21798,0,0,36,0,-36
21799,1,0,58,0,-58
21800,0,0,4,0,-4
21801,1,0,19,0,-19
21802,0,0,25,0,-25
21803,0,0,28,0,-28
21804,1,0,3,0,-3
21805,1,1,145,1310,1165
21806,0,0,38,0,-38
21807,1,0,30,0,-30
21808,1,1,216,1242,1026
21809,0,0,81,0,-81
21810,1,1,554,1215,661
21811,0,0,26,0,-26
21812,1,1,840,1768,928
21813,1,0,52,0,-52
21814,1,1,1024,3793,2769
21815,1,1,200,1340,1140
21816,1,1,316,1340,1024
21817,1,1,191,1627,1436
21818,0,0,13,0,-13
21819,1,1,75,1378,1303
21820,1,1,241,1274,1033
21821,0,0,26,0,-26
21822,1,0,11,0,-11
21823,1,0,1,0,-1
21824,1,1,780,1260,480
21825,1,0,199,0,-199
21826,0,0,79,0,-79
21827,1,0,21,0,-21
21828,1,1,232,1410,1178
21829,1,1,194,2364,2170
21830,1,1,178,1205,1027
21831,0,0,50,0,-50
21832,0,0,12,0,-12
21833,1,1,277,1371,1094
21834,1,0,8,0,-8
21835,1,0,54,0,-54
21836,0,0,98,0,-98
21837,0,0,208,0,-208
21838,0,0,2,0,-2
21839,1,1,425,1235,810
21840,0,0,57,0,-57
21841,0,0,95,0,-95
21842,1,1,260,6516,6256
21843,0,0,93,0,-93
21844,1,0,48,0,-48
21845,1,1,1173,1243,70
21846,1,0,59,0,-59
21847,1,1,136,1213,1077
21848,0,0,84,0,-84
21849,1,0,11,0,-11
21850,1,1,697,1741,1044
21851,1,1,1058,1512,454
21852,0,0,4,0,-4
21853,0,0,35,0,-35
21854,1,0,59,0,-59
21855,0,0,16,0,-16
21856,1,1,387,1464,1077
21857,1,0,107,0,-107
21858,1,1,568,1731,1163
21859,0,0,29,0,-29
21860,0,0,6,0,-6
21861,0,0,6,0,-6
21862,1,0,119,0,-119
21863,1,0,38,0,-38
21864,1,0,4,0,-4
21865,1,1,268,1397,1129
21866,1,1,1590,1641,51
21867,1,0,2,0,-2
21868,0,0,6,0,-6
21869,1,1,80,1699,1619
21870,1,1,767,1396,629
21871,1,0,30,0,-30
21872,1,0,31,0,-31
21873,0,0,99,0,-99
21874,1,0,0,0,0
21875,1,1,766,1224,458
21876,1,1,136,1300,1164
21877,0,0,39,0,-39
21878,1,0,57,0,-57
21879,0,0,14,0,-14
21880,1,0,15,0,-15
21881,1,0,119,0,-119
21882,1,0,12,0,-12
21883,1,1,149,1768,1619
21884,0,0,30,0,-30
21885,1,0,11,0,-11
21886,0,0,85,0,-85
21887,0,0,84,0,-84
21888,0,0,10,0,-10
21889,1,1,1050,1374,324
21890,1,0,43,0,-43
21891,1,1,955,1341,386
21892,0,0,27,0,-27
21893,1,0,6,0,-6
21894,1,1,1014,1242,228
21895,1,1,637,1262,625
21896,1,0,100,0,-100
21897,1,1,531,2097,1566
21898,0,0,27,0,-27
21899,0,0,16,0,-16
21900,1,0,21,0,-21
21901,1,1,267,2434,2167
21902,0,0,3,0,-3
21903,1,1,446,2593,2147
21904,1,1,1982,1343,-639
21905,1,1,652,1239,587
21906,1,1,615,1258,643
21907,0,0,169,0,-169
21908,1,0,29,0,-29
21909,0,0,20,0,-20
21910,1,0,11,0,-11
21911,0,0,71,0,-71
21912,0,0,49,0,-49
21913,0,0,67,0,-67
21914,1,1,99,1328,1229
21915,1,1,516,2057,1541
21916,1,1,914,1560,646
21917,0,0,23,0,-23
21918,1,0,84,0,-84
21919,1,0,211,0,-211
21920,1,0,82,0,-82
21921,1,0,105,0,-105
21922,1,0,64,0,-64
21923,1,0,34,0,-34
21924,1,0,46,0,-46
21925,1,0,7,0,-7
21926,1,0,116,0,-116
21927,0,0,11,0,-11
21928,0,0,54,0,-54
21929,1,0,62,0,-62
21930,1,0,7,0,-7
21931,1,0,7,0,-7
21932,0,0,22,0,-22
21933,0,0,113,0,-113
21934,1,1,113,1252,1139
21935,0,0,7,0,-7
21936,1,1,184,1241,1057
21937,1,1,1139,1416,277
21938,0,0,11,0,-11
21939,1,1,186,1212,1026
21940,0,0,15,0,-15
21941,0,0,128,0,-128
21942,1,1,126,1328,1202
21943,0,0,22,0,-22
21944,0,0,152,0,-152
21945,0,0,7,0,-7
21946,1,0,56,0,-56
21947,0,0,17,0,-17
21948,0,0,47,0,-47
21949,1,0,70,0,-70
21950,0,0,96,0,-96
21951,0,0,44,0,-44
21952,0,0,57,0,-57
21953,0,0,20,0,-20
21954,0,0,14,0,-14
21955,0,0,46,0,-46
21956,1,0,109,0,-109
21957,1,1,1373,1827,454
21958,1,0,41,0,-41
21959,1,0,79,0,-79
21960,0,0,13,0,-13
21961,1,0,55,0,-55
21962,1,0,28,0,-28
21963,0,0,7,0,-7
21964,0,0,69,0,-69
21965,1,1,217,1814,1597
21966,1,1,1257,1260,3
21967,0,0,39,0,-39
21968,1,0,15,0,-15
21969,0,0,6,0,-6
21970,1,0,107,0,-107
21971,1,1,639,1573,934
21972,0,0,8,0,-8
21973,1,0,14,0,-14
21974,1,1,754,1571,817
21975,0,0,72,0,-72
21976,0,0,35,0,-35
21977,0,0,50,0,-50
21978,1,1,441,1329,888
21979,0,0,20,0,-20
21980,1,1,1618,1787,169
21981,1,0,131,0,-131
21982,0,0,186,0,-186
21983,1,0,9,0,-9
21984,1,1,106,2989,2883
21985,1,1,342,1241,899
21986,1,1,1148,1233,85
21987,0,0,0,0,0
21988,0,0,12,0,-12
21989,1,0,6,0,-6
21990,1,0,51,0,-51
21991,0,0,9,0,-9
21992,1,0,11,0,-11
21993,0,0,5,0,-5
21994,1,1,1548,1391,-157
21995,0,0,103,0,-103
21996,0,0,5,0,-5
21997,0,0,24,0,-24
21998,0,0,11,0,-11
21999,1,1,77,2254,2177
22000,1,0,33,0,-33
22001,0,0,49,0,-49
22002,0,0,24,0,-24
22003,1,1,320,2614,2294
22004,1,1,466,1362,896
22005,1,0,104,0,-104
22006,0,0,185,0,-185
22007,0,0,120,0,-120
22008,1,1,469,1540,1071
22009,1,1,473,1787,1314
22010,0,0,12,0,-12
22011,0,0,150,0,-150
22012,1,0,36,0,-36
22013,1,1,918,1214,296
22014,0,0,22,0,-22
22015,0,0,290,0,-290
22016,1,0,17,0,-17
22017,1,0,67,0,-67
22018,1,1,174,1479,1305
22019,0,0,2,0,-2
22020,0,0,29,0,-29
22021,1,1,479,1245,766
22022,1,0,93,0,-93
22023,1,1,766,3144,2378
22024,0,0,54,0,-54
22025,1,0,38,0,-38
22026,1,1,343,1913,1570
22027,1,1,1419,1874,455
22028,1,1,860,4049,3189
22029,0,0,84,0,-84
22030,0,0,121,0,-121
22031,0,0,173,0,-173
22032,1,0,40,0,-40
22033,0,0,24,0,-24
22034,0,0,123,0,-123
22035,1,0,69,0,-69
22036,1,0,10,0,-10
22037,1,1,1221,1323,102
22038,1,1,225,1471,1246
22039,0,0,6,0,-6
22040,1,0,115,0,-115
22041,0,0,0,0,0
22042,0,0,22,0,-22
22043,0,0,7,0,-7
22044,0,0,151,0,-151
22045,0,0,47,0,-47
22046,1,1,508,4380,3872
22047,0,0,2,0,-2
22048,1,0,12,0,-12
22049,1,0,37,0,-37
22050,1,0,15,0,-15
22051,1,0,23,0,-23
22052,1,1,619,1336,717
22053,1,0,20,0,-20
22054,0,0,62,0,-62
22055,1,1,2358,1258,-1100
22056,0,0,33,0,-33
22057,1,1,338,1584,1246
22058,1,0,57,0,-57
22059,1,1,69,1213,1144
22060,0,0,119,0,-119
22061,1,1,148,1433,1285
22062,0,0,107,0,-107
22063,1,1,55,1232,1177
22064,1,1,574,1278,704
22065,1,0,84,0,-84
22066,1,1,1223,2252,1029
22067,0,0,0,0,0
22068,1,0,121,0,-121
22069,1,0,58,0,-58
22070,0,0,61,0,-61
22071,0,0,27,0,-27
22072,1,0,76,0,-76
22073,1,1,510,1464,954
22074,1,1,733,1706,973
22075,1,0,15,0,-15
22076,1,0,57,0,-57
22077,1,1,149,1249,1100
22078,1,1,488,1592,1104
22079,0,0,14,0,-14
22080,1,1,1397,1200,-197
22081,0,0,62,0,-62
22082,0,0,8,0,-8
22083,0,0,86,0,-86
22084,1,1,2690,1810,-880
22085,0,0,68,0,-68
22086,1,0,14,0,-14
22087,0,0,31,0,-31
22088,1,0,108,0,-108
22089,1,0,152,0,-152
22090,1,1,367,1271,904
22091,0,0,18,0,-18
22092,1,0,21,0,-21
22093,0,0,20,0,-20
22094,1,1,436,1267,831
22095,0,0,24,0,-24
22096,1,1,51,1366,1315
22097,1,0,22,0,-22
22098,1,1,1241,1262,21
22099,0,0,16,0,-16
22100,0,0,66,0,-66
22101,0,0,47,0,-47
22102,0,0,31,0,-31
22103,0,0,75,0,-75
22104,1,0,9,0,-9
22105,1,0,13,0,-13
22106,1,1,1836,1325,-511
22107,1,0,153,0,-153
22108,1,1,299,1313,1014
22109,0,0,36,0,-36
22110,1,0,6,0,-6
22111,1,1,275,1273,998
22112,0,0,1,0,-1
22113,1,0,21,0,-21
22114,1,0,31,0,-31
22115,1,1,1096,1983,887
22116,0,0,68,0,-68
22117,0,0,45,0,-45
22118,1,0,17,0,-17
22119,1,1,130,2340,2210
22120,0,0,130,0,-130
22121,0,0,52,0,-52
22122,0,0,15,0,-15
22123,1,1,383,1364,981
22124,1,0,43,0,-43
22125,0,0,3,0,-3
22126,1,1,135,1665,1530
22127,0,0,51,0,-51
22128,1,0,133,0,-133
22129,1,0,54,0,-54
22130,1,1,244,1203,959
22131,1,1,58,1289,1231
22132,0,0,108,0,-108
22133,1,1,491,1442,951
22134,1,1,274,1358,1084
22135,1,0,65,0,-65
22136,1,1,766,1262,496
22137,1,0,23,0,-23
22138,1,0,103,0,-103
22139,1,1,889,1444,555
22140,1,1,616,1374,758
22141,1,0,3,0,-3
22142,1,0,148,0,-148
22143,1,1,1290,1492,202
22144,0,0,3,0,-3
22145,0,0,71,0,-71
22146,0,0,7,0,-7
22147,1,1,1345,1646,301
22148,0,0,21,0,-21
22149,1,1,1091,1291,200
22150,1,1,814,1285,471
22151,0,0,9,0,-9
22152,0,0,17,0,-17
22153,1,0,149,0,-149
22154,0,0,9,0,-9
22155,1,1,722,1408,686
22156,1,0,2,0,-2
22157,1,1,604,1437,833
22158,1,0,21,0,-21
22159,1,1,416,1340,924
22160,1,0,6,0,-6
22161,0,0,8,0,-8
22162,0,0,52,0,-52
22163,0,0,28,0,-28
22164,1,1,145,2064,1919
22165,1,0,65,0,-65
22166,1,1,288,1373,1085
22167,1,1,295,1832,1537
22168,1,1,507,1467,960
22169,1,1,893,1958,1065
22170,1,0,31,0,-31
22171,0,0,1,0,-1
22172,1,1,395,1313,918
22173,0,0,20,0,-20
22174,0,0,166,0,-166
22175,1,1,400,1284,884
22176,1,0,50,0,-50
22177,1,0,9,0,-9
22178,0,0,23,0,-23
22179,0,0,81,0,-81
22180,0,0,16,0,-16
22181,0,0,25,0,-25
22182,1,0,15,0,-15
22183,1,1,369,1342,973
22184,0,0,0,0,0
22185,0,0,62,0,-62
22186,1,1,831,1262,431
22187,1,1,297,1616,1319
22188,1,1,356,1248,892
22189,1,1,27,1246,1219
22190,1,1,764,1528,764
22191,0,0,100,0,-100
22192,0,0,0,0,0
22193,1,0,53,0,-53
22194,1,1,103,1844,1741
22195,1,1,734,1434,700
22196,1,1,453,2145,1692
22197,1,1,942,1340,398
22198,0,0,34,0,-34
22199,0,0,36,0,-36
22200,0,0,53,0,-53
22201,0,0,29,0,-29
22202,0,0,59,0,-59
22203,1,1,99,2122,2023
22204,1,0,51,0,-51
22205,1,1,1863,1279,-584
22206,1,0,34,0,-34
22207,0,0,12,0,-12
22208,1,0,12,0,-12
22209,0,0,55,0,-55
22210,1,1,1352,2185,833
22211,0,0,11,0,-11
22212,1,1,119,1223,1104
22213,1,0,11,0,-11
22214,1,1,515,1815,1300
22215,0,0,112,0,-112
22216,0,0,55,0,-55
22217,0,0,137,0,-137
22218,1,0,87,0,-87
22219,1,0,15,0,-15
22220,0,0,8,0,-8
22221,1,1,600,1768,1168
22222,1,0,40,0,-40
22223,1,1,339,2166,1827
22224,1,1,231,2927,2696
22225,0,0,125,0,-125
22226,1,1,155,2326,2171
22227,1,0,5,0,-5
22228,1,0,12,0,-12
22229,1,1,423,1354,931
22230,0,0,6,0,-6
22231,1,1,2260,1221,-1039
22232,1,0,0,0,0
22233,0,0,38,0,-38
22234,0,0,170,0,-170
22235,1,0,45,0,-45
22236,0,0,11,0,-11
22237,0,0,88,0,-88
22238,0,0,20,0,-20
22239,1,0,135,0,-135
22240,0,0,116,0,-116
22241,1,1,275,1359,1084
22242,0,0,37,0,-37
22243,0,0,44,0,-44
22244,0,0,21,0,-21
22245,0,0,21,0,-21
22246,1,0,84,0,-84
22247,1,0,26,0,-26
22248,0,0,24,0,-24
22249,1,1,1249,1820,571
22250,1,0,28,0,-28
22251,1,0,46,0,-46
22252,1,0,8,0,-8
22253,1,1,551,1439,888
22254,1,0,108,0,-108
22255,1,0,57,0,-57
22256,1,1,240,1257,1017
22257,1,0,53,0,-53
22258,1,0,21,0,-21
22259,1,1,365,2797,2432
22260,1,1,154,1328,1174
22261,1,1,962,1393,431
22262,0,0,21,0,-21
22263,1,0,58,0,-58
22264,1,1,1014,2207,1193
22265,0,0,18,0,-18
22266,0,0,20,0,-20
22267,1,0,40,0,-40
22268,0,0,19,0,-19
22269,0,0,30,0,-30
22270,0,0,23,0,-23
22271,1,0,90,0,-90
22272,0,0,25,0,-25
22273,1,0,19,0,-19
22274,1,1,127,1216,1089
22275,0,0,49,0,-49
22276,1,0,36,0,-36
22277,0,0,39,0,-39
22278,1,0,14,0,-14
22279,1,0,3,0,-3
22280,0,0,175,0,-175
22281,1,0,181,0,-181
22282,1,1,139,1377,1238
22283,0,0,8,0,-8
22284,0,0,172,0,-172
22285,0,0,29,0,-29
22286,0,0,7,0,-7
22287,0,0,67,0,-67
22288,1,0,95,0,-95
22289,0,0,72,0,-72
22290,0,0,7,0,-7
22291,1,0,18,0,-18
22292,1,1,792,2022,1230
22293,1,1,623,1276,653
22294,1,0,32,0,-32
22295,0,0,29,0,-29
22296,0,0,37,0,-37
22297,0,0,1,0,-1
22298,1,1,119,2081,1962
22299,1,1,277,1497,1220
22300,1,0,22,0,-22
22301,1,0,1,0,-1
22302,1,0,194,0,-194
22303,1,0,9,0,-9
22304,1,1,152,1265,1113
22305,0,0,44,0,-44
22306,1,1,546,2107,1561
22307,1,0,21,0,-21
22308,1,1,292,1338,1046
22309,0,0,1,0,-1
22310,1,1,243,1436,1193
22311,0,0,22,0,-22
22312,1,0,21,0,-21
22313,1,0,40,0,-40
22314,0,0,99,0,-99
22315,0,0,136,0,-136
22316,1,1,577,1382,805
22317,1,1,307,4890,4583
22318,1,0,48,0,-48
22319,1,1,238,1551,1313
22320,1,1,2067,1362,-705
22321,0,0,11,0,-11
22322,1,1,47,1435,1388
22323,0,0,5,0,-5
22324,0,0,2,0,-2
22325,1,1,17,1231,1214
22326,1,0,101,0,-101
22327,0,0,32,0,-32
22328,0,0,75,0,-75
22329,0,0,57,0,-57
22330,0,0,26,0,-26
22331,1,0,35,0,-35
22332,1,1,278,2364,2086
22333,1,0,58,0,-58
22334,0,0,47,0,-47
22335,0,0,47,0,-47
22336,0,0,49,0,-49
22337,1,0,22,0,-22
22338,1,0,11,0,-11
22339,0,0,0,0,0
22340,1,0,51,0,-51
22341,0,0,310,0,-310
22342,0,0,178,0,-178
22343,1,0,3,0,-3
22344,1,0,49,0,-49
22345,0,0,103,0,-103
22346,1,1,375,1519,1144
22347,0,0,15,0,-15
22348,1,0,5,0,-5
22349,1,1,318,1688,1370
22350,0,0,45,0,-45
22351,0,0,40,0,-40
22352,0,0,27,0,-27
22353,1,1,120,1297,1177
22354,1,1,416,1313,897
22355,0,0,61,0,-61
22356,1,0,18,0,-18
22357,1,0,57,0,-57
22358,0,0,85,0,-85
22359,0,0,35,0,-35
22360,0,0,47,0,-47
22361,1,0,78,0,-78
22362,1,0,44,0,-44
22363,1,1,556,1222,666
22364,0,0,57,0,-57
22365,0,0,11,0,-11
22366,1,1,1781,1210,-571
22367,0,0,28,0,-28
22368,1,0,176,0,-176
22369,0,0,154,0,-154
22370,1,1,1194,1385,191
22371,0,0,0,0,0
22372,1,0,16,0,-16
22373,1,0,47,0,-47
22374,1,0,28,0,-28
22375,1,1,421,1382,961
22376,1,0,8,0,-8
22377,0,0,6,0,-6
22378,1,0,106,0,-106
22379,0,0,208,0,-208
22380,0,0,28,0,-28
22381,1,1,1015,1310,295
22382,0,0,67,0,-67
22383,0,0,140,0,-140
22384,1,0,140,0,-140
22385,1,0,76,0,-76
22386,1,0,67,0,-67
22387,0,0,39,0,-39
22388,1,1,163,1519,1356
22389,0,0,26,0,-26
22390,1,0,89,0,-89
22391,1,1,977,1654,677
22392,0,0,55,0,-55
22393,1,1,103,1671,1568
22394,1,0,43,0,-43
22395,1,0,43,0,-43
22396,0,0,204,0,-204
22397,1,0,107,0,-107
22398,1,0,115,0,-115
22399,0,0,23,0,-23
22400,1,1,663,1785,1122
22401,0,0,8,0,-8
22402,1,0,38,0,-38
22403,1,1,296,1978,1682
22404,1,0,29,0,-29
22405,1,1,394,1490,1096
22406,0,0,40,0,-40
22407,0,0,34,0,-34
22408,1,0,15,0,-15
22409,0,0,4,0,-4
22410,0,0,8,0,-8
22411,1,0,31,0,-31
22412,0,0,11,0,-11
22413,0,0,68,0,-68
22414,0,0,39,0,-39
22415,1,0,57,0,-57
22416,0,0,236,0,-236
22417,1,0,67,0,-67
22418,0,0,100,0,-100
22419,0,0,46,0,-46
22420,1,1,800,1273,473
22421,1,1,276,2247,1971
22422,1,0,0,0,0
22423,1,1,750,1391,641
22424,0,0,9,0,-9
22425,0,0,6,0,-6
22426,1,1,185,1418,1233
22427,0,0,82,0,-82
22428,1,1,1162,1362,200
22429,0,0,2,0,-2
22430,1,1,344,1540,1196
22431,1,0,79,0,-79
22432,1,0,19,0,-19
22433,1,0,6,0,-6
22434,1,0,19,0,-19
22435,1,0,9,0,-9
22436,1,0,9,0,-9
22437,0,0,61,0,-61
22438,1,1,1329,1644,315
22439,1,1,123,1241,1118
22440,1,1,833,1663,830
22441,0,0,2,0,-2
22442,1,0,7,0,-7
22443,1,0,122,0,-122
22444,0,0,36,0,-36
22445,1,0,13,0,-13
22446,0,0,3,0,-3
22447,1,0,10,0,-10
22448,0,0,39,0,-39
22449,1,1,2383,1701,-682
22450,1,1,419,2186,1767
22451,1,0,43,0,-43
22452,0,0,39,0,-39
22453,0,0,137,0,-137
22454,0,0,32,0,-32
22455,0,0,152,0,-152
22456,0,0,40,0,-40
22457,1,1,322,1506,1184
22458,0,0,82,0,-82
22459,0,0,7,0,-7
22460,0,0,20,0,-20
22461,1,1,338,5012,4674
22462,1,1,637,2201,1564
22463,1,1,700,1350,650
22464,1,1,653,1226,573
22465,0,0,148,0,-148
22466,0,0,11,0,-11
22467,1,1,366,1213,847
22468,1,0,19,0,-19
22469,1,1,362,1394,1032
22470,0,0,25,0,-25
22471,1,0,36,0,-36
22472,0,0,41,0,-41
22473,1,0,10,0,-10
22474,1,1,63,1472,1409
22475,1,0,113,0,-113
22476,1,1,218,1541,1323
22477,0,0,74,0,-74
22478,1,1,139,1230,1091
22479,1,1,83,1275,1192
22480,1,0,27,0,-27
22481,1,1,146,1607,1461
22482,0,0,25,0,-25
22483,0,0,67,0,-67
22484,1,0,87,0,-87
22485,1,1,407,1349,942
22486,0,0,15,0,-15
22487,0,0,99,0,-99
22488,0,0,114,0,-114
22489,0,0,1,0,-1
22490,1,1,458,1726,1268
22491,1,1,104,1354,1250
22492,0,0,1,0,-1
22493,0,0,17,0,-17
22494,1,1,289,1541,1252
22495,0,0,58,0,-58
22496,1,1,1192,1283,91
22497,1,0,0,0,0
22498,1,1,326,1523,1197
22499,1,0,8,0,-8
22500,0,0,33,0,-33
22501,1,1,47,1342,1295
22502,0,0,82,0,-82
22503,1,1,175,1324,1149
22504,1,1,240,1381,1141
22505,0,0,41,0,-41
22506,1,0,25,0,-25
22507,0,0,28,0,-28
22508,1,1,1061,1926,865
22509,0,0,47,0,-47
22510,0,0,33,0,-33
22511,1,0,68,0,-68
22512,0,0,42,0,-42
22513,1,0,20,0,-20
22514,1,0,48,0,-48
22515,1,0,52,0,-52
22516,1,0,27,0,-27
22517,1,1,1176,1825,649
22518,1,0,3,0,-3
22519,0,0,50,0,-50
22520,1,1,168,1430,1262
22521,0,0,44,0,-44
22522,1,1,90,1474,1384
22523,1,0,120,0,-120
22524,0,0,2,0,-2
22525,1,0,26,0,-26
22526,0,0,156,0,-156
22527,1,1,480,1379,899
22528,0,0,10,0,-10
22529,1,0,90,0,-90
22530,0,0,16,0,-16
22531,1,1,346,1358,1012
22532,1,0,103,0,-103
22533,0,0,158,0,-158
22534,0,0,78,0,-78
22535,0,0,58,0,-58
22536,0,0,65,0,-65
22537,1,0,14,0,-14
22538,0,0,15,0,-15
22539,1,1,495,2183,1688
22540,1,0,89,0,-89
22541,1,1,1964,1457,-507
22542,0,0,25,0,-25
22543,1,1,1386,1530,144
22544,1,0,69,0,-69
22545,0,0,6,0,-6
22546,0,0,54,0,-54
22547,0,0,30,0,-30
22548,0,0,62,0,-62
22549,0,0,10,0,-10
22550,0,0,44,0,-44
22551,0,0,151,0,-151
22552,1,1,412,1347,935
22553,0,0,31,0,-31
22554,0,0,63,0,-63
22555,0,0,43,0,-43
22556,0,0,22,0,-22
22557,0,0,136,0,-136
22558,1,1,324,1236,912
22559,1,1,1657,2405,748
22560,1,1,535,1358,823
22561,1,0,12,0,-12
22562,1,1,79,1371,1292
22563,0,0,2,0,-2
22564,0,0,0,0,0
22565,1,1,937,1498,561
22566,1,0,9,0,-9
22567,1,0,146,0,-146
22568,1,1,287,1387,1100
22569,0,0,46,0,-46
22570,0,0,31,0,-31
22571,1,0,96,0,-96
22572,1,1,568,1448,880
22573,1,0,144,0,-144
22574,1,1,68,1298,1230
22575,0,0,5,0,-5
22576,1,0,88,0,-88
22577,1,1,450,1254,804
22578,0,0,151,0,-151
22579,0,0,33,0,-33
22580,1,0,34,0,-34
22581,0,0,22,0,-22
22582,0,0,84,0,-84
22583,0,0,32,0,-32
22584,1,0,113,0,-113
22585,0,0,37,0,-37
22586,1,0,138,0,-138
22587,1,1,1016,1308,292
22588,0,0,143,0,-143
22589,1,0,22,0,-22
22590,1,0,70,0,-70
22591,1,0,75,0,-75
22592,0,0,43,0,-43
22593,0,0,72,0,-72
22594,1,0,170,0,-170
22595,1,0,18,0,-18
22596,0,0,152,0,-152
22597,0,0,130,0,-130
22598,1,0,12,0,-12
22599,0,0,74,0,-74
22600,0,0,51,0,-51
22601,1,1,311,1331,1020
22602,0,0,15,0,-15
22603,1,0,8,0,-8
22604,1,1,344,1735,1391
22605,1,1,156,1438,1282
22606,0,0,3,0,-3
22607,1,0,44,0,-44
22608,1,1,539,1445,906
22609,0,0,70,0,-70
22610,1,0,6,0,-6
22611,1,0,133,0,-133
22612,1,1,531,1934,1403
22613,1,0,72,0,-72
22614,0,0,23,0,-23
22615,1,1,542,1366,824
22616,1,0,0,0,0
22617,1,0,11,0,-11
22618,1,0,34,0,-34
22619,0,0,9,0,-9
22620,1,1,306,1258,952
22621,1,1,945,1255,310
22622,1,1,3206,1213,-1993
22623,0,0,75,0,-75
22624,0,0,6,0,-6
22625,1,1,628,1474,846
22626,0,0,99,0,-99
22627,1,0,47,0,-47
22628,0,0,63,0,-63
22629,0,0,90,0,-90
22630,1,0,21,0,-21
22631,0,0,10,0,-10
22632,1,1,341,1797,1456
22633,1,0,5,0,-5
22634,1,1,526,1241,715
22635,1,0,84,0,-84
22636,0,0,23,0,-23
22637,1,1,359,2207,1848
22638,0,0,43,0,-43
22639,0,0,14,0,-14
22640,0,0,81,0,-81
22641,0,0,23,0,-23
22642,1,1,159,1856,1697
22643,0,0,14,0,-14
22644,1,1,752,1541,789
22645,0,0,160,0,-160
22646,1,0,66,0,-66
22647,1,1,557,1384,827
22648,1,0,5,0,-5
22649,1,0,150,0,-150
22650,1,0,70,0,-70
22651,0,0,96,0,-96
22652,0,0,28,0,-28
22653,1,0,51,0,-51
22654,1,1,991,1247,256
22655,1,1,1391,2063,672
22656,1,1,263,1415,1152
22657,0,0,0,0,0
22658,0,0,81,0,-81
22659,1,0,61,0,-61
22660,1,1,1606,1649,43
22661,1,1,439,1247,808
22662,1,0,87,0,-87
22663,1,1,234,1258,1024
22664,1,1,2001,2747,746
22665,1,1,626,1615,989
22666,1,1,518,1469,951
22667,1,0,77,0,-77
22668,1,0,33,0,-33
22669,0,0,113,0,-113
22670,0,0,80,0,-80
22671,1,1,629,1218,589
22672,0,0,36,0,-36
22673,0,0,28,0,-28
22674,0,0,174,0,-174
22675,1,1,257,1571,1314
22676,1,1,1296,1597,301
22677,1,0,52,0,-52
22678,1,0,9,0,-9
22679,1,0,39,0,-39
22680,1,0,8,0,-8
22681,1,0,122,0,-122
22682,0,0,6,0,-6
22683,0,0,13,0,-13
22684,1,1,394,1457,1063
22685,0,0,2,0,-2
22686,1,1,217,2921,2704
22687,0,0,87,0,-87
22688,1,1,51,1364,1313
22689,1,0,1,0,-1
22690,1,1,277,1201,924
22691,1,1,117,2403,2286
22692,1,0,39,0,-39
22693,1,1,470,1315,845
22694,0,0,6,0,-6
22695,0,0,48,0,-48
22696,1,0,62,0,-62
22697,1,0,28,0,-28
22698,1,1,376,1462,1086
22699,0,0,11,0,-11
22700,1,0,44,0,-44
22701,1,1,244,1282,1038
22702,0,0,76,0,-76
22703,1,1,119,1233,1114
22704,0,0,1,0,-1
22705,0,0,23,0,-23
22706,1,0,198,0,-198
22707,1,0,16,0,-16
22708,1,0,28,0,-28
22709,1,1,625,1221,596
22710,1,0,22,0,-22
22711,1,1,624,1381,757
22712,1,1,79,1393,1314
22713,0,0,78,0,-78
22714,1,1,121,1391,1270
22715,0,0,8,0,-8
22716,0,0,47,0,-47
22717,1,0,107,0,-107
22718,1,0,27,0,-27
22719,0,0,29,0,-29
22720,0,0,128,0,-128
22721,0,0,71,0,-71
22722,1,0,9,0,-9
22723,0,0,47,0,-47
22724,0,0,36,0,-36
22725,1,0,131,0,-131
22726,0,0,12,0,-12
22727,1,0,162,0,-162
22728,0,0,26,0,-26
22729,0,0,16,0,-16
22730,1,1,283,1250,967
22731,1,0,63,0,-63
22732,0,0,51,0,-51
22733,1,1,454,1319,865
22734,1,0,2,0,-2
22735,1,0,5,0,-5
22736,0,0,0,0,0
22737,0,0,10,0,-10
22738,1,1,92,1265,1173
22739,1,1,1312,1384,72
22740,0,0,84,0,-84
22741,1,0,38,0,-38
22742,1,1,432,1232,800
22743,1,1,96,2368,2272
22744,0,0,2,0,-2
22745,1,1,868,1464,596
22746,0,0,19,0,-19
22747,1,1,1274,1448,174
22748,1,1,573,1463,890
22749,1,0,99,0,-99
22750,0,0,100,0,-100
22751,1,0,129,0,-129
22752,1,1,145,1347,1202
22753,1,0,88,0,-88
22754,1,1,2773,1586,-1187
22755,1,1,1285,1464,179
22756,0,0,34,0,-34
22757,1,0,8,0,-8
22758,0,0,2,0,-2
22759,1,0,96,0,-96
22760,0,0,41,0,-41
22761,1,0,44,0,-44
22762,0,0,43,0,-43
22763,0,0,39,0,-39
22764,1,1,35,1750,1715
22765,1,0,73,0,-73
22766,1,1,490,1275,785
22767,1,1,421,1289,868
22768,1,0,121,0,-121
22769,0,0,30,0,-30
22770,0,0,4,0,-4
22771,1,1,524,2031,1507
22772,1,0,2,0,-2
22773,0,0,3,0,-3
22774,1,0,18,0,-18
22775,0,0,7,0,-7
22776,0,0,44,0,-44
22777,1,0,15,0,-15
22778,1,0,182,0,-182
22779,1,1,940,1620,680
22780,0,0,40,0,-40
22781,0,0,56,0,-56
22782,1,0,30,0,-30
22783,0,0,46,0,-46
22784,1,1,127,1327,1200
22785,1,1,202,1793,1591
22786,1,0,21,0,-21
22787,1,1,1780,1940,160
22788,1,0,119,0,-119
22789,1,0,127,0,-127
22790,1,0,36,0,-36
22791,0,0,112,0,-112
22792,1,1,345,1242,897
22793,0,0,40,0,-40
22794,0,0,22,0,-22
22795,1,0,146,0,-146
22796,0,0,99,0,-99
22797,1,1,1107,1382,275
22798,1,0,42,0,-42
22799,1,1,520,1341,821
22800,1,0,27,0,-27
22801,1,1,1287,1248,-39
22802,0,0,48,0,-48
22803,1,0,18,0,-18
22804,0,0,119,0,-119
22805,1,0,37,0,-37
22806,0,0,30,0,-30
22807,1,1,234,2715,2481
22808,1,0,1,0,-1
22809,1,0,11,0,-11
22810,1,1,257,1387,1130
22811,1,1,287,1609,1322
22812,1,0,1,0,-1
22813,0,0,13,0,-13
22814,0,0,122,0,-122
22815,0,0,0,0,0
22816,1,1,1139,1472,333
22817,1,0,7,0,-7
22818,1,1,205,1209,1004
22819,0,0,35,0,-35
22820,1,1,38,1300,1262
22821,1,1,669,2393,1724
22822,1,1,157,2338,2181
22823,1,0,32,0,-32
22824,0,0,5,0,-5
22825,0,0,13,0,-13
22826,1,1,325,1503,1178
22827,0,0,130,0,-130
22828,0,0,33,0,-33
22829,1,1,475,1231,756
22830,1,1,843,1778,935
22831,1,1,145,2836,2691
22832,0,0,25,0,-25
22833,1,0,41,0,-41
22834,1,1,349,1315,966
22835,0,0,9,0,-9
22836,1,1,269,1390,1121
22837,1,0,3,0,-3
22838,1,0,180,0,-180
22839,1,0,90,0,-90
22840,1,1,98,1258,1160
22841,1,0,85,0,-85
22842,1,1,186,1309,1123
22843,0,0,140,0,-140
22844,0,0,324,0,-324
22845,1,0,1,0,-1
22846,0,0,83,0,-83
22847,1,1,442,1705,1263
22848,0,0,43,0,-43
22849,0,0,1,0,-1
22850,0,0,64,0,-64
22851,0,0,4,0,-4
22852,0,0,16,0,-16
22853,1,1,1027,2157,1130
22854,1,1,933,1242,309
22855,0,0,7,0,-7
22856,1,0,16,0,-16
22857,1,0,135,0,-135
22858,1,1,415,1460,1045
22859,0,0,55,0,-55
22860,1,0,1,0,-1
22861,0,0,0,0,0
22862,1,1,345,1266,921
22863,0,0,2,0,-2
22864,1,0,145,0,-145
22865,1,1,910,2131,1221
22866,1,0,21,0,-21
22867,0,0,163,0,-163
22868,1,0,12,0,-12
22869,1,0,58,0,-58
22870,1,1,306,2767,2461
22871,1,1,341,2272,1931
22872,1,0,3,0,-3
22873,0,0,28,0,-28
22874,1,1,83,2918,2835
22875,1,1,106,1507,1401
22876,0,0,8,0,-8
22877,0,0,101,0,-101
22878,1,0,112,0,-112
22879,1,1,193,1243,1050
22880,0,0,92,0,-92
22881,1,0,2,0,-2
22882,1,0,9,0,-9
22883,1,0,8,0,-8
22884,0,0,42,0,-42
22885,1,1,58,1248,1190
22886,0,0,129,0,-129
22887,0,0,22,0,-22
22888,0,0,0,0,0
22889,1,0,56,0,-56
22890,0,0,46,0,-46
22891,1,0,28,0,-28
22892,0,0,82,0,-82
22893,1,0,22,0,-22
22894,1,0,21,0,-21
22895,1,0,49,0,-49
22896,1,1,1353,1216,-137
22897,1,1,254,1495,1241
22898,1,1,137,1257,1120
22899,1,1,668,1296,628
22900,1,0,1,0,-1
22901,0,0,149,0,-149
22902,0,0,183,0,-183
22903,1,0,9,0,-9
22904,1,0,63,0,-63
22905,1,0,43,0,-43
22906,1,1,249,1236,987
22907,0,0,11,0,-11
22908,1,1,318,2095,1777
22909,1,1,396,1550,1154
22910,1,0,123,0,-123
22911,1,1,1315,1378,63
22912,1,0,253,0,-253
22913,0,0,16,0,-16
22914,0,0,38,0,-38
22915,1,1,88,1938,1850
22916,0,0,33,0,-33
22917,1,0,99,0,-99
22918,0,0,23,0,-23
22919,1,1,608,1220,612
22920,0,0,9,0,-9
22921,1,1,174,1222,1048
22922,0,0,41,0,-41
22923,1,1,182,1393,1211
22924,0,0,42,0,-42
22925,1,1,141,1321,1180
22926,0,0,1,0,-1
22927,0,0,17,0,-17
22928,0,0,5,0,-5
22929,1,1,243,1244,1001
22930,1,1,92,1797,1705
22931,1,0,70,0,-70
22932,1,1,365,1705,1340
22933,1,0,174,0,-174
22934,1,0,39,0,-39
22935,0,0,44,0,-44
22936,0,0,57,0,-57
22937,0,0,57,0,-57
22938,0,0,1,0,-1
22939,0,0,28,0,-28
22940,0,0,56,0,-56
22941,0,0,25,0,-25
22942,0,0,7,0,-7
22943,0,0,6,0,-6
22944,1,0,100,0,-100
22945,1,1,2437,1400,-1037
22946,0,0,47,0,-47
22947,0,0,3,0,-3
22948,1,0,32,0,-32
22949,1,0,44,0,-44
22950,0,0,94,0,-94
22951,0,0,7,0,-7
22952,0,0,22,0,-22
22953,0,0,25,0,-25
22954,1,1,1417,1408,-9
22955,1,0,13,0,-13
22956,1,1,289,1269,980
22957,1,1,126,1595,1469
22958,1,1,1099,1235,136
22959,0,0,26,0,-26
22960,0,0,11,0,-11
22961,1,1,2329,1955,-374
22962,1,0,17,0,-17
22963,0,0,73,0,-73
22964,1,0,122,0,-122
22965,0,0,7,0,-7
22966,1,1,56,1475,1419
22967,1,1,1254,1324,70
22968,1,0,10,0,-10
22969,1,0,9,0,-9
22970,1,1,36,1247,1211
22971,0,0,104,0,-104
22972,0,0,101,0,-101
22973,0,0,4,0,-4
22974,1,0,8,0,-8
22975,0,0,96,0,-96
22976,1,1,852,1446,594
22977,1,1,90,1237,1147
22978,0,0,15,0,-15
22979,0,0,4,0,-4
22980,1,1,234,2682,2448
22981,0,0,19,0,-19
22982,1,1,1092,1309,217
22983,0,0,64,0,-64
22984,0,0,26,0,-26
22985,1,0,42,0,-42
22986,1,0,45,0,-45
22987,1,0,35,0,-35
22988,1,1,562,2193,1631
22989,1,1,520,1390,870
22990,0,0,5,0,-5
22991,1,0,12,0,-12
22992,0,0,37,0,-37
22993,1,1,68,1542,1474
22994,0,0,48,0,-48
22995,1,1,321,2088,1767
22996,0,0,138,0,-138
22997,1,1,1404,1703,299
22998,1,1,679,1267,588
22999,0,0,200,0,-200
23000,0,0,50,0,-50
23001,0,0,161,0,-161
23002,1,0,27,0,-27
23003,1,0,27,0,-27
23004,0,0,22,0,-22
23005,1,1,822,2212,1390
23006,1,1,546,1399,853
23007,0,0,127,0,-127
23008,1,0,5,0,-5
23009,1,1,99,1406,1307
23010,0,0,138,0,-138
23011,1,1,779,1319,540
23012,0,0,29,0,-29
23013,0,0,53,0,-53
23014,0,0,97,0,-97
23015,1,1,268,1271,1003
23016,0,0,49,0,-49
23017,0,0,12,0,-12
23018,1,1,230,1518,1288
23019,1,0,110,0,-110
23020,0,0,11,0,-11
23021,0,0,11,0,-11
23022,1,1,403,1392,989
23023,1,1,141,3758,3617
23024,1,1,653,2038,1385
23025,0,0,0,0,0
23026,1,1,407,1242,835
23027,0,0,12,0,-12
23028,1,1,207,1246,1039
23029,0,0,45,0,-45
23030,1,0,13,0,-13
23031,1,1,995,1380,385
23032,1,1,1982,1221,-761
23033,1,1,2380,1228,-1152
23034,1,1,423,2177,1754
23035,0,0,91,0,-91
23036,1,1,159,1549,1390
23037,1,1,1666,2109,443
23038,0,0,0,0,0
23039,0,0,60,0,-60
23040,1,1,637,1441,804
23041,0,0,14,0,-14
23042,0,0,1,0,-1
23043,1,0,36,0,-36
23044,0,0,28,0,-28
23045,0,0,22,0,-22
23046,1,0,10,0,-10
23047,1,0,84,0,-84
23048,1,1,837,1405,568
23049,1,0,151,0,-151
23050,0,0,52,0,-52
23051,1,1,207,1281,1074
23052,0,0,52,0,-52
23053,0,0,68,0,-68
23054,1,0,22,0,-22
23055,0,0,26,0,-26
23056,0,0,3,0,-3
23057,0,0,40,0,-40
23058,0,0,20,0,-20
23059,1,0,105,0,-105
23060,1,0,22,0,-22
23061,1,0,51,0,-51
23062,0,0,80,0,-80
23063,1,0,36,0,-36
23064,0,0,22,0,-22
23065,1,0,50,0,-50
23066,0,0,30,0,-30
23067,0,0,72,0,-72
23068,1,0,112,0,-112
23069,1,1,164,2155,1991
23070,0,0,29,0,-29
23071,1,1,273,2057,1784
23072,1,1,91,1825,1734
23073,0,0,15,0,-15
23074,1,1,689,1385,696
23075,0,0,47,0,-47
23076,1,1,258,1347,1089
23077,0,0,55,0,-55
23078,0,0,47,0,-47
23079,1,1,212,1377,1165
23080,1,0,14,0,-14
23081,0,0,35,0,-35
23082,1,0,5,0,-5
23083,0,0,7,0,-7
23084,1,0,3,0,-3
23085,0,0,68,0,-68
23086,1,0,4,0,-4
23087,1,0,20,0,-20
23088,1,0,25,0,-25
23089,1,0,10,0,-10
23090,1,0,13,0,-13
23091,0,0,4,0,-4
23092,0,0,55,0,-55
23093,1,0,143,0,-143
23094,1,1,781,1264,483
23095,0,0,37,0,-37
23096,0,0,58,0,-58
23097,0,0,84,0,-84
23098,1,0,21,0,-21
23099,0,0,0,0,0
23100,1,1,1265,1619,354
23101,1,1,202,1594,1392
23102,0,0,47,0,-47
23103,0,0,28,0,-28
23104,0,0,84,0,-84
23105,1,0,4,0,-4
23106,0,0,32,0,-32
23107,1,0,34,0,-34
23108,0,0,204,0,-204
23109,1,1,54,1348,1294
23110,1,1,246,1355,1109
23111,1,1,411,1527,1116
23112,1,0,0,0,0
23113,0,0,10,0,-10
23114,0,0,104,0,-104
23115,1,0,15,0,-15
23116,1,0,26,0,-26
23117,0,0,69,0,-69
23118,0,0,29,0,-29
23119,0,0,138,0,-138
23120,0,0,47,0,-47
23121,0,0,61,0,-61
23122,0,0,23,0,-23
23123,1,1,29,1240,1211
23124,0,0,11,0,-11
23125,1,1,1230,1561,331
23126,1,0,33,0,-33
23127,0,0,48,0,-48
23128,0,0,4,0,-4
23129,1,1,669,1652,983
23130,0,0,62,0,-62
23131,0,0,41,0,-41
23132,1,0,57,0,-57
23133,0,0,47,0,-47
23134,0,0,17,0,-17
23135,1,1,473,1403,930
23136,0,0,79,0,-79
23137,1,0,155,0,-155
23138,1,1,804,1708,904
23139,1,1,177,1291,1114
23140,0,0,57,0,-57
23141,0,0,152,0,-152
23142,0,0,69,0,-69
23143,0,0,92,0,-92
23144,1,0,14,0,-14
23145,1,0,17,0,-17
23146,1,0,38,0,-38
23147,1,1,383,1354,971
23148,1,0,73,0,-73
23149,0,0,2,0,-2
23150,1,0,30,0,-30
23151,1,0,102,0,-102
23152,0,0,77,0,-77
23153,0,0,87,0,-87
23154,1,0,19,0,-19
23155,0,0,12,0,-12
23156,1,1,333,1267,934
23157,0,0,42,0,-42
23158,1,1,870,2365,1495
23159,1,1,331,1259,928
23160,1,1,318,1217,899
23161,1,1,320,1309,989
23162,0,0,88,0,-88
23163,1,0,2,0,-2
23164,0,0,124,0,-124
23165,1,1,164,1475,1311
23166,1,0,21,0,-21
23167,1,1,457,1226,769
23168,0,0,72,0,-72
23169,0,0,44,0,-44
23170,1,1,716,1417,701
23171,1,0,51,0,-51
23172,1,0,8,0,-8
23173,1,0,65,0,-65
23174,1,1,401,1610,1209
23175,0,0,205,0,-205
23176,1,1,229,1243,1014
23177,1,1,295,1600,1305
23178,1,1,973,1202,229
23179,0,0,32,0,-32
23180,0,0,23,0,-23
23181,0,0,2,0,-2
23182,1,0,191,0,-191
23183,0,0,7,0,-7
23184,0,0,91,0,-91
23185,1,1,80,1528,1448
23186,1,1,342,1303,961
23187,1,0,17,0,-17
23188,1,0,8,0,-8
23189,0,0,52,0,-52
23190,1,1,1235,1286,51
23191,1,0,60,0,-60
23192,1,0,53,0,-53
23193,0,0,34,0,-34
23194,0,0,44,0,-44
23195,0,0,2,0,-2
23196,0,0,12,0,-12
23197,0,0,48,0,-48
23198,1,1,522,1304,782
23199,1,0,165,0,-165
23200,1,0,9,0,-9
23201,0,0,5,0,-5
23202,1,1,392,2712,2320
23203,0,0,15,0,-15
23204,0,0,63,0,-63
23205,1,0,34,0,-34
23206,1,1,296,1474,1178
23207,1,1,233,1232,999
23208,1,0,24,0,-24
23209,1,1,1193,1720,527
23210,0,0,52,0,-52
23211,1,1,396,1322,926
23212,0,0,109,0,-109
23213,1,1,356,1318,962
23214,1,0,11,0,-11
23215,1,0,53,0,-53
23216,0,0,10,0,-10
23217,0,0,4,0,-4
23218,1,0,8,0,-8
23219,1,0,0,0,0
23220,0,0,14,0,-14
23221,0,0,130,0,-130
23222,0,0,20,0,-20
23223,1,0,18,0,-18
23224,1,1,417,1677,1260
23225,0,0,65,0,-65
23226,1,1,919,1273,354
23227,1,1,738,1213,475
23228,0,0,17,0,-17
23229,0,0,89,0,-89
23230,1,1,869,1381,512
23231,1,1,128,1426,1298
23232,0,0,25,0,-25
23233,1,0,48,0,-48
23234,0,0,17,0,-17
23235,1,0,1,0,-1
23236,1,0,31,0,-31
23237,1,0,0,0,0
23238,0,0,3,0,-3
23239,1,1,353,1396,1043
23240,0,0,11,0,-11
23241,1,1,94,1263,1169
23242,0,0,7,0,-7
23243,1,1,844,1219,375
23244,1,1,59,1387,1328
23245,0,0,34,0,-34
23246,0,0,102,0,-102
23247,0,0,41,0,-41
23248,0,0,83,0,-83
23249,1,0,17,0,-17
23250,0,0,93,0,-93
23251,1,1,174,1677,1503
23252,1,0,13,0,-13
23253,1,0,11,0,-11
23254,0,0,58,0,-58
23255,1,1,719,1629,910
23256,0,0,19,0,-19
23257,1,1,879,1205,326
23258,0,0,39,0,-39
23259,0,0,108,0,-108
23260,1,1,1451,1538,87
23261,1,1,475,1367,892
23262,0,0,0,0,0
23263,0,0,33,0,-33
23264,1,0,25,0,-25
23265,1,0,1,0,-1
23266,1,1,220,1202,982
23267,0,0,57,0,-57
23268,1,1,32,1357,1325
23269,1,0,45,0,-45
23270,1,0,35,0,-35
23271,1,1,619,1785,1166
23272,1,1,58,1228,1170
23273,1,0,4,0,-4
23274,1,0,2,0,-2
23275,0,0,107,0,-107
23276,1,1,773,1223,450
23277,0,0,40,0,-40
23278,0,0,23,0,-23
23279,1,1,462,1201,739
23280,1,1,339,1291,952
23281,0,0,16,0,-16
23282,1,1,189,1373,1184
23283,1,1,1034,1352,318
23284,1,1,333,1540,1207
23285,1,0,5,0,-5
23286,1,0,5,0,-5
23287,0,0,73,0,-73
23288,1,0,18,0,-18
23289,0,0,6,0,-6
23290,1,0,25,0,-25
23291,1,1,187,1400,1213
23292,0,0,24,0,-24
23293,0,0,30,0,-30
23294,1,0,100,0,-100
23295,0,0,72,0,-72
23296,1,1,365,1965,1600
23297,1,1,800,1802,1002
23298,1,1,1710,1405,-305
23299,1,0,44,0,-44
23300,1,0,0,0,0
23301,0,0,54,0,-54
23302,1,0,4,0,-4
23303,1,0,12,0,-12
23304,1,1,1044,1750,706
23305,1,0,27,0,-27
23306,1,1,982,1433,451
23307,1,1,213,1384,1171
23308,1,1,1477,1331,-146
23309,1,1,974,1200,226
23310,1,0,32,0,-32
23311,1,1,208,1229,1021
23312,1,1,188,1386,1198
23313,1,1,313,1433,1120
23314,1,1,1829,1568,-261
23315,1,1,460,1394,934
23316,1,0,14,0,-14
23317,0,0,1,0,-1
23318,1,1,39,1333,1294
23319,0,0,52,0,-52
23320,0,0,66,0,-66
23321,1,1,132,1228,1096
23322,0,0,70,0,-70
23323,1,0,150,0,-150
23324,0,0,5,0,-5
23325,0,0,135,0,-135
23326,0,0,37,0,-37
23327,1,0,59,0,-59
23328,1,1,323,1524,1201
23329,1,1,1245,1260,15
23330,0,0,45,0,-45
23331,1,0,81,0,-81
23332,0,0,2,0,-2
23333,1,0,45,0,-45
23334,1,1,108,1489,1381
23335,0,0,63,0,-63
23336,1,0,30,0,-30
23337,0,0,75,0,-75
23338,1,0,8,0,-8
23339,0,0,33,0,-33
23340,1,0,132,0,-132
23341,0,0,94,0,-94
23342,1,1,1101,1390,289
23343,0,0,4,0,-4
23344,1,1,253,1538,1285
23345,1,1,340,1213,873
23346,1,0,15,0,-15
23347,1,0,50,0,-50
23348,0,0,84,0,-84
23349,0,0,0,0,0
23350,1,1,1361,2690,1329
23351,1,0,1,0,-1
23352,1,0,19,0,-19
23353,0,0,28,0,-28
23354,0,0,5,0,-5
23355,0,0,58,0,-58
23356,1,0,75,0,-75
23357,1,1,191,1483,1292
23358,1,1,966,1215,249
23359,0,0,11,0,-11
23360,0,0,17,0,-17
23361,1,1,109,1520,1411
23362,0,0,40,0,-40
23363,0,0,19,0,-19
23364,1,0,162,0,-162
23365,0,0,67,0,-67
23366,1,1,69,2036,1967
23367,1,1,507,1461,954
23368,1,0,269,0,-269
23369,0,0,2,0,-2
23370,1,1,407,1543,1136
23371,0,0,13,0,-13
23372,0,0,2,0,-2
23373,1,0,96,0,-96
23374,0,0,20,0,-20
23375,0,0,34,0,-34
23376,0,0,53,0,-53
23377,0,0,11,0,-11
23378,1,1,33,1618,1585
23379,1,0,1,0,-1
23380,1,0,65,0,-65
23381,1,1,167,2429,2262
23382,1,1,230,1257,1027
23383,1,1,20,1242,1222
23384,0,0,118,0,-118
23385,0,0,101,0,-101
23386,1,1,757,1277,520
23387,0,0,19,0,-19
23388,1,0,85,0,-85
23389,1,1,321,1332,1011
23390,0,0,144,0,-144
23391,1,0,24,0,-24
23392,0,0,114,0,-114
23393,0,0,85,0,-85
23394,1,0,9,0,-9
23395,1,1,717,1654,937
23396,0,0,87,0,-87
23397,0,0,1,0,-1
23398,1,1,361,1339,978
23399,0,0,103,0,-103
23400,1,1,114,1315,1201
23401,1,1,722,1737,1015
23402,1,1,677,1411,734
23403,1,0,7,0,-7
23404,1,1,124,1353,1229
23405,1,1,618,2441,1823
23406,0,0,67,0,-67
23407,0,0,71,0,-71
23408,1,0,3,0,-3
23409,1,0,52,0,-52
23410,1,0,143,0,-143
23411,1,0,7,0,-7
23412,1,1,2830,1379,-1451
23413,1,0,36,0,-36
23414,0,0,118,0,-118
23415,0,0,74,0,-74
23416,0,0,36,0,-36
23417,0,0,89,0,-89
23418,0,0,7,0,-7
23419,0,0,115,0,-115
23420,0,0,93,0,-93
23421,1,0,8,0,-8
23422,0,0,37,0,-37
23423,1,1,54,1285,1231
23424,1,1,415,2153,1738
23425,1,0,22,0,-22
23426,1,0,39,0,-39
23427,1,1,47,1413,1366
23428,1,0,22,0,-22
23429,1,1,440,1360,920
23430,0,0,152,0,-152
23431,0,0,50,0,-50
23432,0,0,76,0,-76
23433,0,0,18,0,-18
23434,1,0,118,0,-118
23435,1,0,11,0,-11
23436,0,0,9,0,-9
23437,1,1,78,1307,1229
23438,0,0,4,0,-4
23439,1,0,18,0,-18
23440,1,0,36,0,-36
23441,1,0,2,0,-2
23442,1,1,1270,1438,168
23443,1,1,111,1297,1186
23444,1,0,124,0,-124
23445,0,0,24,0,-24
23446,0,0,14,0,-14
23447,1,1,511,2475,1964
23448,1,1,282,1534,1252
23449,1,0,18,0,-18
23450,1,0,5,0,-5
23451,0,0,19,0,-19
23452,1,1,302,1263,961
23453,0,0,79,0,-79
23454,1,0,30,0,-30
23455,0,0,34,0,-34
23456,1,1,254,1304,1050
23457,1,1,113,2212,2099
23458,0,0,14,0,-14
23459,1,1,135,1426,1291
23460,0,0,23,0,-23
23461,0,0,16,0,-16
23462,0,0,0,0,0
23463,0,0,57,0,-57
23464,0,0,40,0,-40
23465,1,0,61,0,-61
23466,1,1,261,2007,1746
23467,0,0,23,0,-23
23468,1,1,491,1599,1108
23469,0,0,0,0,0
23470,0,0,2,0,-2
23471,0,0,4,0,-4
23472,1,1,658,4173,3515
23473,0,0,9,0,-9
23474,1,0,182,0,-182
23475,1,1,769,1426,657
23476,1,0,55,0,-55
23477,1,0,64,0,-64
23478,0,0,145,0,-145
23479,1,0,28,0,-28
23480,0,0,2,0,-2
23481,1,1,202,1283,1081
23482,1,0,13,0,-13
23483,1,0,38,0,-38
23484,1,1,1042,1238,196
23485,1,1,190,1543,1353
23486,0,0,2,0,-2
23487,1,0,33,0,-33
23488,0,0,12,0,-12
23489,1,1,269,1375,1106
23490,1,0,17,0,-17
23491,1,0,11,0,-11
23492,0,0,63,0,-63
23493,1,1,481,1270,789
23494,1,0,5,0,-5
23495,1,0,2,0,-2
23496,1,0,81,0,-81
23497,1,1,582,1697,1115
23498,1,1,1410,1274,-136
23499,0,0,57,0,-57
23500,0,0,28,0,-28
23501,1,1,1636,1777,141
23502,0,0,8,0,-8
23503,0,0,14,0,-14
23504,1,1,246,1357,1111
23505,1,1,211,1324,1113
23506,0,0,13,0,-13
23507,0,0,6,0,-6
23508,1,1,500,1623,1123
23509,0,0,2,0,-2
23510,1,1,454,2169,1715
23511,0,0,49,0,-49
23512,1,1,132,1327,1195
23513,0,0,30,0,-30
23514,1,0,111,0,-111
23515,0,0,10,0,-10
23516,1,0,112,0,-112
23517,0,0,8,0,-8
23518,0,0,55,0,-55
23519,1,0,34,0,-34
23520,1,1,1416,1230,-186
23521,0,0,64,0,-64
23522,1,1,1910,1205,-705
23523,0,0,36,0,-36
23524,0,0,29,0,-29
23525,0,0,58,0,-58
23526,1,1,887,1385,498
23527,0,0,79,0,-79
23528,1,1,584,1218,634
23529,0,0,117,0,-117
23530,0,0,15,0,-15
23531,0,0,27,0,-27
23532,1,0,9,0,-9
23533,1,0,87,0,-87
23534,1,0,66,0,-66
23535,1,0,157,0,-157
23536,1,1,937,1234,297
23537,1,0,25,0,-25
23538,1,0,163,0,-163
23539,0,0,45,0,-45
23540,1,0,20,0,-20
23541,1,0,30,0,-30
23542,1,0,95,0,-95
23543,0,0,66,0,-66
23544,1,0,91,0,-91
23545,1,0,32,0,-32
23546,1,1,550,1226,676
23547,0,0,9,0,-9
23548,1,0,57,0,-57
23549,0,0,100,0,-100
23550,0,0,23,0,-23
23551,1,0,98,0,-98
23552,1,0,24,0,-24
23553,0,0,173,0,-173
23554,1,1,113,1221,1108
23555,1,0,3,0,-3
23556,1,0,20,0,-20
23557,1,0,34,0,-34
23558,0,0,40,0,-40
23559,1,1,1207,1672,465
23560,1,1,768,1247,479
23561,1,1,102,1379,1277
23562,0,0,44,0,-44
23563,1,1,403,1578,1175
23564,1,0,8,0,-8
23565,0,0,59,0,-59
23566,1,1,1183,2261,1078
23567,1,1,450,1243,793
23568,1,1,971,1289,318
23569,1,1,330,1320,990
23570,1,1,943,1369,426
23571,1,1,333,1457,1124
23572,1,1,459,1924,1465
23573,0,0,176,0,-176
23574,1,0,61,0,-61
23575,0,0,146,0,-146
23576,0,0,3,0,-3
23577,0,0,1,0,-1
23578,0,0,59,0,-59
23579,1,1,184,1986,1802
23580,1,1,49,1634,1585
23581,1,0,122,0,-122
23582,0,0,59,0,-59
23583,0,0,199,0,-199
23584,0,0,43,0,-43
23585,0,0,21,0,-21
23586,1,0,22,0,-22
23587,1,0,95,0,-95
23588,0,0,41,0,-41
23589,1,0,9,0,-9
23590,0,0,93,0,-93
23591,0,0,45,0,-45
23592,1,1,925,1253,328
23593,1,1,1643,2969,1326
23594,1,0,36,0,-36
23595,1,0,226,0,-226
23596,1,1,1235,1291,56
23597,0,0,10,0,-10
23598,0,0,41,0,-41
23599,0,0,67,0,-67
23600,0,0,200,0,-200
23601,0,0,3,0,-3
23602,0,0,17,0,-17
23603,0,0,10,0,-10
23604,1,0,175,0,-175
23605,1,1,1112,1368,256
23606,1,1,461,1987,1526
23607,0,0,84,0,-84
23608,1,0,43,0,-43
23609,1,1,440,1665,1225
23610,1,1,525,1250,725
23611,1,0,37,0,-37
23612,1,1,105,1262,1157
23613,0,0,18,0,-18
23614,1,0,19,0,-19
23615,1,1,124,1951,1827
23616,1,1,646,2252,1606
23617,1,1,224,2207,1983
23618,1,1,754,1241,487
23619,1,0,25,0,-25
23620,0,0,81,0,-81
23621,0,0,7,0,-7
23622,0,0,49,0,-49
23623,0,0,37,0,-37
23624,0,0,14,0,-14
23625,1,0,9,0,-9
23626,1,0,7,0,-7
23627,1,1,990,1291,301
23628,0,0,9,0,-9
23629,0,0,4,0,-4
23630,1,0,233,0,-233
23631,0,0,15,0,-15
23632,1,0,42,0,-42
23633,1,1,421,1399,978
23634,0,0,137,0,-137
23635,1,0,69,0,-69
23636,1,1,448,1536,1088
23637,0,0,51,0,-51
23638,1,1,380,1322,942
23639,1,1,1103,2070,967
23640,0,0,69,0,-69
23641,1,1,1068,1366,298
23642,1,1,1246,1380,134
23643,0,0,35,0,-35
23644,1,1,366,1672,1306
23645,1,1,274,1407,1133
23646,1,0,21,0,-21
23647,1,1,441,1211,770
23648,0,0,2,0,-2
23649,1,0,74,0,-74
23650,1,1,702,1493,791
23651,0,0,15,0,-15
23652,1,1,332,1500,1168
23653,1,0,24,0,-24
23654,1,0,0,0,0
23655,0,0,12,0,-12
23656,1,1,454,2444,1990
23657,1,0,42,0,-42
23658,0,0,14,0,-14
23659,1,0,25,0,-25
23660,0,0,60,0,-60
23661,1,1,119,1556,1437
23662,1,1,1470,1332,-138
23663,1,0,27,0,-27
23664,0,0,18,0,-18
23665,1,0,39,0,-39
23666,1,0,134,0,-134
23667,0,0,18,0,-18
23668,0,0,31,0,-31
23669,1,1,970,1284,314
23670,0,0,42,0,-42
23671,1,1,1515,1894,379
23672,1,0,149,0,-149
23673,0,0,189,0,-189
23674,1,1,845,1509,664
23675,1,1,257,1455,1198
23676,1,1,45,1273,1228
23677,0,0,246,0,-246
23678,1,1,1177,1326,149
23679,1,0,35,0,-35
23680,0,0,35,0,-35
23681,0,0,2,0,-2
23682,1,0,45,0,-45
23683,0,0,60,0,-60
23684,1,0,7,0,-7
23685,1,0,0,0,0
23686,0,0,15,0,-15
23687,0,0,28,0,-28
23688,1,1,29,1369,1340
23689,0,0,40,0,-40
23690,0,0,10,0,-10
23691,1,1,381,1302,921
23692,1,0,91,0,-91
23693,1,1,360,1335,975
23694,1,0,29,0,-29
23695,1,0,19,0,-19
23696,0,0,125,0,-125
23697,1,1,498,3719,3221
23698,1,0,145,0,-145
23699,1,0,28,0,-28
23700,1,1,174,1673,1499
23701,1,0,53,0,-53
23702,0,0,18,0,-18
23703,0,0,137,0,-137
23704,0,0,59,0,-59
23705,1,1,229,1254,1025
23706,0,0,33,0,-33
23707,0,0,222,0,-222
23708,1,0,19,0,-19
23709,1,1,264,1245,981
23710,0,0,72,0,-72
23711,1,1,375,1406,1031
23712,1,0,17,0,-17
23713,0,0,97,0,-97
23714,1,1,464,1207,743
23715,1,1,1412,1435,23
23716,1,0,147,0,-147
23717,1,0,7,0,-7
23718,0,0,10,0,-10
23719,1,1,871,1288,417
23720,1,1,1157,2405,1248
23721,0,0,10,0,-10
23722,1,1,99,1339,1240
23723,0,0,26,0,-26
23724,1,1,183,1622,1439
23725,0,0,101,0,-101
23726,1,0,14,0,-14
23727,0,0,7,0,-7
23728,0,0,15,0,-15
23729,1,1,197,1414,1217
23730,1,0,11,0,-11
23731,0,0,14,0,-14
23732,0,0,31,0,-31
23733,1,1,1043,1401,358
23734,1,1,1068,1243,175
23735,0,0,133,0,-133
23736,1,1,783,1414,631
23737,1,0,27,0,-27
23738,0,0,19,0,-19
23739,0,0,58,0,-58
23740,1,0,5,0,-5
23741,1,1,173,1489,1316
23742,1,0,76,0,-76
23743,0,0,31,0,-31
23744,0,0,265,0,-265
23745,1,1,350,1284,934
23746,0,0,61,0,-61
23747,1,1,236,1229,993
23748,0,0,159,0,-159
23749,0,0,103,0,-103
23750,1,0,13,0,-13
23751,0,0,60,0,-60
23752,1,0,3,0,-3
23753,0,0,1,0,-1
23754,0,0,149,0,-149
23755,1,1,278,2393,2115
23756,1,1,87,1300,1213
23757,1,1,1224,1945,721
23758,1,0,50,0,-50
23759,0,0,74,0,-74
23760,0,0,61,0,-61
23761,1,1,275,1327,1052
23762,0,0,14,0,-14
23763,1,1,417,1350,933
23764,0,0,32,0,-32
23765,0,0,11,0,-11
23766,0,0,77,0,-77
23767,1,0,8,0,-8
23768,1,0,31,0,-31
23769,0,0,76,0,-76
23770,1,0,16,0,-16
23771,1,1,471,2589,2118
23772,1,0,101,0,-101
23773,1,0,29,0,-29
23774,1,0,14,0,-14
23775,0,0,2,0,-2
23776,0,0,21,0,-21
23777,1,0,60,0,-60
23778,1,0,13,0,-13
23779,1,1,240,2980,2740
23780,0,0,95,0,-95
23781,1,1,164,1741,1577
23782,1,0,3,0,-3
23783,1,1,596,1282,686
23784,0,0,26,0,-26
23785,0,0,4,0,-4
23786,0,0,135,0,-135
23787,0,0,14,0,-14
23788,1,0,60,0,-60
23789,0,0,30,0,-30
23790,1,0,126,0,-126
23791,1,0,96,0,-96
23792,1,0,6,0,-6
23793,1,1,167,1908,1741
23794,0,0,57,0,-57
23795,0,0,4,0,-4
23796,1,1,209,2485,2276
23797,0,0,130,0,-130
23798,1,1,418,1583,1165
23799,1,1,419,1451,1032
23800,0,0,8,0,-8
23801,1,1,104,1200,1096
23802,1,1,360,3273,2913
23803,1,0,22,0,-22
23804,1,0,25,0,-25
23805,1,1,292,1468,1176
23806,0,0,29,0,-29
23807,0,0,76,0,-76
23808,0,0,118,0,-118
23809,1,0,39,0,-39
23810,1,0,7,0,-7
23811,0,0,31,0,-31
23812,1,1,597,1685,1088
23813,1,1,149,1645,1496
23814,1,1,687,1517,830
23815,1,1,298,1663,1365
23816,1,1,438,4379,3941
23817,0,0,84,0,-84
23818,1,0,6,0,-6
23819,1,1,97,1426,1329
23820,1,0,35,0,-35
23821,1,1,68,1394,1326
23822,1,0,111,0,-111
23823,1,1,1570,1314,-256
23824,0,0,15,0,-15
23825,1,1,864,1830,966
23826,0,0,106,0,-106
23827,1,1,274,1326,1052
23828,1,1,56,1401,1345
23829,0,0,55,0,-55
23830,0,0,114,0,-114
23831,0,0,19,0,-19
23832,0,0,35,0,-35
23833,0,0,25,0,-25
23834,0,0,9,0,-9
23835,1,0,17,0,-17
23836,0,0,36,0,-36
23837,0,0,18,0,-18
23838,0,0,0,0,0
23839,1,1,117,1330,1213
23840,1,1,145,1201,1056
23841,1,0,133,0,-133
23842,0,0,127,0,-127
23843,1,0,130,0,-130
23844,0,0,20,0,-20
23845,1,0,119,0,-119
23846,1,0,66,0,-66
23847,1,0,60,0,-60
23848,1,1,384,1291,907
23849,1,0,2,0,-2
23850,0,0,7,0,-7
23851,1,1,123,1651,1528
23852,1,1,312,1256,944
23853,1,1,175,1397,1222
23854,1,0,92,0,-92
23855,1,0,8,0,-8
23856,0,0,18,0,-18
23857,1,1,434,1320,886
23858,1,1,825,1290,465
23859,1,0,51,0,-51
23860,1,0,44,0,-44
23861,0,0,103,0,-103
23862,1,0,10,0,-10
23863,1,0,151,0,-151
23864,0,0,73,0,-73
23865,1,1,223,1339,1116
23866,0,0,155,0,-155
23867,0,0,15,0,-15
23868,0,0,8,0,-8
23869,1,0,153,0,-153
23870,0,0,148,0,-148
23871,0,0,26,0,-26
23872,1,0,5,0,-5
23873,0,0,18,0,-18
23874,1,1,422,1416,994
23875,0,0,51,0,-51
23876,1,0,35,0,-35
23877,1,1,512,2440,1928
23878,0,0,8,0,-8
23879,1,0,64,0,-64
23880,1,0,0,0,0
23881,0,0,51,0,-51
23882,0,0,9,0,-9
23883,1,1,274,1363,1089
23884,1,1,403,1378,975
23885,0,0,123,0,-123
23886,1,1,270,1248,978
23887,1,0,45,0,-45
23888,0,0,149,0,-149
23889,1,1,87,1955,1868
23890,1,0,52,0,-52
23891,1,0,35,0,-35
23892,1,1,1489,1504,15
23893,1,1,350,1351,1001
23894,1,0,32,0,-32
23895,1,0,4,0,-4
23896,1,0,112,0,-112
23897,1,0,114,0,-114
23898,1,1,314,1228,914
23899,0,0,57,0,-57
23900,1,0,6,0,-6
23901,1,1,191,1221,1030
23902,0,0,20,0,-20
23903,1,1,959,1300,341
23904,0,0,11,0,-11
23905,0,0,75,0,-75
23906,1,1,585,9012,8427
23907,1,1,412,1309,897
23908,0,0,13,0,-13
23909,1,1,1002,2052,1050
23910,1,1,1199,1215,16
23911,1,0,86,0,-86
23912,1,0,17,0,-17
23913,0,0,20,0,-20
23914,1,0,5,0,-5
23915,1,0,29,0,-29
23916,0,0,60,0,-60
23917,0,0,12,0,-12
23918,1,0,12,0,-12
23919,1,1,379,2180,1801
23920,0,0,28,0,-28
23921,0,0,12,0,-12
23922,0,0,77,0,-77
23923,0,0,18,0,-18
23924,1,0,26,0,-26
23925,1,1,235,1481,1246
23926,1,1,700,2020,1320
23927,0,0,34,0,-34
23928,1,0,95,0,-95
23929,1,0,19,0,-19
23930,1,0,18,0,-18
23931,0,0,2,0,-2
23932,1,1,816,1597,781
23933,1,1,180,1305,1125
23934,1,1,596,1213,617
23935,1,1,525,1207,682
23936,1,0,0,0,0
23937,1,0,27,0,-27
23938,1,0,255,0,-255
23939,1,1,998,1440,442
23940,1,0,2,0,-2
23941,0,0,10,0,-10
23942,0,0,50,0,-50
23943,0,0,18,0,-18
23944,1,0,39,0,-39
23945,1,0,32,0,-32
23946,0,0,10,0,-10
23947,0,0,20,0,-20
23948,0,0,141,0,-141
23949,1,1,884,1331,447
23950,1,1,8,3112,3104
23951,1,0,57,0,-57
23952,0,0,53,0,-53
23953,1,1,1039,2053,1014
23954,0,0,108,0,-108
23955,0,0,279,0,-279
23956,0,0,60,0,-60
23957,1,0,12,0,-12
23958,1,0,51,0,-51
23959,0,0,32,0,-32
23960,1,1,3346,1284,-2062
23961,1,0,7,0,-7
23962,1,0,70,0,-70
23963,0,0,94,0,-94
23964,1,0,17,0,-17
23965,0,0,26,0,-26
23966,1,0,1,0,-1
23967,1,1,113,1510,1397
23968,0,0,50,0,-50
23969,1,0,53,0,-53
23970,1,0,32,0,-32
23971,0,0,11,0,-11
23972,1,0,46,0,-46
23973,1,1,205,1293,1088
23974,0,0,1,0,-1
23975,0,0,8,0,-8
23976,1,1,1172,1392,220
23977,1,0,11,0,-11
23978,1,0,45,0,-45
23979,1,1,1989,1427,-562
23980,1,0,3,0,-3
23981,1,0,7,0,-7
23982,1,1,1047,1717,670
23983,0,0,27,0,-27
23984,1,0,13,0,-13
23985,1,1,389,1370,981
23986,1,1,1944,3293,1349
23987,0,0,9,0,-9
23988,1,1,464,1351,887
23989,1,0,68,0,-68
23990,0,0,131,0,-131
23991,0,0,34,0,-34
23992,1,1,119,1353,1234
23993,1,1,249,1325,1076
23994,1,1,1493,1226,-267
23995,0,0,69,0,-69
23996,1,1,264,1459,1195
23997,1,1,159,1309,1150
23998,0,0,45,0,-45
23999,1,0,15,0,-15
24000,1,0,4,0,-4
24001,0,0,44,0,-44
24002,1,1,397,3119,2722
24003,0,0,69,0,-69
24004,0,0,18,0,-18
24005,0,0,34,0,-34
24006,1,0,5,0,-5
24007,0,0,66,0,-66
24008,0,0,17,0,-17
24009,0,0,144,0,-144
24010,1,1,442,1655,1213
24011,1,1,155,1283,1128
24012,1,0,13,0,-13
24013,1,1,644,1697,1053
24014,1,1,333,1354,1021
24015,1,0,138,0,-138
24016,1,1,71,1281,1210
24017,0,0,2,0,-2
24018,0,0,27,0,-27
24019,1,0,55,0,-55
24020,1,1,1444,1280,-164
24021,0,0,48,0,-48
24022,1,1,549,1356,807
24023,1,0,46,0,-46
24024,1,1,186,1746,1560
24025,1,1,120,1372,1252
24026,0,0,63,0,-63
24027,1,1,1073,1410,337
24028,0,0,42,0,-42
24029,1,1,851,1274,423
24030,0,0,1,0,-1
24031,1,0,34,0,-34
24032,0,0,13,0,-13
24033,1,1,1193,1824,631
24034,0,0,57,0,-57
24035,1,1,99,1210,1111
24036,1,0,31,0,-31
24037,1,1,1268,1700,432
24038,1,0,98,0,-98
24039,0,0,52,0,-52
24040,1,0,81,0,-81
24041,0,0,34,0,-34
24042,1,1,286,1204,918
24043,0,0,5,0,-5
24044,1,0,23,0,-23
24045,1,1,140,1221,1081
24046,1,0,284,0,-284
24047,0,0,25,0,-25
24048,1,1,34,3446,3412
24049,1,0,31,0,-31
24050,0,0,6,0,-6
24051,1,0,20,0,-20
24052,1,0,57,0,-57
24053,0,0,34,0,-34
24054,0,0,11,0,-11
24055,1,0,86,0,-86
24056,1,1,120,1975,1855
24057,1,1,64,1847,1783
24058,1,0,73,0,-73
24059,1,0,30,0,-30
24060,1,0,0,0,0
24061,0,0,11,0,-11
24062,1,1,162,2099,1937
24063,1,0,30,0,-30
24064,1,0,21,0,-21
24065,0,0,130,0,-130
24066,1,0,50,0,-50
24067,1,0,23,0,-23
24068,1,1,179,1626,1447
24069,1,0,41,0,-41
24070,0,0,13,0,-13
24071,1,1,1014,1749,735
24072,1,1,478,1373,895
24073,1,1,1040,1374,334
24074,0,0,63,0,-63
24075,0,0,13,0,-13
24076,1,0,78,0,-78
24077,1,1,134,1529,1395
24078,0,0,80,0,-80
24079,1,0,195,0,-195
24080,1,1,584,1633,1049
24081,0,0,10,0,-10
24082,1,1,110,1805,1695
24083,0,0,188,0,-188
24084,0,0,47,0,-47
24085,0,0,59,0,-59
24086,0,0,138,0,-138
24087,1,1,146,1200,1054
24088,0,0,4,0,-4
24089,1,0,23,0,-23
24090,0,0,25,0,-25
24091,1,0,5,0,-5
24092,0,0,26,0,-26
24093,1,0,108,0,-108
24094,1,0,201,0,-201
24095,0,0,146,0,-146
24096,0,0,69,0,-69
24097,1,0,142,0,-142
24098,1,1,229,1513,1284
24099,1,0,19,0,-19
24100,0,0,54,0,-54
24101,0,0,108,0,-108
24102,1,1,741,1396,655
24103,0,0,42,0,-42
24104,1,1,591,1218,627
24105,0,0,91,0,-91
24106,1,0,35,0,-35
24107,1,1,110,1592,1482
24108,1,1,1039,1254,215
24109,1,0,90,0,-90
24110,1,1,119,1365,1246
24111,0,0,95,0,-95
24112,0,0,15,0,-15
24113,0,0,7,0,-7
24114,1,1,1337,1647,310
24115,1,1,159,1326,1167
24116,1,1,902,1285,383
24117,1,0,63,0,-63
24118,1,0,10,0,-10
24119,1,0,81,0,-81
24120,0,0,35,0,-35
24121,0,0,63,0,-63
24122,1,0,45,0,-45
24123,0,0,157,0,-157
24124,1,1,165,1252,1087
24125,1,1,727,1291,564
24126,1,0,66,0,-66
24127,0,0,96,0,-96
24128,1,1,528,1596,1068
24129,0,0,17,0,-17
24130,0,0,6,0,-6
24131,0,0,98,0,-98
24132,1,1,551,1352,801
24133,1,1,127,1265,1138
24134,1,1,768,1264,496
24135,1,0,180,0,-180
24136,0,0,41,0,-41
24137,1,1,229,1218,989
24138,1,1,1221,1799,578
24139,1,0,17,0,-17
24140,0,0,22,0,-22
24141,0,0,115,0,-115
24142,1,1,116,1212,1096
24143,1,1,1254,1265,11
24144,0,0,68,0,-68
24145,1,0,29,0,-29
24146,1,1,94,1960,1866
24147,1,0,55,0,-55
24148,0,0,49,0,-49
24149,0,0,69,0,-69
24150,0,0,46,0,-46
24151,1,1,573,2651,2078
24152,1,0,0,0,0
24153,0,0,3,0,-3
24154,1,0,22,0,-22
24155,0,0,34,0,-34
24156,0,0,32,0,-32
24157,1,0,15,0,-15
24158,0,0,6,0,-6
24159,1,1,391,1221,830
24160,0,0,11,0,-11
24161,1,1,1338,1298,-40
24162,1,1,95,1383,1288
24163,0,0,6,0,-6
24164,1,1,442,1255,813
24165,1,1,392,1511,1119
24166,0,0,34,0,-34
24167,0,0,8,0,-8
24168,1,0,31,0,-31
24169,1,1,457,2801,2344
24170,1,0,87,0,-87
24171,1,0,102,0,-102
24172,1,0,57,0,-57
24173,1,0,33,0,-33
24174,1,1,1417,1836,419
24175,0,0,0,0,0
24176,0,0,0,0,0
24177,1,1,271,1235,964
24178,0,0,79,0,-79
24179,1,1,2049,1564,-485
24180,1,0,67,0,-67
24181,0,0,60,0,-60
24182,1,1,1030,1528,498
24183,0,0,61,0,-61
24184,1,1,834,1432,598
24185,1,0,30,0,-30
24186,0,0,28,0,-28
24187,1,1,125,1238,1113
24188,1,1,289,1576,1287
24189,0,0,184,0,-184
24190,0,0,36,0,-36
24191,1,0,18,0,-18
24192,1,1,1058,1388,330
24193,0,0,143,0,-143
24194,1,0,15,0,-15
24195,1,1,185,1450,1265
24196,1,0,15,0,-15
24197,0,0,3,0,-3
24198,1,1,408,1352,944
24199,0,0,50,0,-50
24200,1,0,33,0,-33
24201,0,0,112,0,-112
24202,1,1,402,1401,999
24203,0,0,43,0,-43
24204,1,0,71,0,-71
24205,1,0,7,0,-7
24206,1,1,664,1291,627
24207,0,0,12,0,-12
24208,0,0,188,0,-188
24209,1,0,24,0,-24
24210,1,1,319,1364,1045
24211,1,0,28,0,-28
24212,0,0,32,0,-32
24213,0,0,32,0,-32
24214,1,1,161,1236,1075
24215,1,1,356,1890,1534
24216,1,1,275,2428,2153
24217,1,1,232,1325,1093
24218,0,0,48,0,-48
24219,0,0,159,0,-159
24220,1,0,16,0,-16
24221,1,0,0,0,0
24222,0,0,66,0,-66
24223,0,0,27,0,-27
24224,1,1,454,1399,945
24225,1,1,1014,1381,367
24226,1,0,45,0,-45
24227,0,0,47,0,-47
24228,1,1,263,2961,2698
24229,0,0,50,0,-50
24230,1,0,15,0,-15
24231,1,0,77,0,-77
24232,0,0,24,0,-24
24233,1,0,2,0,-2
24234,1,0,1,0,-1
24235,1,0,36,0,-36
24236,1,0,52,0,-52
24237,1,0,29,0,-29
24238,1,0,15,0,-15
24239,1,1,168,2253,2085
24240,0,0,6,0,-6
24241,1,0,41,0,-41
24242,1,0,71,0,-71
24243,1,1,211,1248,1037
24244,1,1,1284,1658,374
24245,1,1,59,3381,3322
24246,1,0,113,0,-113
24247,0,0,60,0,-60
24248,0,0,83,0,-83
24249,0,0,49,0,-49
24250,1,0,2,0,-2
24251,1,0,48,0,-48
24252,0,0,8,0,-8
24253,0,0,30,0,-30
24254,1,0,17,0,-17
24255,0,0,49,0,-49
24256,1,1,246,1369,1123
24257,0,0,30,0,-30
24258,0,0,42,0,-42
24259,1,0,12,0,-12
24260,1,0,53,0,-53
24261,1,0,39,0,-39
24262,1,1,940,2219,1279
24263,0,0,63,0,-63
24264,0,0,15,0,-15
24265,1,1,516,1482,966
24266,0,0,6,0,-6
24267,1,0,165,0,-165
24268,1,1,981,1606,625
24269,1,0,43,0,-43
24270,1,1,60,1224,1164
24271,1,0,53,0,-53
24272,0,0,43,0,-43
24273,0,0,11,0,-11
24274,1,0,72,0,-72
24275,1,0,32,0,-32
24276,1,1,341,1290,949
24277,1,1,165,1234,1069
24278,1,1,956,1896,940
24279,1,1,1527,1427,-100
24280,1,0,15,0,-15
24281,1,1,110,1291,1181
24282,0,0,11,0,-11
24283,0,0,17,0,-17
24284,0,0,59,0,-59
24285,1,0,78,0,-78
24286,1,0,152,0,-152
24287,0,0,57,0,-57
24288,0,0,44,0,-44
24289,1,0,65,0,-65
24290,1,0,20,0,-20
24291,0,0,16,0,-16
24292,1,0,82,0,-82
24293,1,1,1565,1733,168
24294,0,0,0,0,0
24295,0,0,30,0,-30
24296,0,0,23,0,-23
24297,1,0,2,0,-2
24298,0,0,13,0,-13
24299,0,0,8,0,-8
24300,1,1,577,1404,827
24301,0,0,12,0,-12
24302,0,0,38,0,-38
24303,0,0,66,0,-66
24304,0,0,141,0,-141
24305,0,0,87,0,-87
24306,0,0,44,0,-44
24307,1,0,57,0,-57
24308,1,1,197,1709,1512
24309,1,0,121,0,-121
24310,1,1,478,1409,931
24311,1,0,168,0,-168
24312,1,0,29,0,-29
24313,0,0,1,0,-1
24314,0,0,110,0,-110
24315,1,1,433,1316,883
24316,1,0,20,0,-20
24317,1,0,103,0,-103
24318,1,1,440,1564,1124
24319,1,0,61,0,-61
24320,1,1,227,1561,1334
24321,1,1,143,1479,1336
24322,0,0,19,0,-19
24323,1,1,69,1965,1896
24324,1,1,448,1309,861
24325,1,0,5,0,-5
24326,1,0,2,0,-2
24327,1,0,26,0,-26
24328,1,0,66,0,-66
24329,0,0,43,0,-43
24330,1,1,74,2883,2809
24331,1,1,214,1414,1200
24332,0,0,28,0,-28
24333,1,0,45,0,-45
24334,1,1,87,1221,1134
24335,0,0,24,0,-24
24336,1,1,446,2548,2102
24337,0,0,102,0,-102
24338,1,1,285,1470,1185
24339,0,0,171,0,-171
24340,0,0,35,0,-35
24341,0,0,34,0,-34
24342,0,0,11,0,-11
24343,1,0,7,0,-7
24344,1,1,142,1822,1680
24345,0,0,77,0,-77
24346,0,0,4,0,-4
24347,1,1,3220,1228,-1992
24348,0,0,37,0,-37
24349,0,0,33,0,-33
24350,1,1,1415,1221,-194
24351,0,0,136,0,-136
24352,0,0,27,0,-27
24353,1,0,4,0,-4
24354,1,0,2,0,-2
24355,1,1,468,3893,3425
24356,1,0,28,0,-28
24357,1,0,37,0,-37
24358,1,0,55,0,-55
24359,1,1,1679,1761,82
24360,0,0,15,0,-15
24361,1,0,193,0,-193
24362,1,1,327,1392,1065
24363,0,0,9,0,-9
24364,1,0,40,0,-40
24365,0,0,6,0,-6
24366,0,0,27,0,-27
24367,1,1,55,1502,1447
24368,0,0,4,0,-4
24369,1,0,13,0,-13
24370,1,0,41,0,-41
24371,0,0,2,0,-2
24372,1,0,34,0,-34
24373,0,0,4,0,-4
24374,1,0,6,0,-6
24375,1,0,22,0,-22
24376,1,0,30,0,-30
24377,1,1,659,1562,903
24378,1,1,110,1285,1175
24379,1,0,156,0,-156
24380,1,1,683,1203,520
24381,0,0,60,0,-60
24382,1,0,22,0,-22
24383,1,1,1534,1310,-224
24384,0,0,10,0,-10
24385,1,1,121,1207,1086
24386,1,1,299,1501,1202
24387,0,0,124,0,-124
24388,1,1,1688,1286,-402
24389,1,0,68,0,-68
24390,1,1,134,1546,1412
24391,1,1,184,1298,1114
24392,0,0,14,0,-14
24393,1,0,81,0,-81
24394,1,0,67,0,-67
24395,1,0,30,0,-30
24396,1,1,830,1287,457
24397,0,0,12,0,-12
24398,0,0,16,0,-16
24399,0,0,5,0,-5
24400,1,1,902,1287,385
24401,1,0,91,0,-91
24402,0,0,19,0,-19
24403,1,0,33,0,-33
24404,1,1,239,1275,1036
24405,0,0,60,0,-60
24406,1,1,326,1255,929
24407,1,0,35,0,-35
24408,0,0,66,0,-66
24409,1,0,51,0,-51
24410,1,1,365,2047,1682
24411,0,0,13,0,-13
24412,1,0,5,0,-5
24413,0,0,47,0,-47
24414,1,0,157,0,-157
24415,1,0,15,0,-15
24416,1,1,58,1409,1351
24417,0,0,352,0,-352
24418,1,0,10,0,-10
24419,0,0,37,0,-37
24420,1,0,20,0,-20
24421,0,0,104,0,-104
24422,1,1,190,1434,1244
24423,1,0,53,0,-53
24424,0,0,12,0,-12
24425,1,0,5,0,-5
24426,1,0,32,0,-32
24427,0,0,55,0,-55
24428,1,0,12,0,-12
24429,1,0,31,0,-31
24430,0,0,46,0,-46
24431,0,0,30,0,-30
24432,1,1,763,1523,760
24433,1,1,100,1911,1811
24434,1,0,14,0,-14
24435,1,0,35,0,-35
24436,0,0,116,0,-116
24437,1,0,49,0,-49
24438,0,0,26,0,-26
24439,1,1,1110,1704,594
24440,1,0,69,0,-69
24441,0,0,456,0,-456
24442,1,1,323,1205,882
24443,1,0,34,0,-34
24444,0,0,63,0,-63
24445,0,0,133,0,-133
24446,0,0,5,0,-5
24447,1,1,350,1499,1149
24448,1,0,25,0,-25
24449,1,0,20,0,-20
24450,0,0,0,0,0
24451,0,0,103,0,-103
24452,0,0,170,0,-170
24453,1,1,342,1344,1002
24454,0,0,125,0,-125
24455,1,1,1037,1717,680
24456,0,0,23,0,-23
24457,1,1,701,1298,597
24458,1,1,205,2388,2183
24459,1,1,438,1564,1126
24460,0,0,64,0,-64
24461,0,0,15,0,-15
24462,0,0,128,0,-128
24463,1,1,285,1327,1042
24464,0,0,176,0,-176
24465,1,0,36,0,-36
24466,1,1,1444,1583,139
24467,1,1,274,1296,1022
24468,0,0,45,0,-45
24469,1,0,40,0,-40
24470,1,1,95,1338,1243
24471,1,0,16,0,-16
24472,0,0,0,0,0
24473,0,0,25,0,-25
24474,0,0,8,0,-8
24475,1,1,2040,1520,-520
24476,1,1,361,1435,1074
24477,1,1,326,1229,903
24478,1,1,308,1505,1197
24479,0,0,116,0,-116
24480,1,1,218,1710,1492
24481,1,1,109,1411,1302
24482,0,0,38,0,-38
24483,1,0,52,0,-52
24484,1,0,127,0,-127
24485,1,1,161,1539,1378
24486,1,1,602,1284,682
24487,0,0,93,0,-93
24488,0,0,15,0,-15
24489,1,0,17,0,-17
24490,1,0,28,0,-28
24491,0,0,8,0,-8
24492,1,0,112,0,-112
24493,1,0,12,0,-12
24494,1,0,75,0,-75
24495,1,1,91,1640,1549
24496,0,0,9,0,-9
24497,1,1,691,1283,592
24498,1,1,503,1237,734
24499,0,0,3,0,-3
24500,1,0,15,0,-15
24501,1,1,1061,1314,253
24502,0,0,9,0,-9
24503,1,0,70,0,-70
24504,1,0,57,0,-57
24505,1,0,39,0,-39
24506,1,0,81,0,-81
24507,0,0,11,0,-11
24508,1,0,8,0,-8
24509,1,0,125,0,-125
24510,0,0,48,0,-48
24511,1,0,55,0,-55
24512,1,0,43,0,-43
24513,1,0,60,0,-60
24514,1,0,99,0,-99
24515,0,0,44,0,-44
24516,0,0,25,0,-25
24517,1,1,180,1600,1420
24518,1,1,117,1301,1184
24519,1,1,294,1755,1461
24520,0,0,60,0,-60
24521,0,0,74,0,-74
24522,1,0,5,0,-5
24523,1,0,5,0,-5
24524,0,0,50,0,-50
24525,1,1,620,2264,1644
24526,1,1,321,1921,1600
24527,0,0,8,0,-8
24528,1,0,248,0,-248
24529,1,1,72,1869,1797
24530,1,0,82,0,-82
24531,1,0,54,0,-54
24532,1,1,124,1498,1374
24533,0,0,4,0,-4
24534,1,0,13,0,-13
24535,1,1,149,1957,1808
24536,1,1,475,1307,832
24537,1,1,380,1388,1008
24538,0,0,20,0,-20
24539,0,0,27,0,-27
24540,0,0,140,0,-140
24541,1,1,661,1358,697
24542,1,0,12,0,-12
24543,0,0,19,0,-19
24544,1,0,113,0,-113
24545,1,0,21,0,-21
24546,1,1,789,1263,474
24547,1,0,111,0,-111
24548,1,0,104,0,-104
24549,1,0,119,0,-119
24550,1,1,650,1262,612
24551,1,0,28,0,-28
24552,1,1,184,1362,1178
24553,1,0,35,0,-35
24554,1,0,265,0,-265
24555,1,1,461,1678,1217
24556,0,0,16,0,-16
24557,0,0,93,0,-93
24558,0,0,20,0,-20
24559,0,0,121,0,-121
24560,1,1,140,1631,1491
24561,0,0,24,0,-24
24562,1,1,688,1269,581
24563,0,0,61,0,-61
24564,0,0,51,0,-51
24565,1,0,65,0,-65
24566,1,1,294,1240,946
24567,0,0,29,0,-29
24568,1,0,12,0,-12
24569,1,1,1639,1964,325
24570,1,0,91,0,-91
24571,1,1,1568,1366,-202
24572,0,0,49,0,-49
24573,1,0,42,0,-42
24574,1,1,295,1245,950
24575,0,0,21,0,-21
24576,0,0,12,0,-12
24577,1,0,52,0,-52
24578,0,0,39,0,-39
24579,1,1,599,1336,737
24580,1,0,1,0,-1
24581,0,0,105,0,-105
24582,0,0,11,0,-11
24583,0,0,60,0,-60
24584,1,0,51,0,-51
24585,0,0,2,0,-2
24586,1,0,100,0,-100
24587,1,0,26,0,-26
24588,0,0,89,0,-89
24589,1,1,208,3225,3017
24590,0,0,89,0,-89
24591,0,0,8,0,-8
24592,1,0,60,0,-60
24593,1,0,29,0,-29
24594,1,0,119,0,-119
24595,0,0,30,0,-30
24596,0,0,4,0,-4
24597,0,0,7,0,-7
24598,1,0,5,0,-5
24599,1,0,140,0,-140
24600,1,0,1,0,-1
24601,0,0,0,0,0
24602,0,0,9,0,-9
24603,0,0,67,0,-67
24604,1,0,244,0,-244
24605,1,1,229,1586,1357
24606,1,0,12,0,-12
24607,0,0,67,0,-67
24608,1,1,27,1257,1230
24609,0,0,62,0,-62
24610,1,0,93,0,-93
24611,1,0,117,0,-117
24612,0,0,14,0,-14
24613,0,0,40,0,-40
24614,1,1,304,1207,903
24615,0,0,24,0,-24
24616,1,0,71,0,-71
24617,1,1,232,5780,5548
24618,0,0,72,0,-72
24619,1,0,46,0,-46
24620,1,0,51,0,-51
24621,1,1,427,1240,813
24622,1,1,340,1283,943
24623,0,0,21,0,-21
24624,0,0,31,0,-31
24625,1,1,1580,2390,810
24626,0,0,49,0,-49
24627,1,1,145,2413,2268
24628,1,1,380,3869,3489
24629,0,0,131,0,-131
24630,1,0,0,0,0
24631,0,0,25,0,-25
24632,1,0,4,0,-4
24633,1,0,15,0,-15
24634,1,1,162,1262,1100
24635,0,0,53,0,-53
24636,0,0,20,0,-20
24637,0,0,0,0,0
24638,0,0,52,0,-52
24639,1,0,153,0,-153
24640,1,1,597,2169,1572
24641,0,0,76,0,-76
24642,1,1,976,1298,322
24643,0,0,1,0,-1
24644,1,0,209,0,-209
24645,1,0,23,0,-23
24646,1,1,352,1495,1143
24647,1,1,837,2712,1875
24648,1,0,2,0,-2
24649,1,1,273,1561,1288
24650,0,0,60,0,-60
24651,0,0,21,0,-21
24652,1,0,77,0,-77
24653,1,0,39,0,-39
24654,1,0,104,0,-104
24655,1,0,189,0,-189
24656,0,0,31,0,-31
24657,0,0,41,0,-41
24658,1,0,10,0,-10
24659,1,1,131,1229,1098
24660,1,0,0,0,0
24661,1,0,0,0,0
24662,1,0,53,0,-53
24663,1,0,9,0,-9
24664,1,0,14,0,-14
24665,1,0,57,0,-57
24666,1,0,14,0,-14
24667,1,1,158,1875,1717
24668,1,0,35,0,-35
24669,1,1,1285,1528,243
24670,1,0,291,0,-291
24671,1,0,3,0,-3
24672,1,1,631,1605,974
24673,0,0,0,0,0
24674,1,1,925,1219,294
24675,1,0,43,0,-43
24676,1,1,861,1227,366
24677,0,0,64,0,-64
24678,0,0,86,0,-86
24679,1,1,782,1427,645
24680,1,0,26,0,-26
24681,0,0,75,0,-75
24682,0,0,49,0,-49
24683,1,0,44,0,-44
24684,0,0,102,0,-102
24685,0,0,115,0,-115
24686,1,1,74,1928,1854
24687,1,0,61,0,-61
24688,0,0,11,0,-11
24689,0,0,25,0,-25
24690,0,0,51,0,-51
24691,1,0,5,0,-5
24692,1,0,64,0,-64
24693,0,0,44,0,-44
24694,1,1,895,4307,3412
24695,0,0,5,0,-5
24696,1,1,1803,2720,917
24697,1,1,424,1474,1050
24698,0,0,74,0,-74
24699,1,1,874,1221,347
24700,0,0,33,0,-33
24701,1,0,7,0,-7
24702,1,1,719,2178,1459
24703,1,1,147,1438,1291
24704,0,0,5,0,-5
24705,1,1,215,1202,987
24706,0,0,243,0,-243
24707,1,1,1385,1953,568
24708,1,1,188,1754,1566
24709,1,0,25,0,-25
24710,1,1,148,1631,1483
24711,0,0,23,0,-23
24712,1,1,485,1350,865
24713,0,0,10,0,-10
24714,1,1,744,1254,510
24715,0,0,157,0,-157
24716,0,0,12,0,-12
24717,1,1,1267,1248,-19
24718,0,0,7,0,-7
24719,1,1,982,1365,383
24720,0,0,3,0,-3
24721,0,0,60,0,-60
24722,0,0,1,0,-1
24723,0,0,0,0,0
24724,0,0,3,0,-3
24725,0,0,5,0,-5
24726,0,0,103,0,-103
24727,1,0,17,0,-17
24728,1,0,56,0,-56
24729,1,1,1171,1808,637
24730,0,0,79,0,-79
24731,0,0,12,0,-12
24732,1,0,3,0,-3
24733,1,1,98,1455,1357
24734,0,0,115,0,-115
24735,1,1,215,1464,1249
24736,1,0,53,0,-53
24737,0,0,23,0,-23
24738,0,0,9,0,-9
24739,0,0,1,0,-1
24740,1,1,45,1417,1372
24741,1,0,18,0,-18
24742,1,1,937,1230,293
24743,0,0,77,0,-77
24744,0,0,30,0,-30
24745,1,1,871,3979,3108
24746,1,0,36,0,-36
24747,0,0,207,0,-207
24748,1,0,27,0,-27
24749,1,0,54,0,-54
24750,1,0,86,0,-86
24751,1,1,200,1365,1165
24752,1,0,29,0,-29
24753,1,0,56,0,-56
24754,1,0,117,0,-117
24755,0,0,47,0,-47
24756,1,0,56,0,-56
24757,0,0,0,0,0
24758,1,0,203,0,-203
24759,1,0,100,0,-100
24760,1,1,664,1447,783
24761,0,0,13,0,-13
24762,1,1,827,1424,597
24763,1,0,19,0,-19
24764,1,1,60,1362,1302
24765,1,0,68,0,-68
24766,0,0,107,0,-107
24767,1,1,330,1256,926
24768,0,0,74,0,-74
24769,0,0,33,0,-33
24770,0,0,47,0,-47
24771,1,0,18,0,-18
24772,1,1,219,1698,1479
24773,1,0,2,0,-2
24774,1,0,41,0,-41
24775,0,0,10,0,-10
24776,1,0,120,0,-120
24777,1,0,7,0,-7
24778,1,1,602,1630,1028
24779,1,1,582,1841,1259
24780,1,1,1023,1344,321
24781,0,0,9,0,-9
24782,0,0,71,0,-71
24783,1,1,341,1285,944
24784,0,0,25,0,-25
24785,0,0,33,0,-33
24786,1,0,4,0,-4
24787,0,0,4,0,-4
24788,1,0,33,0,-33
24789,0,0,43,0,-43
24790,0,0,61,0,-61
24791,0,0,7,0,-7
24792,1,0,42,0,-42
24793,1,1,1726,1310,-416
24794,0,0,52,0,-52
24795,1,0,39,0,-39
24796,0,0,85,0,-85
24797,0,0,25,0,-25
24798,1,1,1053,1441,388
24799,1,0,28,0,-28
24800,1,1,136,1326,1190
24801,0,0,0,0,0
24802,0,0,17,0,-17
24803,0,0,42,0,-42
24804,0,0,61,0,-61
24805,0,0,16,0,-16
24806,1,0,61,0,-61
24807,0,0,42,0,-42
24808,1,1,972,1264,292
24809,1,1,212,1344,1132
24810,0,0,1,0,-1
24811,1,1,418,1757,1339
24812,1,1,172,1559,1387
24813,0,0,71,0,-71
24814,0,0,23,0,-23
24815,1,0,13,0,-13
24816,0,0,10,0,-10
24817,1,1,944,1207,263
24818,1,1,94,1287,1193
24819,0,0,71,0,-71
24820,1,0,43,0,-43
24821,1,1,915,1488,573
24822,1,1,2646,1957,-689
24823,1,0,46,0,-46
24824,1,1,174,1207,1033
24825,1,1,113,1217,1104
24826,0,0,3,0,-3
24827,1,0,23,0,-23
24828,0,0,63,0,-63
24829,0,0,151,0,-151
24830,0,0,17,0,-17
24831,0,0,40,0,-40
24832,0,0,37,0,-37
24833,0,0,49,0,-49
24834,1,0,14,0,-14
24835,1,1,27,1401,1374
24836,0,0,27,0,-27
24837,0,0,17,0,-17
24838,1,0,20,0,-20
24839,1,0,26,0,-26
24840,0,0,19,0,-19
24841,1,0,97,0,-97
24842,0,0,7,0,-7
24843,1,0,33,0,-33
24844,1,1,852,1351,499
24845,0,0,49,0,-49
24846,0,0,21,0,-21
24847,0,0,49,0,-49
24848,0,0,133,0,-133
24849,0,0,13,0,-13
24850,0,0,82,0,-82
24851,1,0,72,0,-72
24852,1,1,175,2973,2798
24853,0,0,33,0,-33
24854,1,0,34,0,-34
24855,0,0,73,0,-73
24856,1,0,179,0,-179
24857,1,0,52,0,-52
24858,0,0,27,0,-27
24859,0,0,6,0,-6
24860,0,0,96,0,-96
24861,1,0,151,0,-151
24862,0,0,80,0,-80
24863,1,0,39,0,-39
24864,1,0,85,0,-85
24865,1,0,40,0,-40
24866,0,0,139,0,-139
24867,1,0,20,0,-20
24868,1,0,276,0,-276
24869,1,0,12,0,-12
24870,1,1,77,3845,3768
24871,1,1,1255,1223,-32
24872,0,0,167,0,-167
24873,1,1,236,1387,1151
24874,1,1,209,1747,1538
24875,0,0,95,0,-95
24876,0,0,68,0,-68
24877,1,0,73,0,-73
24878,0,0,30,0,-30
24879,1,1,242,1292,1050
24880,1,0,75,0,-75
24881,0,0,10,0,-10
24882,1,0,100,0,-100
24883,1,1,421,1764,1343
24884,1,1,117,1867,1750
24885,1,1,1295,1273,-22
24886,1,1,441,1261,820
24887,0,0,91,0,-91
24888,0,0,37,0,-37
24889,0,0,96,0,-96
24890,0,0,3,0,-3
24891,1,1,986,1957,971
24892,1,1,937,1330,393
24893,0,0,0,0,0
24894,1,1,144,1732,1588
24895,1,0,36,0,-36
24896,1,0,72,0,-72
24897,1,1,205,1229,1024
24898,1,1,259,1489,1230
24899,1,0,77,0,-77
24900,1,0,37,0,-37
24901,0,0,28,0,-28
24902,1,0,94,0,-94
24903,0,0,44,0,-44
24904,1,1,203,1206,1003
24905,1,0,115,0,-115
24906,1,1,492,1257,765
24907,1,0,41,0,-41
24908,0,0,10,0,-10
24909,1,0,6,0,-6
24910,1,1,589,1399,810
24911,1,1,416,1293,877
24912,1,1,663,1409,746
24913,0,0,22,0,-22
24914,1,0,0,0,0
24915,1,0,0,0,0
24916,0,0,61,0,-61
24917,1,1,844,1484,640
24918,0,0,114,0,-114
24919,0,0,19,0,-19
24920,1,0,40,0,-40
24921,1,1,748,1266,518
24922,1,1,1013,2144,1131
24923,0,0,3,0,-3
24924,1,1,1414,1398,-16
24925,1,0,15,0,-15
24926,0,0,102,0,-102
24927,0,0,28,0,-28
24928,0,0,54,0,-54
24929,1,0,16,0,-16
24930,1,0,1,0,-1
24931,0,0,25,0,-25
24932,1,0,0,0,0
24933,0,0,24,0,-24
24934,1,0,4,0,-4
24935,0,0,204,0,-204
24936,1,0,172,0,-172
24937,1,0,2,0,-2
24938,0,0,36,0,-36
24939,0,0,79,0,-79
24940,1,0,0,0,0
24941,0,0,51,0,-51
24942,1,0,41,0,-41
24943,1,0,153,0,-153
24944,1,0,32,0,-32
24945,0,0,2,0,-2
24946,1,1,92,1315,1223
24947,0,0,1,0,-1
24948,1,0,115,0,-115
24949,1,0,27,0,-27
24950,0,0,14,0,-14
24951,1,1,672,1403,731
24952,1,1,1419,1444,25
24953,0,0,44,0,-44
24954,1,1,1107,1248,141
24955,0,0,153,0,-153
24956,1,0,68,0,-68
24957,1,1,1385,2113,728
24958,0,0,52,0,-52
24959,1,0,16,0,-16
24960,0,0,3,0,-3
24961,1,1,782,1907,1125
24962,1,0,5,0,-5
24963,0,0,64,0,-64
24964,0,0,5,0,-5
24965,0,0,74,0,-74
24966,1,1,434,1436,1002
24967,1,0,13,0,-13
24968,1,0,6,0,-6
24969,1,1,855,1270,415
24970,1,1,766,1452,686
24971,0,0,63,0,-63
24972,0,0,9,0,-9
24973,1,1,1458,1445,-13
24974,1,1,512,2992,2480
24975,0,0,35,0,-35
24976,1,1,1003,1254,251
24977,0,0,53,0,-53
24978,1,1,2572,1295,-1277
24979,1,1,38,1495,1457
24980,1,1,419,1456,1037
24981,0,0,43,0,-43
24982,1,1,354,1398,1044
24983,1,0,45,0,-45
24984,0,0,1,0,-1
24985,1,1,336,1324,988
24986,1,0,2,0,-2
24987,1,1,90,1483,1393
24988,0,0,15,0,-15
24989,1,0,13,0,-13
24990,0,0,14,0,-14
24991,0,0,18,0,-18
24992,1,1,298,1968,1670
24993,0,0,47,0,-47
24994,1,1,368,1240,872
24995,0,0,29,0,-29
24996,0,0,71,0,-71
24997,1,0,35,0,-35
24998,1,1,389,1380,991
24999,0,0,47,0,-47
25000,1,1,1718,1594,-124
25001,0,0,48,0,-48
25002,1,1,555,1449,894
25003,1,0,1,0,-1
25004,0,0,54,0,-54
25005,1,0,111,0,-111
25006,0,0,11,0,-11
25007,0,0,11,0,-11
25008,0,0,19,0,-19
25009,1,0,44,0,-44
25010,1,0,15,0,-15
25011,0,0,0,0,0
25012,0,0,103,0,-103
25013,0,0,18,0,-18
25014,0,0,84,0,-84
25015,1,0,8,0,-8
25016,0,0,47,0,-47
25017,1,0,7,0,-7
25018,1,1,389,1318,929
25019,1,1,200,1269,1069
25020,0,0,52,0,-52
25021,1,0,109,0,-109
25022,1,0,69,0,-69
25023,1,1,36,2172,2136
25024,1,1,783,1246,463
25025,0,0,63,0,-63
25026,1,1,2682,1310,-1372
25027,1,0,41,0,-41
25028,0,0,5,0,-5
25029,0,0,11,0,-11
25030,1,0,36,0,-36
25031,1,0,6,0,-6
25032,0,0,5,0,-5
25033,1,0,43,0,-43
25034,1,1,277,1550,1273
25035,0,0,10,0,-10
25036,1,0,31,0,-31
25037,1,0,28,0,-28
25038,1,0,17,0,-17
25039,1,1,400,1422,1022
25040,1,1,295,1202,907
25041,1,1,478,1750,1272
25042,1,1,302,1296,994
25043,1,0,5,0,-5
25044,0,0,238,0,-238
25045,0,0,13,0,-13
25046,1,0,26,0,-26
25047,1,0,56,0,-56
25048,1,0,21,0,-21
25049,1,1,2001,1347,-654
25050,1,1,11,1372,1361
25051,0,0,141,0,-141
25052,0,0,40,0,-40
25053,1,0,29,0,-29
25054,1,1,11,1421,1410
25055,0,0,3,0,-3
25056,1,1,225,1258,1033
25057,1,0,132,0,-132
25058,1,0,13,0,-13
25059,1,0,42,0,-42
25060,0,0,59,0,-59
25061,1,0,16,0,-16
25062,1,1,230,1529,1299
25063,1,0,34,0,-34
25064,1,1,923,1281,358
25065,0,0,41,0,-41
25066,0,0,42,0,-42
25067,1,1,342,1234,892
25068,0,0,43,0,-43
25069,1,1,409,1242,833
25070,1,1,680,1257,577
25071,0,0,85,0,-85
25072,1,0,187,0,-187
25073,1,0,70,0,-70
25074,1,1,799,1526,727
25075,1,0,127,0,-127
25076,1,1,1984,1227,-757
25077,1,1,361,1417,1056
25078,1,0,36,0,-36
25079,1,0,33,0,-33
25080,1,0,14,0,-14
25081,1,1,158,1240,1082
25082,1,0,25,0,-25
25083,1,0,19,0,-19
25084,0,0,18,0,-18
25085,1,1,218,1421,1203
25086,1,1,182,2658,2476
25087,0,0,67,0,-67
25088,1,1,1611,1292,-319
25089,1,1,1698,2122,424
25090,0,0,100,0,-100
25091,1,0,158,0,-158
25092,1,1,139,1444,1305
25093,1,0,133,0,-133
25094,1,1,328,1309,981
25095,0,0,39,0,-39
25096,0,0,28,0,-28
25097,0,0,83,0,-83
25098,1,1,814,1641,827
25099,1,0,39,0,-39
25100,1,1,604,1283,679
25101,0,0,6,0,-6
25102,0,0,15,0,-15
25103,0,0,101,0,-101
25104,1,1,59,1733,1674
25105,1,0,59,0,-59
25106,1,1,2172,1349,-823
25107,0,0,30,0,-30
25108,1,1,603,1220,617
25109,0,0,31,0,-31
25110,0,0,122,0,-122
25111,1,0,16,0,-16
25112,0,0,36,0,-36
25113,0,0,22,0,-22
25114,0,0,61,0,-61
25115,0,0,40,0,-40
25116,0,0,103,0,-103
25117,1,1,588,1407,819
25118,1,0,6,0,-6
25119,1,1,981,1411,430
25120,0,0,97,0,-97
25121,1,1,666,1244,578
25122,1,0,1,0,-1
25123,1,1,233,1226,993
25124,1,1,132,1327,1195
25125,1,0,46,0,-46
25126,0,0,19,0,-19
25127,1,1,259,1465,1206
25128,0,0,104,0,-104
25129,1,1,216,1968,1752
25130,0,0,49,0,-49
25131,0,0,9,0,-9
25132,1,0,59,0,-59
25133,1,1,708,1282,574
25134,1,1,1306,1356,50
25135,1,1,1105,1528,423
25136,1,1,469,1804,1335
25137,1,1,116,1647,1531
25138,1,0,2,0,-2
25139,0,0,24,0,-24
25140,1,0,53,0,-53
25141,1,1,281,1284,1003
25142,1,1,706,1283,577
25143,1,1,324,1765,1441
25144,1,0,21,0,-21
25145,1,1,349,1920,1571
25146,1,0,2,0,-2
25147,1,0,53,0,-53
25148,0,0,57,0,-57
25149,1,1,656,1345,689
25150,0,0,28,0,-28
25151,1,1,117,1410,1293
25152,1,1,187,1513,1326
25153,1,1,878,1448,570
25154,0,0,35,0,-35
25155,0,0,51,0,-51
25156,0,0,129,0,-129
25157,1,0,224,0,-224
25158,1,0,38,0,-38
25159,1,1,702,1486,784
25160,1,0,35,0,-35
25161,1,1,1843,4468,2625
25162,1,0,63,0,-63
25163,1,0,83,0,-83
25164,0,0,4,0,-4
25165,0,0,0,0,0
25166,1,1,351,1465,1114
25167,1,0,3,0,-3
25168,0,0,14,0,-14
25169,1,1,733,1390,657
25170,0,0,106,0,-106
25171,1,0,90,0,-90
25172,0,0,29,0,-29
25173,0,0,12,0,-12
25174,1,1,1193,1307,114
25175,1,1,798,1385,587
25176,1,1,176,1691,1515
25177,1,0,76,0,-76
25178,1,1,1429,1448,19
25179,0,0,42,0,-42
25180,0,0,64,0,-64
25181,1,1,717,1301,584
25182,0,0,134,0,-134
25183,0,0,5,0,-5
25184,0,0,81,0,-81
25185,0,0,39,0,-39
25186,1,1,1527,1385,-142
25187,0,0,294,0,-294
25188,1,0,11,0,-11
25189,0,0,23,0,-23
25190,0,0,3,0,-3
25191,1,0,30,0,-30
25192,1,0,6,0,-6
25193,1,0,106,0,-106
25194,1,0,136,0,-136
25195,1,1,100,1724,1624
25196,0,0,41,0,-41
25197,1,0,56,0,-56
25198,1,0,25,0,-25
25199,0,0,37,0,-37
25200,1,0,0,0,0
25201,0,0,103,0,-103
25202,0,0,53,0,-53
25203,1,1,361,1650,1289
25204,0,0,70,0,-70
25205,0,0,20,0,-20
25206,1,0,28,0,-28
25207,0,0,2,0,-2
25208,1,1,141,1220,1079
25209,1,0,24,0,-24
25210,0,0,11,0,-11
25211,1,0,18,0,-18
25212,1,0,116,0,-116
25213,0,0,29,0,-29
25214,1,1,162,3015,2853
25215,1,0,20,0,-20
25216,1,1,713,1591,878
25217,0,0,2,0,-2
25218,0,0,131,0,-131
25219,0,0,30,0,-30
25220,1,0,23,0,-23
25221,0,0,12,0,-12
25222,1,1,288,2353,2065
25223,1,1,89,1273,1184
25224,0,0,5,0,-5
25225,0,0,127,0,-127
25226,1,1,1361,1255,-106
25227,0,0,72,0,-72
25228,1,1,1170,1426,256
25229,1,1,187,1912,1725
25230,0,0,18,0,-18
25231,0,0,7,0,-7
25232,1,1,387,1796,1409
25233,1,0,27,0,-27
25234,0,0,42,0,-42
25235,0,0,95,0,-95
25236,1,1,36,1328,1292
25237,1,1,401,1308,907
25238,1,1,311,1321,1010
25239,1,1,379,1302,923
25240,0,0,22,0,-22
25241,0,0,117,0,-117
25242,1,1,382,1341,959
25243,1,0,106,0,-106
25244,1,0,9,0,-9
25245,1,1,144,1843,1699
25246,0,0,65,0,-65
25247,1,1,263,1418,1155
25248,1,1,1183,1695,512
25249,1,1,843,2520,1677
25250,1,0,13,0,-13
25251,1,1,85,1589,1504
25252,0,0,49,0,-49
25253,1,0,0,0,0
25254,0,0,18,0,-18
25255,1,1,588,2298,1710
25256,0,0,84,0,-84
25257,1,1,112,1212,1100
25258,0,0,18,0,-18
25259,1,1,36,1342,1306
25260,1,1,527,1322,795
25261,0,0,2,0,-2
25262,0,0,11,0,-11
25263,1,0,139,0,-139
25264,1,0,23,0,-23
25265,0,0,132,0,-132
25266,1,1,402,2992,2590
25267,0,0,3,0,-3
25268,0,0,9,0,-9
25269,0,0,37,0,-37
25270,1,1,309,1402,1093
25271,0,0,150,0,-150
25272,1,1,227,1552,1325
25273,1,1,1683,1226,-457
25274,1,1,97,1299,1202
25275,1,1,263,2674,2411
25276,1,1,473,1773,1300
25277,1,1,714,1207,493
25278,0,0,56,0,-56
25279,1,1,38,2115,2077
25280,0,0,162,0,-162
25281,1,1,263,1370,1107
25282,0,0,90,0,-90
25283,1,1,924,3635,2711
25284,0,0,53,0,-53
25285,1,0,46,0,-46
25286,1,1,110,1278,1168
25287,1,1,500,1326,826
25288,0,0,29,0,-29
25289,0,0,36,0,-36
25290,1,0,1,0,-1
25291,0,0,13,0,-13
25292,1,0,64,0,-64
25293,0,0,7,0,-7
25294,0,0,25,0,-25
25295,0,0,83,0,-83
25296,1,1,224,1544,1320
25297,1,0,22,0,-22
25298,1,0,42,0,-42
25299,0,0,46,0,-46
25300,1,1,362,1269,907
25301,0,0,96,0,-96
25302,0,0,27,0,-27
25303,1,0,19,0,-19
25304,0,0,64,0,-64
25305,1,1,579,1812,1233
25306,0,0,9,0,-9
25307,1,1,356,1469,1113
25308,0,0,53,0,-53
25309,0,0,101,0,-101
25310,1,0,5,0,-5
25311,0,0,42,0,-42
25312,0,0,34,0,-34
25313,1,1,23,1276,1253
25314,1,1,82,2337,2255
25315,0,0,31,0,-31
25316,0,0,14,0,-14
25317,0,0,0,0,0
25318,1,1,521,1254,733
25319,1,1,1400,1620,220
25320,0,0,4,0,-4
25321,1,1,1270,1376,106
25322,0,0,88,0,-88
25323,1,1,950,1221,271
25324,0,0,139,0,-139
25325,1,1,884,1252,368
25326,0,0,14,0,-14
25327,0,0,58,0,-58
25328,1,0,6,0,-6
25329,0,0,8,0,-8
25330,0,0,38,0,-38
25331,0,0,129,0,-129
25332,1,0,10,0,-10
25333,1,1,136,1774,1638
25334,1,0,72,0,-72
25335,1,1,52,1302,1250
25336,0,0,81,0,-81
25337,1,1,682,1415,733
25338,0,0,14,0,-14
25339,0,0,5,0,-5
25340,1,1,127,1413,1286
25341,1,1,1477,1762,285
25342,1,1,147,2215,2068
25343,1,1,27,1290,1263
25344,1,1,231,1271,1040
25345,1,0,8,0,-8
25346,1,1,464,1378,914
25347,0,0,29,0,-29
25348,1,0,44,0,-44
25349,0,0,69,0,-69
25350,1,1,197,1475,1278
25351,1,0,25,0,-25
25352,1,1,524,1228,704
25353,1,0,171,0,-171
25354,0,0,16,0,-16
25355,1,1,464,1214,750
25356,1,0,15,0,-15
25357,0,0,36,0,-36
25358,0,0,142,0,-142
25359,0,0,15,0,-15
25360,1,0,19,0,-19
25361,1,1,211,1246,1035
25362,1,0,11,0,-11
25363,1,0,42,0,-42
25364,0,0,37,0,-37
25365,1,1,793,3216,2423
25366,1,0,28,0,-28
25367,1,0,50,0,-50
25368,0,0,2,0,-2
25369,1,0,87,0,-87
25370,0,0,29,0,-29
25371,0,0,6,0,-6
25372,1,1,676,1212,536
25373,0,0,78,0,-78
25374,1,0,7,0,-7
25375,0,0,45,0,-45
25376,1,1,241,1212,971
25377,1,0,123,0,-123
25378,0,0,46,0,-46
25379,0,0,46,0,-46
25380,0,0,1,0,-1
25381,0,0,5,0,-5
25382,1,1,603,1632,1029
25383,1,1,268,1407,1139
25384,1,1,608,1218,610
25385,1,1,591,1290,699
25386,1,0,65,0,-65
25387,0,0,22,0,-22
25388,1,0,110,0,-110
25389,1,1,89,1252,1163
25390,1,1,326,1991,1665
25391,1,0,15,0,-15
25392,0,0,89,0,-89
25393,1,0,54,0,-54
25394,0,0,34,0,-34
25395,0,0,53,0,-53
25396,0,0,65,0,-65
25397,1,1,1029,1553,524
25398,1,0,36,0,-36
25399,1,0,4,0,-4
25400,1,1,939,1249,310
25401,1,1,606,1283,677
25402,1,1,18,1710,1692
25403,1,0,135,0,-135
25404,1,1,2167,1392,-775
25405,1,1,256,2307,2051
25406,1,0,142,0,-142
25407,0,0,25,0,-25
25408,1,0,24,0,-24
25409,1,1,45,1552,1507
25410,1,1,357,1524,1167
25411,1,0,8,0,-8
25412,0,0,22,0,-22
25413,1,0,3,0,-3
25414,0,0,16,0,-16
25415,0,0,62,0,-62
25416,1,1,181,1222,1041
25417,1,1,1191,1258,67
25418,0,0,25,0,-25
25419,1,1,728,1396,668
25420,1,1,1091,1456,365
25421,1,1,225,1387,1162
25422,0,0,31,0,-31
25423,1,1,296,1423,1127
25424,0,0,25,0,-25
25425,1,1,466,1516,1050
25426,1,0,19,0,-19
25427,1,0,92,0,-92
25428,1,1,529,1356,827
25429,0,0,84,0,-84
25430,1,0,74,0,-74
25431,1,1,666,1827,1161
25432,1,1,16,1211,1195
25433,1,1,242,2136,1894
25434,1,1,335,1262,927
25435,0,0,52,0,-52
25436,1,0,22,0,-22
25437,0,0,190,0,-190
25438,1,1,247,1692,1445
25439,1,0,1,0,-1
25440,1,1,822,1786,964
25441,1,0,47,0,-47
25442,1,0,40,0,-40
25443,0,0,22,0,-22
25444,1,1,961,1461,500
25445,1,0,2,0,-2
25446,1,0,3,0,-3
25447,0,0,17,0,-17
25448,1,1,762,1301,539
25449,1,1,100,1517,1417
25450,1,1,284,1346,1062
25451,1,1,1890,1415,-475
25452,1,1,197,1816,1619
25453,0,0,8,0,-8
25454,1,0,7,0,-7
25455,0,0,73,0,-73
25456,1,1,128,2065,1937
25457,1,1,278,1447,1169
25458,1,0,6,0,-6
25459,0,0,49,0,-49
25460,1,0,27,0,-27
25461,1,0,12,0,-12
25462,0,0,76,0,-76
25463,1,1,761,1431,670
25464,1,1,85,1265,1180
25465,0,0,24,0,-24
25466,0,0,300,0,-300
25467,1,0,84,0,-84
25468,1,1,37,1659,1622
25469,1,1,466,1252,786
25470,1,1,400,1789,1389
25471,1,1,520,1330,810
25472,1,1,727,1380,653
25473,1,1,616,1257,641
25474,1,0,22,0,-22
25475,1,1,1811,1276,-535
25476,0,0,8,0,-8
25477,1,1,117,1287,1170
25478,1,1,1560,1491,-69
25479,1,1,461,1929,1468
25480,1,1,1410,1801,391
25481,1,1,115,1354,1239
25482,0,0,6,0,-6
25483,1,1,2273,1497,-776
25484,1,0,197,0,-197
25485,1,0,9,0,-9
25486,1,1,795,1659,864
25487,1,1,787,1404,617
25488,1,0,162,0,-162
25489,1,0,13,0,-13
25490,1,1,150,2197,2047
25491,0,0,99,0,-99
25492,1,1,142,1524,1382
25493,0,0,71,0,-71
25494,1,0,209,0,-209
25495,0,0,68,0,-68
25496,1,1,360,1241,881
25497,0,0,76,0,-76
25498,1,1,749,1256,507
25499,1,1,61,1220,1159
25500,1,0,21,0,-21
25501,1,1,475,1382,907
25502,0,0,99,0,-99
25503,0,0,205,0,-205
25504,0,0,69,0,-69
25505,1,0,1,0,-1
25506,0,0,59,0,-59
25507,1,1,797,1254,457
25508,1,0,32,0,-32
25509,0,0,30,0,-30
25510,0,0,32,0,-32
25511,0,0,23,0,-23
25512,0,0,290,0,-290
25513,0,0,24,0,-24
25514,1,1,364,1516,1152
25515,0,0,6,0,-6
25516,0,0,3,0,-3
25517,0,0,12,0,-12
25518,1,0,82,0,-82
25519,0,0,203,0,-203
25520,1,0,39,0,-39
25521,1,0,124,0,-124
25522,0,0,56,0,-56
25523,1,1,152,1219,1067
25524,0,0,3,0,-3
25525,0,0,5,0,-5
25526,0,0,44,0,-44
25527,1,1,255,1712,1457
25528,0,0,58,0,-58
25529,0,0,18,0,-18
25530,1,0,29,0,-29
25531,1,1,69,1285,1216
25532,0,0,97,0,-97
25533,1,1,147,1499,1352
25534,0,0,12,0,-12
25535,1,0,35,0,-35
25536,1,1,161,2178,2017
25537,0,0,68,0,-68
25538,1,0,20,0,-20
25539,1,1,984,1473,489
25540,1,1,149,1450,1301
25541,0,0,9,0,-9
25542,0,0,51,0,-51
25543,1,1,1108,1958,850
25544,1,0,19,0,-19
25545,0,0,30,0,-30
25546,0,0,78,0,-78
25547,0,0,0,0,0
25548,0,0,40,0,-40
25549,1,1,2343,1259,-1084
25550,0,0,49,0,-49
25551,1,1,666,1688,1022
25552,0,0,4,0,-4
25553,0,0,44,0,-44
25554,0,0,50,0,-50
25555,1,1,295,1204,909
25556,0,0,136,0,-136
25557,0,0,158,0,-158
25558,0,0,28,0,-28
25559,0,0,107,0,-107
25560,0,0,5,0,-5
25561,0,0,34,0,-34
25562,1,0,14,0,-14
25563,1,1,85,1419,1334
25564,0,0,9,0,-9
25565,1,0,38,0,-38
25566,0,0,136,0,-136
25567,1,0,18,0,-18
25568,0,0,32,0,-32
25569,1,0,47,0,-47
25570,1,0,32,0,-32
25571,1,1,302,1401,1099
25572,0,0,5,0,-5
25573,0,0,42,0,-42
25574,1,1,301,2242,1941
25575,0,0,2,0,-2
25576,1,1,1763,3541,1778
25577,1,1,1062,1376,314
25578,1,1,325,1268,943
25579,1,0,9,0,-9
25580,0,0,13,0,-13
25581,1,0,36,0,-36
25582,1,1,986,1367,381
25583,0,0,0,0,0
25584,1,1,347,1966,1619
25585,0,0,67,0,-67
25586,1,1,195,1299,1104
25587,0,0,26,0,-26
25588,0,0,182,0,-182
25589,0,0,41,0,-41
25590,1,1,675,1964,1289
25591,1,1,1672,1297,-375
25592,1,1,1013,1444,431
25593,0,0,52,0,-52
25594,0,0,51,0,-51
25595,0,0,37,0,-37
25596,1,1,164,2174,2010
25597,0,0,33,0,-33
25598,1,1,85,2000,1915
25599,1,1,172,1368,1196
25600,0,0,32,0,-32
25601,0,0,148,0,-148
25602,1,1,769,1604,835
25603,0,0,39,0,-39
25604,0,0,49,0,-49
25605,0,0,11,0,-11
25606,0,0,22,0,-22
25607,0,0,117,0,-117
25608,0,0,119,0,-119
25609,0,0,15,0,-15
25610,0,0,83,0,-83
25611,1,1,546,1496,950
25612,1,1,431,1209,778
25613,0,0,72,0,-72
25614,1,1,1192,1575,383
25615,1,0,40,0,-40
25616,0,0,131,0,-131
25617,1,1,736,1205,469
25618,1,1,924,1240,316
25619,1,1,235,1967,1732
25620,0,0,70,0,-70
25621,0,0,99,0,-99
25622,1,1,474,1674,1200
25623,1,1,621,1222,601
25624,0,0,79,0,-79
25625,1,0,20,0,-20
25626,1,1,2394,1417,-977
25627,0,0,82,0,-82
25628,0,0,15,0,-15
25629,0,0,12,0,-12
25630,0,0,12,0,-12
25631,1,1,203,1207,1004
25632,0,0,30,0,-30
25633,1,0,47,0,-47
25634,0,0,26,0,-26
25635,0,0,23,0,-23
25636,0,0,19,0,-19
25637,0,0,11,0,-11
25638,0,0,4,0,-4
25639,1,0,126,0,-126
25640,1,0,8,0,-8
25641,0,0,56,0,-56
25642,0,0,19,0,-19
25643,1,0,49,0,-49
25644,1,1,295,1337,1042
25645,1,0,17,0,-17
25646,0,0,30,0,-30
25647,0,0,1,0,-1
25648,1,0,70,0,-70
25649,0,0,28,0,-28
25650,0,0,30,0,-30
25651,1,0,48,0,-48
25652,1,0,14,0,-14
25653,0,0,28,0,-28
25654,1,1,466,1487,1021
25655,1,1,199,1461,1262
25656,0,0,101,0,-101
25657,1,0,23,0,-23
25658,0,0,21,0,-21
25659,0,0,123,0,-123
25660,1,0,27,0,-27
25661,0,0,6,0,-6
25662,0,0,9,0,-9
25663,1,1,261,1662,1401
25664,1,1,1574,1245,-329
25665,0,0,7,0,-7
25666,1,0,35,0,-35
25667,1,1,411,1255,844
25668,1,0,162,0,-162
25669,0,0,161,0,-161
25670,1,1,871,1887,1016
25671,1,0,2,0,-2
25672,1,1,295,1288,993
25673,1,0,23,0,-23
25674,0,0,176,0,-176
25675,1,1,791,1481,690
25676,1,1,262,1310,1048
25677,1,0,23,0,-23
25678,1,0,110,0,-110
25679,0,0,10,0,-10
25680,0,0,1,0,-1
25681,1,0,74,0,-74
25682,1,1,171,1264,1093
25683,1,0,29,0,-29
25684,0,0,22,0,-22
25685,1,1,876,2199,1323
25686,1,0,1,0,-1
25687,1,0,14,0,-14
25688,1,0,116,0,-116
25689,1,0,195,0,-195
25690,0,0,64,0,-64
25691,0,0,55,0,-55
25692,1,0,67,0,-67
25693,1,1,821,1272,451
25694,1,1,328,1389,1061
25695,1,1,944,1220,276
25696,0,0,20,0,-20
25697,1,0,10,0,-10
25698,1,0,143,0,-143
25699,1,0,114,0,-114
25700,1,1,345,1262,917
25701,1,1,439,1314,875
25702,1,1,513,1917,1404
25703,1,0,28,0,-28
25704,1,1,372,1270,898
25705,0,0,7,0,-7
25706,1,1,311,1287,976
25707,1,1,2050,1286,-764
25708,1,1,693,1541,848
25709,0,0,47,0,-47
25710,1,1,176,1367,1191
25711,1,0,4,0,-4
25712,1,1,979,1409,430
25713,1,0,32,0,-32
25714,0,0,5,0,-5
25715,1,0,56,0,-56
25716,0,0,47,0,-47
25717,1,0,110,0,-110
25718,0,0,36,0,-36
25719,0,0,60,0,-60
25720,1,1,32,2338,2306
25721,1,1,375,1486,1111
25722,1,1,651,2497,1846
25723,0,0,192,0,-192
25724,1,1,388,1213,825
25725,1,1,472,1258,786
25726,1,1,725,1916,1191
25727,0,0,21,0,-21
25728,1,1,326,1498,1172
25729,1,0,69,0,-69
25730,1,1,178,1252,1074
25731,1,0,14,0,-14
25732,1,0,120,0,-120
25733,0,0,48,0,-48
25734,1,1,176,1365,1189
25735,1,1,1372,3086,1714
25736,0,0,16,0,-16
25737,0,0,6,0,-6
25738,1,1,1442,1207,-235
25739,1,0,80,0,-80
25740,1,1,375,1571,1196
25741,1,0,3,0,-3
25742,1,0,29,0,-29
25743,1,1,91,1720,1629
25744,0,0,80,0,-80
25745,0,0,56,0,-56
25746,1,0,8,0,-8
25747,1,1,271,1281,1010
25748,0,0,61,0,-61
25749,1,0,17,0,-17
25750,1,1,222,1301,1079
25751,0,0,19,0,-19
25752,0,0,0,0,0
25753,0,0,10,0,-10
25754,1,0,0,0,0
25755,0,0,10,0,-10
25756,1,1,365,2114,1749
25757,1,0,34,0,-34
25758,1,0,51,0,-51
25759,1,0,65,0,-65
25760,1,1,391,1455,1064
25761,0,0,8,0,-8
25762,1,0,20,0,-20
25763,1,1,326,1272,946
25764,0,0,17,0,-17
25765,1,1,908,1633,725
25766,1,0,27,0,-27
25767,1,0,25,0,-25
25768,0,0,212,0,-212
25769,0,0,3,0,-3
25770,1,1,1575,2303,728
25771,1,1,469,1345,876
25772,1,1,65,1343,1278
25773,0,0,9,0,-9
25774,1,1,361,1617,1256
25775,0,0,28,0,-28
25776,0,0,49,0,-49
25777,1,1,965,1581,616
25778,1,1,764,1218,454
25779,0,0,5,0,-5
25780,1,1,749,1205,456
25781,1,0,63,0,-63
25782,1,0,8,0,-8
25783,1,0,47,0,-47
25784,0,0,13,0,-13
25785,0,0,26,0,-26
25786,1,0,111,0,-111
25787,0,0,48,0,-48
25788,0,0,7,0,-7
25789,1,1,184,1872,1688
25790,1,0,86,0,-86
25791,1,0,4,0,-4
25792,1,1,408,1885,1477
25793,1,0,47,0,-47
25794,0,0,19,0,-19
25795,0,0,11,0,-11
25796,1,0,15,0,-15
25797,1,1,553,1313,760
25798,1,1,1264,1353,89
25799,1,1,330,1409,1079
25800,1,0,6,0,-6
25801,1,1,109,1294,1185
25802,1,0,57,0,-57
25803,1,1,306,7395,7089
25804,1,0,14,0,-14
25805,1,0,9,0,-9
25806,1,0,69,0,-69
25807,1,0,15,0,-15
25808,0,0,57,0,-57
25809,1,0,82,0,-82
25810,1,0,9,0,-9
25811,0,0,46,0,-46
25812,1,0,46,0,-46
25813,0,0,40,0,-40
25814,0,0,48,0,-48
25815,1,0,134,0,-134
25816,0,0,2,0,-2
25817,1,1,29,1280,1251
25818,0,0,74,0,-74
25819,1,1,295,1225,930
25820,0,0,9,0,-9
25821,0,0,37,0,-37
25822,1,1,226,1591,1365
25823,1,0,67,0,-67
25824,0,0,21,0,-21
25825,1,1,1935,1462,-473
25826,0,0,26,0,-26
25827,1,1,81,1283,1202
25828,0,0,82,0,-82
25829,0,0,0,0,0
25830,0,0,50,0,-50
25831,1,0,99,0,-99
25832,0,0,128,0,-128
25833,1,1,747,1261,514
25834,1,1,213,1874,1661
25835,0,0,58,0,-58
25836,1,1,819,1775,956
25837,0,0,5,0,-5
25838,0,0,4,0,-4
25839,1,1,865,1645,780
25840,0,0,17,0,-17
25841,0,0,112,0,-112
25842,1,1,1096,1415,319
25843,0,0,103,0,-103
25844,1,0,27,0,-27
25845,0,0,79,0,-79
25846,1,0,123,0,-123
25847,1,1,468,1219,751
25848,1,1,702,1541,839
25849,1,0,6,0,-6
25850,1,0,3,0,-3
25851,0,0,2,0,-2
25852,1,1,120,1333,1213
25853,0,0,57,0,-57
25854,1,1,363,1805,1442
25855,1,0,45,0,-45
25856,0,0,14,0,-14
25857,1,1,435,1642,1207
25858,1,1,1386,1349,-37
25859,0,0,8,0,-8
25860,0,0,2,0,-2
25861,1,1,51,2135,2084
25862,0,0,6,0,-6
25863,0,0,32,0,-32
25864,1,0,61,0,-61
25865,0,0,27,0,-27
25866,0,0,133,0,-133
25867,1,1,430,1316,886
25868,0,0,32,0,-32
25869,1,1,582,2814,2232
25870,1,1,522,1247,725
25871,1,0,26,0,-26
25872,1,1,45,1270,1225
25873,0,0,25,0,-25
25874,0,0,12,0,-12
25875,0,0,299,0,-299
25876,1,1,1841,1200,-641
25877,0,0,19,0,-19
25878,0,0,64,0,-64
25879,0,0,13,0,-13
25880,0,0,62,0,-62
25881,1,1,562,1223,661
25882,0,0,14,0,-14
25883,0,0,40,0,-40
25884,0,0,144,0,-144
25885,1,1,141,1358,1217
25886,0,0,5,0,-5
25887,0,0,18,0,-18
25888,1,1,63,1206,1143
25889,1,0,12,0,-12
25890,0,0,7,0,-7
25891,1,0,30,0,-30
25892,0,0,33,0,-33
25893,0,0,7,0,-7
25894,0,0,8,0,-8
25895,0,0,9,0,-9
25896,0,0,23,0,-23
25897,1,1,118,1957,1839
25898,0,0,20,0,-20
25899,1,0,56,0,-56
25900,0,0,63,0,-63
25901,0,0,23,0,-23
25902,1,1,853,1246,393
25903,1,1,821,1540,719
25904,1,0,89,0,-89
25905,0,0,117,0,-117
25906,1,1,200,1418,1218
25907,0,0,0,0,0
25908,1,1,834,2127,1293
25909,0,0,89,0,-89
25910,1,0,39,0,-39
25911,1,0,150,0,-150
25912,0,0,3,0,-3
25913,0,0,139,0,-139
25914,0,0,21,0,-21
25915,0,0,8,0,-8
25916,0,0,11,0,-11
25917,1,0,4,0,-4
25918,1,1,1245,1834,589
25919,1,1,446,2053,1607
25920,0,0,144,0,-144
25921,0,0,19,0,-19
25922,1,1,273,1297,1024
25923,0,0,24,0,-24
25924,0,0,43,0,-43
25925,1,0,22,0,-22
25926,1,0,81,0,-81
25927,1,1,899,1274,375
25928,1,0,83,0,-83
25929,0,0,18,0,-18
25930,1,0,8,0,-8
25931,1,1,366,1359,993
25932,1,0,105,0,-105
25933,0,0,32,0,-32
25934,1,0,195,0,-195
25935,0,0,32,0,-32
25936,1,1,1222,1310,88
25937,1,0,8,0,-8
25938,0,0,2,0,-2
25939,0,0,4,0,-4
25940,1,1,262,1200,938
25941,1,0,35,0,-35
25942,1,1,619,1423,804
25943,1,0,4,0,-4
25944,0,0,43,0,-43
25945,1,1,122,1310,1188
25946,1,0,2,0,-2
25947,1,0,34,0,-34
25948,0,0,44,0,-44
25949,1,0,194,0,-194
25950,1,1,1120,2286,1166
25951,1,0,23,0,-23
25952,1,0,41,0,-41
25953,1,1,266,1250,984
25954,1,0,191,0,-191
25955,0,0,37,0,-37
25956,1,1,861,2895,2034
25957,0,0,122,0,-122
25958,1,1,775,1253,478
25959,0,0,33,0,-33
25960,1,0,34,0,-34
25961,1,1,1364,2035,671
25962,1,0,73,0,-73
25963,1,1,250,1392,1142
25964,1,0,47,0,-47
25965,1,1,399,1571,1172
25966,1,0,16,0,-16
25967,0,0,22,0,-22
25968,1,1,485,1418,933
25969,0,0,51,0,-51
25970,1,0,37,0,-37
25971,1,1,276,1952,1676
25972,1,0,228,0,-228
25973,0,0,39,0,-39
25974,1,1,110,2658,2548
25975,0,0,37,0,-37
25976,0,0,81,0,-81
25977,1,0,26,0,-26
25978,0,0,48,0,-48
25979,0,0,70,0,-70
25980,0,0,48,0,-48
25981,1,1,765,1271,506
25982,1,0,89,0,-89
25983,1,1,456,2009,1553
25984,1,0,93,0,-93
25985,0,0,74,0,-74
25986,1,0,26,0,-26
25987,1,0,46,0,-46
25988,0,0,233,0,-233
25989,1,1,340,1296,956
25990,1,1,147,1299,1152
25991,1,0,10,0,-10
25992,1,0,15,0,-15
25993,0,0,36,0,-36
25994,1,0,35,0,-35
25995,0,0,14,0,-14
25996,0,0,52,0,-52
25997,0,0,37,0,-37
25998,0,0,43,0,-43
25999,0,0,98,0,-98
26000,1,0,1,0,-1
26001,1,1,654,1256,602
26002,0,0,7,0,-7
26003,0,0,16,0,-16
26004,0,0,24,0,-24
26005,1,0,53,0,-53
26006,1,0,50,0,-50
26007,1,0,84,0,-84
26008,1,0,4,0,-4
26009,0,0,203,0,-203
26010,1,1,125,1387,1262
26011,0,0,7,0,-7
26012,0,0,5,0,-5
26013,1,0,24,0,-24
26014,1,1,814,1236,422
26015,0,0,10,0,-10
26016,1,0,49,0,-49
26017,0,0,79,0,-79
26018,1,0,0,0,0
26019,1,1,1250,1397,147
26020,1,0,103,0,-103
26021,1,1,464,1311,847
26022,1,0,72,0,-72
26023,1,1,1465,1261,-204
26024,1,1,252,1451,1199
26025,1,0,242,0,-242
26026,1,0,25,0,-25
26027,0,0,5,0,-5
26028,0,0,126,0,-126
26029,1,0,6,0,-6
26030,0,0,50,0,-50
26031,1,0,92,0,-92
26032,1,0,50,0,-50
26033,1,0,50,0,-50
26034,0,0,19,0,-19
26035,0,0,5,0,-5
26036,0,0,76,0,-76
26037,1,0,29,0,-29
26038,0,0,98,0,-98
26039,1,1,1754,1552,-202
26040,0,0,62,0,-62
26041,0,0,0,0,0
26042,0,0,165,0,-165
26043,0,0,6,0,-6
26044,0,0,64,0,-64
26045,1,1,173,1464,1291
26046,1,1,714,1344,630
26047,1,0,35,0,-35
26048,1,0,19,0,-19
26049,0,0,2,0,-2
26050,1,1,182,1764,1582
26051,1,0,77,0,-77
26052,1,0,17,0,-17
26053,1,0,74,0,-74
26054,1,0,10,0,-10
26055,1,1,164,2233,2069
26056,0,0,4,0,-4
26057,0,0,149,0,-149
26058,0,0,112,0,-112
26059,0,0,58,0,-58
26060,1,1,890,1342,452
26061,1,1,2198,1331,-867
26062,0,0,33,0,-33
26063,0,0,12,0,-12
26064,1,1,481,1438,957
26065,1,0,19,0,-19
26066,1,1,260,1238,978
26067,1,1,529,1200,671
26068,1,1,11,1329,1318
26069,1,0,42,0,-42
26070,0,0,20,0,-20
26071,0,0,2,0,-2
26072,0,0,93,0,-93
26073,1,0,17,0,-17
26074,1,0,24,0,-24
26075,0,0,100,0,-100
26076,0,0,54,0,-54
26077,0,0,94,0,-94
26078,1,1,1093,1229,136
26079,1,0,10,0,-10
26080,1,1,717,1294,577
26081,0,0,8,0,-8
26082,1,1,1211,1487,276
26083,0,0,15,0,-15
26084,1,1,97,1288,1191
26085,1,1,855,2084,1229
26086,1,1,127,2605,2478
26087,1,0,24,0,-24
26088,1,0,138,0,-138
26089,0,0,275,0,-275
26090,1,0,16,0,-16
26091,0,0,115,0,-115
26092,0,0,63,0,-63
26093,1,0,2,0,-2
26094,1,0,55,0,-55
26095,0,0,80,0,-80
26096,1,1,327,1492,1165
26097,1,1,2275,1568,-707
26098,1,0,17,0,-17
26099,1,1,133,1370,1237
26100,0,0,325,0,-325
26101,1,1,1065,1400,335
26102,1,1,385,2742,2357
26103,1,1,1761,1209,-552
26104,0,0,67,0,-67
26105,1,0,149,0,-149
26106,1,1,925,1639,714
26107,1,1,565,1317,752
26108,1,0,25,0,-25
26109,0,0,135,0,-135
26110,0,0,68,0,-68
26111,1,1,656,1247,591
26112,1,0,10,0,-10
26113,1,1,139,1478,1339
26114,1,1,384,2669,2285
26115,1,0,48,0,-48
26116,1,0,43,0,-43
26117,1,0,38,0,-38
26118,1,1,646,1321,675
26119,1,0,3,0,-3
26120,1,1,126,1753,1627
26121,0,0,52,0,-52
26122,1,1,1357,1269,-88
26123,0,0,62,0,-62
26124,0,0,0,0,0
26125,0,0,35,0,-35
26126,1,1,193,1247,1054
26127,1,1,192,1509,1317
26128,1,1,1587,1254,-333
26129,0,0,245,0,-245
26130,1,1,2108,1870,-238
26131,0,0,216,0,-216
26132,1,0,1,0,-1
26133,1,0,62,0,-62
26134,1,1,424,1600,1176
26135,0,0,3,0,-3
26136,1,1,84,1564,1480
26137,0,0,38,0,-38
26138,0,0,2,0,-2
26139,0,0,98,0,-98
26140,1,0,5,0,-5
26141,1,1,687,1785,1098
26142,0,0,88,0,-88
26143,1,1,658,1200,542
26144,0,0,11,0,-11
26145,1,1,1275,1466,191
26146,1,1,171,1232,1061
26147,1,0,0,0,0
26148,0,0,52,0,-52
26149,1,1,718,1316,598
26150,1,1,661,1408,747
26151,1,0,143,0,-143
26152,0,0,141,0,-141
26153,0,0,16,0,-16
26154,1,1,626,1623,997
26155,0,0,147,0,-147
26156,1,1,961,1240,279
26157,1,0,71,0,-71
26158,0,0,113,0,-113
26159,1,1,574,1764,1190
26160,0,0,72,0,-72
26161,1,1,678,1446,768
26162,0,0,51,0,-51
26163,1,1,815,1798,983
26164,0,0,21,0,-21
26165,0,0,29,0,-29
26166,1,1,292,1415,1123
26167,1,1,675,1854,1179
26168,1,1,19,1327,1308
26169,0,0,120,0,-120
26170,0,0,7,0,-7
26171,1,1,2063,2024,-39
26172,0,0,32,0,-32
26173,1,1,151,1461,1310
26174,0,0,59,0,-59
26175,1,0,116,0,-116
26176,0,0,9,0,-9
26177,1,1,126,1555,1429
26178,1,1,630,1464,834
26179,0,0,32,0,-32
26180,0,0,24,0,-24
26181,0,0,27,0,-27
26182,1,1,246,1790,1544
26183,0,0,100,0,-100
26184,0,0,86,0,-86
26185,1,0,60,0,-60
26186,0,0,82,0,-82
26187,0,0,14,0,-14
26188,1,0,6,0,-6
26189,1,1,255,2293,2038
26190,0,0,7,0,-7
26191,1,1,484,1262,778
26192,1,0,69,0,-69
26193,0,0,92,0,-92
26194,1,1,37,1203,1166
26195,0,0,79,0,-79
26196,1,1,492,1820,1328
26197,1,1,889,2017,1128
26198,0,0,79,0,-79
26199,1,0,17,0,-17
26200,1,0,50,0,-50
26201,0,0,45,0,-45
26202,1,1,608,1205,597
26203,0,0,7,0,-7
26204,1,1,508,1215,707
26205,1,1,18,1306,1288
26206,0,0,19,0,-19
26207,1,1,406,1506,1100
26208,1,1,2237,2228,-9
26209,0,0,23,0,-23
26210,0,0,5,0,-5
26211,0,0,17,0,-17
26212,1,1,169,1258,1089
26213,1,1,722,1394,672
26214,1,1,875,1206,331
26215,1,0,37,0,-37
26216,1,1,118,1978,1860
26217,1,1,733,1413,680
26218,1,0,18,0,-18
26219,1,1,181,1357,1176
26220,0,0,12,0,-12
26221,1,1,1698,1418,-280
26222,1,1,224,2022,1798
26223,0,0,61,0,-61
26224,1,0,5,0,-5
26225,1,1,938,1306,368
26226,0,0,24,0,-24
26227,0,0,3,0,-3
26228,1,1,141,1370,1229
26229,1,1,1244,1618,374
26230,1,1,503,1462,959
26231,0,0,154,0,-154
26232,1,0,42,0,-42
26233,0,0,89,0,-89
26234,0,0,26,0,-26
26235,0,0,8,0,-8
26236,0,0,26,0,-26
26237,0,0,33,0,-33
26238,0,0,10,0,-10
26239,0,0,119,0,-119
26240,0,0,12,0,-12
26241,1,1,493,1522,1029
26242,0,0,120,0,-120
26243,1,1,763,3195,2432
26244,1,1,216,1270,1054
26245,0,0,38,0,-38
26246,1,1,654,1341,687
26247,0,0,32,0,-32
26248,0,0,64,0,-64
26249,1,1,191,1331,1140
26250,1,1,538,4099,3561
26251,1,1,616,1388,772
26252,1,0,36,0,-36
26253,1,1,10,2580,2570
26254,0,0,21,0,-21
26255,1,0,45,0,-45
26256,1,0,40,0,-40
26257,0,0,62,0,-62
26258,1,1,822,1651,829
26259,1,0,161,0,-161
26260,1,1,1273,1990,717
26261,1,0,6,0,-6
26262,0,0,2,0,-2
26263,1,0,38,0,-38
26264,1,0,142,0,-142
26265,0,0,36,0,-36
26266,1,1,28,1230,1202
26267,0,0,33,0,-33
26268,1,0,42,0,-42
26269,1,1,260,1219,959
26270,1,1,184,1234,1050
26271,0,0,32,0,-32
26272,1,0,54,0,-54
26273,1,1,411,1427,1016
26274,1,0,7,0,-7
26275,1,1,165,1449,1284
26276,1,1,276,1431,1155
26277,0,0,12,0,-12
26278,0,0,1,0,-1
26279,0,0,7,0,-7
26280,1,0,103,0,-103
26281,0,0,31,0,-31
26282,1,0,75,0,-75
26283,0,0,81,0,-81
26284,1,1,386,1397,1011
26285,1,1,270,1433,1163
26286,0,0,61,0,-61
26287,1,1,47,5106,5059
26288,1,1,1005,1250,245
26289,1,1,2497,1353,-1144
26290,0,0,52,0,-52
26291,1,1,161,1610,1449
26292,1,0,8,0,-8
26293,0,0,21,0,-21
26294,1,0,101,0,-101
26295,0,0,3,0,-3
26296,0,0,72,0,-72
26297,0,0,53,0,-53
26298,1,0,15,0,-15
26299,0,0,63,0,-63
26300,0,0,24,0,-24
26301,0,0,5,0,-5
26302,1,1,159,1349,1190
26303,0,0,21,0,-21
26304,0,0,54,0,-54
26305,0,0,27,0,-27
26306,1,0,70,0,-70
26307,0,0,114,0,-114
26308,1,0,14,0,-14
26309,1,0,148,0,-148
26310,1,0,42,0,-42
26311,1,1,224,1372,1148
26312,0,0,4,0,-4
26313,0,0,8,0,-8
26314,1,0,122,0,-122
26315,1,1,195,1593,1398
26316,0,0,6,0,-6
26317,1,0,30,0,-30
26318,1,0,34,0,-34
26319,0,0,4,0,-4
26320,1,0,230,0,-230
26321,0,0,17,0,-17
26322,0,0,10,0,-10
26323,1,1,101,1923,1822
26324,0,0,46,0,-46
26325,0,0,6,0,-6
26326,0,0,89,0,-89
26327,1,0,70,0,-70
26328,1,0,1,0,-1
26329,0,0,43,0,-43
26330,1,1,274,2023,1749
26331,1,1,577,1524,947
26332,0,0,4,0,-4
26333,0,0,75,0,-75
26334,0,0,108,0,-108
26335,0,0,49,0,-49
26336,0,0,3,0,-3
26337,1,0,49,0,-49
26338,1,0,22,0,-22
26339,1,0,13,0,-13
26340,1,1,363,1336,973
26341,1,1,371,1213,842
26342,1,0,77,0,-77
26343,1,0,91,0,-91
26344,1,1,515,1393,878
26345,0,0,42,0,-42
26346,1,1,118,1452,1334
26347,0,0,95,0,-95
26348,0,0,18,0,-18
26349,0,0,146,0,-146
26350,0,0,11,0,-11
26351,1,1,146,1392,1246
26352,1,0,31,0,-31
26353,0,0,4,0,-4
26354,0,0,33,0,-33
26355,1,0,30,0,-30
26356,0,0,366,0,-366
26357,1,1,187,1251,1064
26358,0,0,23,0,-23
26359,1,0,17,0,-17
26360,1,0,27,0,-27
26361,1,1,582,1285,703
26362,0,0,69,0,-69
26363,0,0,54,0,-54
26364,1,0,37,0,-37
26365,0,0,17,0,-17
26366,0,0,138,0,-138
26367,0,0,3,0,-3
26368,1,0,153,0,-153
26369,1,1,1131,1220,89
26370,1,1,830,1527,697
26371,0,0,21,0,-21
26372,0,0,74,0,-74
26373,0,0,51,0,-51
26374,0,0,50,0,-50
26375,0,0,123,0,-123
26376,1,0,194,0,-194
26377,1,0,27,0,-27
26378,0,0,22,0,-22
26379,1,1,797,1451,654
26380,1,1,21,1752,1731
26381,1,1,1540,1548,8
26382,1,1,583,1717,1134
26383,1,1,340,1217,877
26384,1,0,38,0,-38
26385,1,0,74,0,-74
26386,0,0,90,0,-90
26387,0,0,31,0,-31
26388,1,1,83,1917,1834
26389,1,1,192,1656,1464
26390,0,0,149,0,-149
26391,1,1,351,1256,905
26392,1,0,121,0,-121
26393,1,1,321,1357,1036
26394,0,0,234,0,-234
26395,0,0,59,0,-59
26396,1,0,2,0,-2
26397,1,0,118,0,-118
26398,1,1,219,1205,986
26399,1,0,39,0,-39
26400,1,1,238,1313,1075
26401,1,1,446,2503,2057
26402,1,0,40,0,-40
26403,1,1,491,1230,739
26404,1,1,1077,1218,141
26405,0,0,45,0,-45
26406,0,0,155,0,-155
26407,1,1,69,3212,3143
26408,0,0,5,0,-5
26409,1,1,1205,1584,379
26410,0,0,144,0,-144
26411,1,0,31,0,-31
26412,1,1,554,1241,687
26413,1,1,1065,1202,137
26414,0,0,52,0,-52
26415,0,0,74,0,-74
26416,1,0,27,0,-27
26417,1,0,35,0,-35
26418,0,0,37,0,-37
26419,1,1,240,1694,1454
26420,0,0,43,0,-43
26421,1,1,79,1210,1131
26422,1,0,3,0,-3
26423,0,0,15,0,-15
26424,0,0,104,0,-104
26425,0,0,226,0,-226
26426,1,0,119,0,-119
26427,0,0,85,0,-85
26428,1,1,1539,1260,-279
26429,1,1,293,1290,997
26430,1,1,252,1215,963
26431,0,0,112,0,-112
26432,1,0,113,0,-113
26433,0,0,101,0,-101
26434,0,0,37,0,-37
26435,0,0,17,0,-17
26436,1,0,46,0,-46
26437,1,0,84,0,-84
26438,0,0,2,0,-2
26439,0,0,110,0,-110
26440,1,1,62,1981,1919
26441,1,1,89,1475,1386
26442,1,1,1461,1657,196
26443,0,0,6,0,-6
26444,1,1,61,4131,4070
26445,1,0,47,0,-47
26446,0,0,98,0,-98
26447,0,0,55,0,-55
26448,1,1,64,2101,2037
26449,0,0,60,0,-60
26450,0,0,9,0,-9
26451,0,0,84,0,-84
26452,1,1,124,1482,1358
26453,1,0,120,0,-120
26454,1,0,48,0,-48
26455,1,1,779,1530,751
26456,1,0,6,0,-6
26457,0,0,12,0,-12
26458,1,0,16,0,-16
26459,1,1,639,2037,1398
26460,1,1,127,1592,1465
26461,1,0,35,0,-35
26462,1,1,560,1330,770
26463,0,0,162,0,-162
26464,0,0,2,0,-2
26465,0,0,10,0,-10
26466,0,0,104,0,-104
26467,0,0,4,0,-4
26468,0,0,181,0,-181
26469,1,1,571,1420,849
26470,1,1,670,1203,533
26471,1,0,6,0,-6
26472,0,0,11,0,-11
26473,1,0,17,0,-17
26474,1,1,677,1739,1062
26475,1,0,3,0,-3
26476,1,1,559,1401,842
26477,0,0,47,0,-47
26478,0,0,119,0,-119
26479,1,1,1086,1359,273
26480,0,0,52,0,-52
26481,0,0,11,0,-11
26482,1,1,2179,1370,-809
26483,1,0,30,0,-30
26484,0,0,18,0,-18
26485,0,0,42,0,-42
26486,0,0,31,0,-31
26487,0,0,12,0,-12
26488,0,0,39,0,-39
26489,0,0,13,0,-13
26490,0,0,67,0,-67
26491,0,0,27,0,-27
26492,0,0,9,0,-9
26493,1,1,1452,1513,61
26494,0,0,19,0,-19
26495,1,0,101,0,-101
26496,1,0,1,0,-1
26497,1,1,487,1329,842
26498,0,0,72,0,-72
26499,0,0,94,0,-94
26500,1,0,19,0,-19
26501,1,0,77,0,-77
26502,1,1,308,1293,985
26503,0,0,21,0,-21
26504,0,0,19,0,-19
26505,1,1,86,1200,1114
26506,1,1,75,1415,1340
26507,0,0,27,0,-27
26508,0,0,172,0,-172
26509,1,1,198,1592,1394
26510,0,0,7,0,-7
26511,0,0,17,0,-17
26512,1,0,90,0,-90
26513,0,0,31,0,-31
26514,1,0,49,0,-49
26515,0,0,56,0,-56
26516,1,0,4,0,-4
26517,1,1,322,1366,1044
26518,0,0,120,0,-120
26519,1,1,799,1725,926
26520,0,0,25,0,-25
26521,0,0,146,0,-146
26522,1,1,397,1462,1065
26523,0,0,5,0,-5
26524,1,1,669,1333,664
26525,1,0,19,0,-19
26526,0,0,6,0,-6
26527,0,0,9,0,-9
26528,1,1,274,1304,1030
26529,1,0,49,0,-49
26530,0,0,3,0,-3
26531,1,0,63,0,-63
26532,1,0,2,0,-2
26533,1,0,37,0,-37
26534,1,0,26,0,-26
26535,1,1,388,1857,1469
26536,1,1,74,1252,1178
26537,0,0,3,0,-3
26538,1,0,17,0,-17
26539,0,0,9,0,-9
26540,1,1,558,1209,651
26541,1,1,162,1516,1354
26542,1,1,429,1617,1188
26543,0,0,52,0,-52
26544,1,0,8,0,-8
26545,1,0,16,0,-16
26546,0,0,18,0,-18
26547,1,1,1126,1457,331
26548,1,0,36,0,-36
26549,1,0,17,0,-17
26550,1,0,11,0,-11
26551,1,1,1258,2020,762
26552,1,0,24,0,-24
26553,0,0,80,0,-80
26554,1,1,377,1977,1600
26555,0,0,27,0,-27
26556,1,0,19,0,-19
26557,1,1,1006,1646,640
26558,1,0,31,0,-31
26559,1,0,147,0,-147
26560,1,0,109,0,-109
26561,1,0,54,0,-54
26562,0,0,13,0,-13
26563,0,0,94,0,-94
26564,0,0,17,0,-17
26565,1,0,61,0,-61
26566,1,0,37,0,-37
26567,1,0,34,0,-34
26568,1,0,45,0,-45
26569,0,0,53,0,-53
26570,0,0,23,0,-23
26571,0,0,2,0,-2
26572,1,0,45,0,-45
26573,1,1,217,1322,1105
26574,1,1,1975,2382,407
26575,1,1,1549,1538,-11
26576,1,1,187,1637,1450
26577,1,1,159,1485,1326
26578,1,1,1182,1644,462
26579,0,0,95,0,-95
26580,0,0,31,0,-31
26581,1,1,798,1296,498
26582,1,1,91,1246,1155
26583,1,1,934,1498,564
26584,1,0,29,0,-29
26585,1,0,50,0,-50
26586,1,1,250,2079,1829
26587,0,0,7,0,-7
26588,1,0,28,0,-28
26589,1,0,54,0,-54
26590,1,0,125,0,-125
26591,0,0,33,0,-33
26592,0,0,46,0,-46
26593,1,0,38,0,-38
26594,0,0,4,0,-4
26595,1,0,183,0,-183
26596,0,0,55,0,-55
26597,1,1,181,3359,3178
26598,1,0,94,0,-94
26599,1,0,44,0,-44
26600,1,1,594,1403,809
26601,1,1,47,1493,1446
26602,1,0,79,0,-79
26603,1,0,24,0,-24
26604,0,0,6,0,-6
26605,0,0,28,0,-28
26606,1,1,428,1223,795
26607,1,1,607,2664,2057
26608,0,0,61,0,-61
26609,1,0,19,0,-19
26610,1,1,65,1467,1402
26611,1,0,21,0,-21
26612,1,1,237,1949,1712
26613,0,0,3,0,-3
26614,1,0,119,0,-119
26615,1,0,5,0,-5
26616,1,1,525,1224,699
26617,1,0,119,0,-119
26618,0,0,8,0,-8
26619,0,0,114,0,-114
26620,0,0,86,0,-86
26621,0,0,163,0,-163
26622,1,0,168,0,-168
26623,0,0,7,0,-7
26624,0,0,37,0,-37
26625,1,0,36,0,-36
26626,1,0,59,0,-59
26627,1,0,55,0,-55
26628,1,0,106,0,-106
26629,1,0,119,0,-119
26630,1,1,1040,1742,702
26631,1,1,334,2254,1920
26632,1,0,7,0,-7
26633,1,1,1126,2254,1128
26634,1,0,35,0,-35
26635,0,0,46,0,-46
26636,0,0,32,0,-32
26637,0,0,27,0,-27
26638,1,1,212,1603,1391
26639,1,1,177,2721,2544
26640,1,1,34,1454,1420
26641,0,0,6,0,-6
26642,0,0,42,0,-42
26643,0,0,21,0,-21
26644,0,0,206,0,-206
26645,1,0,53,0,-53
26646,1,0,175,0,-175
26647,1,0,44,0,-44
26648,1,0,61,0,-61
26649,1,0,0,0,0
26650,1,0,91,0,-91
26651,1,1,147,1316,1169
26652,1,1,535,1343,808
26653,1,1,117,1577,1460
26654,1,1,514,1531,1017
26655,1,1,355,1534,1179
26656,1,0,53,0,-53
26657,1,1,151,1218,1067
26658,1,0,28,0,-28
26659,1,1,73,1543,1470
26660,1,0,56,0,-56
26661,1,0,19,0,-19
26662,1,1,180,1474,1294
26663,0,0,2,0,-2
26664,0,0,0,0,0
26665,1,1,622,1363,741
26666,1,1,1552,1879,327
26667,0,0,12,0,-12
26668,1,0,87,0,-87
26669,0,0,43,0,-43
26670,1,0,2,0,-2
26671,1,0,87,0,-87
26672,0,0,115,0,-115
26673,1,1,258,1360,1102
26674,0,0,44,0,-44
26675,0,0,81,0,-81
26676,1,0,67,0,-67
26677,0,0,5,0,-5
26678,1,1,570,1850,1280
26679,0,0,105,0,-105
26680,1,1,800,1232,432
26681,1,1,358,1367,1009
26682,1,0,209,0,-209
26683,1,0,34,0,-34
26684,1,0,13,0,-13
26685,1,1,84,1380,1296
26686,1,0,13,0,-13
26687,0,0,49,0,-49
26688,1,0,135,0,-135
26689,0,0,82,0,-82
26690,1,0,62,0,-62
26691,0,0,162,0,-162
26692,1,0,47,0,-47
26693,0,0,69,0,-69
26694,1,0,15,0,-15
26695,1,1,221,1380,1159
26696,1,0,21,0,-21
26697,1,0,72,0,-72
26698,1,0,19,0,-19
26699,1,1,234,1420,1186
26700,0,0,31,0,-31
26701,0,0,0,0,0
26702,0,0,68,0,-68
26703,1,0,9,0,-9
26704,0,0,19,0,-19
26705,0,0,10,0,-10
26706,1,0,85,0,-85
26707,1,0,14,0,-14
26708,1,1,1282,1425,143
26709,1,1,617,1294,677
26710,1,1,658,1234,576
26711,1,0,33,0,-33
26712,1,0,10,0,-10
26713,0,0,43,0,-43
26714,0,0,4,0,-4
26715,1,1,815,2234,1419
26716,1,1,464,1357,893
26717,0,0,147,0,-147
26718,0,0,171,0,-171
26719,1,0,53,0,-53
26720,1,1,485,1253,768
26721,0,0,11,0,-11
26722,0,0,0,0,0
26723,1,1,300,1368,1068
26724,1,0,15,0,-15
26725,0,0,13,0,-13
26726,0,0,15,0,-15
26727,0,0,13,0,-13
26728,1,0,55,0,-55
26729,0,0,2,0,-2
26730,1,1,191,1445,1254
26731,1,1,233,1379,1146
26732,1,1,490,1753,1263
26733,1,1,728,1230,502
26734,1,0,114,0,-114
26735,1,1,347,1575,1228
26736,1,1,771,1214,443
26737,0,0,118,0,-118
26738,1,0,43,0,-43
26739,1,0,164,0,-164
26740,1,1,1301,2131,830
26741,0,0,20,0,-20
26742,1,1,1035,1251,216
26743,0,0,25,0,-25
26744,0,0,21,0,-21
26745,1,1,166,1437,1271
26746,1,0,8,0,-8
26747,1,0,6,0,-6
26748,1,1,208,2391,2183
26749,1,1,328,1620,1292
26750,0,0,30,0,-30
26751,1,1,38,1274,1236
26752,1,1,697,1238,541
26753,0,0,50,0,-50
26754,1,1,463,1841,1378
26755,1,0,84,0,-84
26756,0,0,7,0,-7
26757,1,1,1600,2459,859
26758,1,1,445,1852,1407
26759,1,1,1149,1453,304
26760,1,0,4,0,-4
26761,1,1,72,1202,1130
26762,0,0,227,0,-227
26763,1,0,4,0,-4
26764,1,0,26,0,-26
26765,0,0,172,0,-172
26766,1,1,1951,1448,-503
26767,0,0,97,0,-97
26768,0,0,24,0,-24
26769,1,1,411,1498,1087
26770,1,0,42,0,-42
26771,1,0,2,0,-2
26772,0,0,14,0,-14
26773,0,0,91,0,-91
26774,1,1,508,1278,770
26775,0,0,15,0,-15
26776,1,0,79,0,-79
26777,0,0,42,0,-42
26778,1,0,268,0,-268
26779,1,1,37,2536,2499
26780,1,0,79,0,-79
26781,1,1,355,1366,1011
26782,1,1,269,1210,941
26783,1,1,312,1228,916
26784,1,0,60,0,-60
26785,0,0,21,0,-21
26786,1,1,330,1317,987
26787,1,1,44,1284,1240
26788,1,1,269,1917,1648
26789,1,0,124,0,-124
26790,0,0,71,0,-71
26791,1,0,81,0,-81
26792,0,0,86,0,-86
26793,0,0,95,0,-95
26794,0,0,168,0,-168
26795,0,0,92,0,-92
26796,1,0,50,0,-50
26797,1,1,507,1265,758
26798,1,0,337,0,-337
26799,1,1,325,1387,1062
26800,0,0,43,0,-43
26801,1,0,45,0,-45
26802,1,1,849,1356,507
26803,1,0,10,0,-10
26804,0,0,44,0,-44
26805,1,0,11,0,-11
26806,1,0,187,0,-187
26807,1,1,142,1228,1086
26808,1,0,18,0,-18
26809,0,0,24,0,-24
26810,0,0,25,0,-25
26811,1,0,77,0,-77
26812,1,0,26,0,-26
26813,0,0,61,0,-61
26814,0,0,3,0,-3
26815,0,0,143,0,-143
26816,1,1,1329,1214,-115
26817,1,1,264,1355,1091
26818,0,0,95,0,-95
26819,1,1,142,1230,1088
26820,1,0,13,0,-13
26821,0,0,58,0,-58
26822,1,0,180,0,-180
26823,1,0,0,0,0
26824,1,0,18,0,-18
26825,1,1,284,1284,1000
26826,0,0,15,0,-15
26827,0,0,77,0,-77
26828,0,0,35,0,-35
26829,0,0,7,0,-7
26830,0,0,84,0,-84
26831,1,1,216,1913,1697
26832,1,0,62,0,-62
26833,1,1,1195,1546,351
26834,0,0,0,0,0
26835,0,0,2,0,-2
26836,1,0,61,0,-61
26837,0,0,51,0,-51
26838,1,1,554,1893,1339
26839,0,0,37,0,-37
26840,1,0,53,0,-53
26841,1,1,182,1222,1040
26842,1,1,29,1657,1628
26843,1,0,56,0,-56
26844,1,0,8,0,-8
26845,1,1,166,2536,2370
26846,0,0,145,0,-145
26847,1,1,2028,1765,-263
26848,1,0,1,0,-1
26849,1,0,25,0,-25
26850,0,0,163,0,-163
26851,0,0,1,0,-1
26852,0,0,11,0,-11
26853,1,0,181,0,-181
26854,0,0,10,0,-10
26855,1,1,230,2744,2514
26856,0,0,54,0,-54
26857,0,0,69,0,-69
26858,1,0,6,0,-6
26859,1,1,591,1757,1166
26860,1,1,106,1914,1808
26861,1,0,1,0,-1
26862,1,0,10,0,-10
26863,1,0,16,0,-16
26864,0,0,78,0,-78
26865,1,0,123,0,-123
26866,0,0,21,0,-21
26867,0,0,28,0,-28
26868,1,0,1,0,-1
26869,0,0,64,0,-64
26870,0,0,150,0,-150
26871,1,0,30,0,-30
26872,1,0,8,0,-8
26873,1,1,126,1294,1168
26874,1,1,27,2163,2136
26875,1,1,169,1347,1178
26876,1,1,639,1589,950
26877,1,1,323,1667,1344
26878,1,0,1,0,-1
26879,0,0,56,0,-56
26880,0,0,27,0,-27
26881,1,0,19,0,-19
26882,1,1,260,1236,976
26883,0,0,47,0,-47
26884,1,0,83,0,-83
26885,1,1,2268,1645,-623
26886,1,0,71,0,-71
26887,1,1,1064,3048,1984
26888,1,0,239,0,-239
26889,0,0,7,0,-7
26890,1,1,312,1360,1048
26891,1,0,5,0,-5
26892,0,0,156,0,-156
26893,1,1,89,11817,11728
26894,1,1,1474,1453,-21
26895,1,0,69,0,-69
26896,0,0,7,0,-7
26897,0,0,14,0,-14
26898,0,0,38,0,-38
26899,1,0,260,0,-260
26900,0,0,2,0,-2
26901,1,1,1037,2778,1741
26902,0,0,206,0,-206
26903,0,0,60,0,-60
26904,1,1,114,1755,1641
26905,0,0,46,0,-46
26906,1,1,490,1453,963
26907,0,0,22,0,-22
26908,0,0,2,0,-2
26909,1,1,358,1224,866
26910,1,1,773,1293,520
26911,1,1,1332,1264,-68
26912,1,1,340,1463,1123
26913,1,1,190,1317,1127
26914,0,0,52,0,-52
26915,1,0,5,0,-5
26916,0,0,65,0,-65
26917,0,0,56,0,-56
26918,1,0,28,0,-28
26919,0,0,34,0,-34
26920,1,0,16,0,-16
26921,0,0,255,0,-255
26922,0,0,15,0,-15
26923,1,0,19,0,-19
26924,1,1,202,1488,1286
26925,0,0,51,0,-51
26926,0,0,71,0,-71
26927,1,0,59,0,-59
26928,0,0,153,0,-153
26929,1,0,42,0,-42
26930,1,0,40,0,-40
26931,1,1,510,1605,1095
26932,1,0,4,0,-4
26933,1,1,174,1217,1043
26934,1,1,147,2122,1975
26935,0,0,4,0,-4
26936,1,0,42,0,-42
26937,1,1,2755,1314,-1441
26938,1,0,84,0,-84
26939,1,0,22,0,-22
26940,1,0,118,0,-118
26941,0,0,20,0,-20
26942,1,0,24,0,-24
26943,0,0,67,0,-67
26944,0,0,24,0,-24
26945,0,0,114,0,-114
26946,1,0,55,0,-55
26947,0,0,7,0,-7
26948,1,1,577,1548,971
26949,1,0,13,0,-13
26950,0,0,19,0,-19
26951,0,0,31,0,-31
26952,0,0,127,0,-127
26953,0,0,9,0,-9
26954,1,0,4,0,-4
26955,0,0,23,0,-23
26956,1,1,344,1271,927
26957,1,0,147,0,-147
26958,0,0,63,0,-63
26959,0,0,117,0,-117
26960,1,0,28,0,-28
26961,1,0,86,0,-86
26962,1,0,0,0,0
26963,0,0,112,0,-112
26964,1,0,16,0,-16
26965,1,0,38,0,-38
26966,0,0,51,0,-51
26967,0,0,109,0,-109
26968,1,0,46,0,-46
26969,1,0,7,0,-7
26970,1,0,266,0,-266
26971,0,0,26,0,-26
26972,1,1,170,1289,1119
26973,1,1,1278,1402,124
26974,0,0,0,0,0
26975,1,1,318,1459,1141
26976,1,1,441,2190,1749
26977,1,0,51,0,-51
26978,0,0,36,0,-36
26979,0,0,121,0,-121
26980,1,0,39,0,-39
26981,0,0,21,0,-21
26982,1,1,454,1201,747
26983,0,0,20,0,-20
26984,1,1,379,1204,825
26985,0,0,65,0,-65
26986,1,1,690,1341,651
26987,1,0,17,0,-17
26988,1,1,184,1535,1351
26989,1,0,98,0,-98
26990,1,0,17,0,-17
26991,1,0,96,0,-96
26992,0,0,81,0,-81
26993,0,0,14,0,-14
26994,1,0,26,0,-26
26995,1,1,553,3274,2721
26996,1,1,512,2184,1672
26997,1,0,32,0,-32
26998,1,1,595,1399,804
26999,1,1,1385,1220,-165
27000,1,1,28,1481,1453
27001,1,0,66,0,-66
27002,0,0,0,0,0
27003,1,0,89,0,-89
27004,1,0,95,0,-95
27005,0,0,41,0,-41
27006,0,0,51,0,-51
27007,0,0,16,0,-16
27008,1,1,463,2402,1939
27009,0,0,15,0,-15
27010,1,1,456,1568,1112
27011,1,1,91,1291,1200
27012,1,1,830,2095,1265
27013,1,1,395,1416,1021
27014,1,1,81,2437,2356
27015,1,1,130,2131,2001
27016,1,1,633,1339,706
27017,1,1,89,1234,1145
27018,0,0,38,0,-38
27019,0,0,27,0,-27
27020,0,0,8,0,-8
27021,1,1,807,4707,3900
27022,0,0,15,0,-15
27023,1,0,32,0,-32
27024,0,0,46,0,-46
27025,0,0,103,0,-103
27026,1,0,37,0,-37
27027,1,1,213,1273,1060
27028,0,0,91,0,-91
27029,1,1,235,1270,1035
27030,1,1,183,2030,1847
27031,1,1,540,1721,1181
27032,1,1,162,1581,1419
27033,1,0,20,0,-20
27034,1,0,105,0,-105
27035,1,1,471,1404,933
27036,1,0,51,0,-51
27037,0,0,17,0,-17
27038,0,0,12,0,-12
27039,1,0,43,0,-43
27040,1,0,64,0,-64
27041,1,1,162,1302,1140
27042,1,0,4,0,-4
27043,0,0,137,0,-137
27044,1,0,19,0,-19
27045,0,0,28,0,-28
27046,0,0,49,0,-49
27047,1,0,37,0,-37
27048,1,0,72,0,-72
27049,1,0,2,0,-2
27050,1,1,1283,1424,141
27051,0,0,32,0,-32
27052,1,1,1692,1270,-422
27053,0,0,346,0,-346
27054,1,1,1285,1645,360
27055,1,0,55,0,-55
27056,1,0,46,0,-46
27057,1,1,321,1757,1436
27058,0,0,38,0,-38
27059,1,0,7,0,-7
27060,1,0,4,0,-4
27061,0,0,7,0,-7
27062,0,0,100,0,-100
27063,1,0,41,0,-41
27064,1,0,2,0,-2
27065,1,1,41,1746,1705
27066,0,0,32,0,-32
27067,0,0,54,0,-54
27068,1,1,146,1277,1131
27069,1,1,393,1565,1172
27070,1,1,1217,2102,885
27071,0,0,4,0,-4
27072,0,0,41,0,-41
27073,1,0,76,0,-76
27074,0,0,13,0,-13
27075,1,1,732,2336,1604
27076,1,0,23,0,-23
27077,1,1,134,1221,1087
27078,1,1,41,2060,2019
27079,0,0,3,0,-3
27080,1,0,232,0,-232
27081,1,1,350,1368,1018
27082,1,1,72,1262,1190
27083,1,1,857,1420,563
27084,1,1,37,1844,1807
27085,0,0,21,0,-21
27086,1,1,1482,1280,-202
27087,1,0,41,0,-41
27088,0,0,13,0,-13
27089,0,0,8,0,-8
27090,1,0,34,0,-34
27091,0,0,203,0,-203
27092,0,0,223,0,-223
27093,1,0,85,0,-85
27094,0,0,99,0,-99
27095,0,0,118,0,-118
27096,1,1,389,1333,944
27097,1,0,92,0,-92
27098,1,0,6,0,-6
27099,0,0,29,0,-29
27100,1,0,81,0,-81
27101,1,1,476,2751,2275
27102,1,0,89,0,-89
27103,1,0,87,0,-87
27104,0,0,68,0,-68
27105,0,0,104,0,-104
27106,0,0,35,0,-35
27107,0,0,14,0,-14
27108,1,1,669,1217,548
27109,1,0,63,0,-63
27110,1,1,1910,1745,-165
27111,0,0,82,0,-82
27112,1,0,33,0,-33
27113,1,0,1,0,-1
27114,1,0,4,0,-4
27115,1,1,819,1553,734
27116,0,0,4,0,-4
27117,1,1,478,1286,808
27118,1,0,75,0,-75
27119,1,0,78,0,-78
27120,1,0,10,0,-10
27121,0,0,67,0,-67
27122,0,0,12,0,-12
27123,1,0,13,0,-13
27124,1,1,611,2314,1703
27125,1,0,0,0,0
27126,1,0,61,0,-61
27127,0,0,5,0,-5
27128,0,0,52,0,-52
27129,0,0,17,0,-17
27130,0,0,112,0,-112
27131,1,1,616,1628,1012
27132,0,0,55,0,-55
27133,1,1,1681,1617,-64
27134,0,0,74,0,-74
27135,0,0,94,0,-94
27136,0,0,60,0,-60
27137,1,0,1,0,-1
27138,0,0,48,0,-48
27139,0,0,23,0,-23
27140,1,1,396,1244,848
27141,0,0,40,0,-40
27142,0,0,88,0,-88
27143,0,0,8,0,-8
27144,1,1,1750,1333,-417
27145,1,0,1,0,-1
27146,0,0,40,0,-40
27147,1,0,4,0,-4
27148,1,0,64,0,-64
27149,1,0,102,0,-102
27150,0,0,68,0,-68
27151,1,0,1,0,-1
27152,1,0,20,0,-20
27153,1,0,108,0,-108
27154,0,0,30,0,-30
27155,1,0,7,0,-7
27156,0,0,12,0,-12
27157,1,1,360,1331,971
27158,0,0,72,0,-72
27159,0,0,11,0,-11
27160,0,0,14,0,-14
27161,1,1,981,1976,995
27162,0,0,73,0,-73
27163,1,0,53,0,-53
27164,1,0,60,0,-60
27165,0,0,47,0,-47
27166,1,0,95,0,-95
27167,1,0,56,0,-56
27168,0,0,41,0,-41
27169,0,0,6,0,-6
27170,1,1,657,1208,551
27171,1,1,232,1345,1113
27172,1,0,6,0,-6
27173,0,0,123,0,-123
27174,0,0,14,0,-14
27175,1,1,265,1498,1233
27176,0,0,52,0,-52
27177,1,0,51,0,-51
27178,0,0,48,0,-48
27179,1,0,38,0,-38
27180,0,0,19,0,-19
27181,1,1,645,1273,628
27182,1,1,1156,1708,552
27183,1,0,107,0,-107
27184,0,0,54,0,-54
27185,0,0,40,0,-40
27186,0,0,21,0,-21
27187,1,0,83,0,-83
27188,1,0,62,0,-62
27189,0,0,0,0,0
27190,1,0,60,0,-60
27191,1,1,411,1450,1039
27192,0,0,80,0,-80
27193,0,0,27,0,-27
27194,1,1,691,1294,603
27195,0,0,13,0,-13
27196,1,0,39,0,-39
27197,0,0,25,0,-25
27198,1,1,135,1269,1134
27199,0,0,28,0,-28
27200,1,0,16,0,-16
27201,1,0,27,0,-27
27202,1,1,356,1765,1409
27203,1,1,903,1246,343
27204,0,0,5,0,-5
27205,1,0,59,0,-59
27206,1,0,10,0,-10
27207,1,0,247,0,-247
27208,1,1,1627,2715,1088
27209,0,0,46,0,-46
27210,1,0,58,0,-58
27211,1,0,51,0,-51
27212,0,0,18,0,-18
27213,1,0,19,0,-19
27214,0,0,50,0,-50
27215,0,0,73,0,-73
27216,1,0,62,0,-62
27217,1,0,38,0,-38
27218,0,0,72,0,-72
27219,1,1,45,2148,2103
27220,1,1,1244,1387,143
27221,1,1,796,1473,677
27222,1,0,28,0,-28
27223,1,1,668,1752,1084
27224,0,0,59,0,-59
27225,1,0,6,0,-6
27226,0,0,22,0,-22
27227,0,0,15,0,-15
27228,1,0,48,0,-48
27229,0,0,15,0,-15
27230,0,0,93,0,-93
27231,1,0,2,0,-2
27232,1,1,1029,2383,1354
27233,1,1,240,1297,1057
27234,0,0,26,0,-26
27235,1,1,974,1209,235
27236,1,0,0,0,0
27237,1,0,14,0,-14
27238,1,1,1068,1381,313
27239,0,0,3,0,-3
27240,1,0,14,0,-14
27241,1,0,77,0,-77
27242,0,0,155,0,-155
27243,0,0,34,0,-34
27244,1,1,116,1547,1431
27245,1,1,1747,1294,-453
27246,0,0,102,0,-102
27247,1,0,121,0,-121
27248,0,0,29,0,-29
27249,1,1,563,2861,2298
27250,0,0,27,0,-27
27251,1,1,1146,1386,240
27252,1,0,10,0,-10
27253,0,0,21,0,-21
27254,1,0,128,0,-128
27255,1,0,59,0,-59
27256,0,0,67,0,-67
27257,0,0,110,0,-110
27258,1,1,421,1363,942
27259,1,0,7,0,-7
27260,1,0,17,0,-17
27261,0,0,62,0,-62
27262,1,0,73,0,-73
27263,0,0,42,0,-42
27264,1,1,185,1916,1731
27265,0,0,59,0,-59
27266,1,1,1603,1395,-208
27267,1,1,353,1256,903
27268,1,0,36,0,-36
27269,0,0,160,0,-160
27270,1,1,1890,1717,-173
27271,0,0,42,0,-42
27272,1,1,1165,1286,121
27273,0,0,17,0,-17
27274,0,0,28,0,-28
27275,0,0,8,0,-8
27276,0,0,54,0,-54
27277,0,0,56,0,-56
27278,0,0,36,0,-36
27279,1,0,105,0,-105
27280,1,1,185,1579,1394
27281,1,1,669,1467,798
27282,0,0,42,0,-42
27283,1,1,99,2065,1966
27284,1,0,25,0,-25
27285,1,0,25,0,-25
27286,1,1,1035,1634,599
27287,1,0,12,0,-12
27288,1,1,797,1344,547
27289,1,1,230,1798,1568
27290,1,1,96,1325,1229
27291,0,0,10,0,-10
27292,0,0,79,0,-79
27293,0,0,15,0,-15
27294,1,1,657,1742,1085
27295,1,0,32,0,-32
27296,0,0,18,0,-18
27297,1,1,628,1517,889
27298,1,0,26,0,-26
27299,0,0,31,0,-31
27300,0,0,100,0,-100
27301,0,0,4,0,-4
27302,0,0,6,0,-6
27303,0,0,57,0,-57
27304,1,1,462,1631,1169
27305,0,0,64,0,-64
27306,0,0,67,0,-67
27307,1,1,748,1284,536
27308,1,1,39,1231,1192
27309,1,1,1521,1700,179
27310,1,1,41,3586,3545
27311,1,1,58,2050,1992
27312,1,0,54,0,-54
27313,1,1,802,1863,1061
27314,1,1,1542,1267,-275
27315,1,0,0,0,0
27316,1,0,37,0,-37
27317,1,0,54,0,-54
27318,0,0,195,0,-195
27319,1,0,35,0,-35
27320,1,0,92,0,-92
27321,1,1,1390,1365,-25
27322,0,0,9,0,-9
27323,0,0,31,0,-31
27324,0,0,118,0,-118
27325,0,0,12,0,-12
27326,0,0,99,0,-99
27327,0,0,59,0,-59
27328,1,1,419,1335,916
27329,1,0,15,0,-15
27330,0,0,33,0,-33
27331,1,1,90,1358,1268
27332,1,1,354,1283,929
27333,0,0,34,0,-34
27334,1,0,0,0,0
27335,1,1,765,2187,1422
27336,0,0,43,0,-43
27337,0,0,50,0,-50
27338,0,0,10,0,-10
27339,1,0,78,0,-78
27340,0,0,1,0,-1
27341,1,1,2108,1336,-772
27342,0,0,16,0,-16
27343,1,0,33,0,-33
27344,0,0,8,0,-8
27345,0,0,67,0,-67
27346,0,0,32,0,-32
27347,1,0,74,0,-74
27348,0,0,47,0,-47
27349,1,0,4,0,-4
27350,1,0,1,0,-1
27351,1,0,56,0,-56
27352,0,0,136,0,-136
27353,0,0,48,0,-48
27354,0,0,41,0,-41
27355,1,1,1347,1297,-50
27356,1,0,82,0,-82
27357,1,0,100,0,-100
27358,1,1,1656,1938,282
27359,1,0,15,0,-15
27360,1,1,83,1408,1325
27361,0,0,64,0,-64
27362,0,0,132,0,-132
27363,1,1,1545,1391,-154
27364,0,0,2,0,-2
27365,0,0,42,0,-42
27366,1,0,63,0,-63
27367,1,1,920,1592,672
27368,0,0,14,0,-14
27369,0,0,5,0,-5
27370,1,1,269,1995,1726
27371,0,0,42,0,-42
27372,0,0,47,0,-47
27373,1,0,32,0,-32
27374,1,0,12,0,-12
27375,0,0,80,0,-80
27376,1,1,784,1906,1122
27377,0,0,1,0,-1
27378,1,1,903,2200,1297
27379,1,0,85,0,-85
27380,1,0,23,0,-23
27381,1,0,153,0,-153
27382,0,0,14,0,-14
27383,0,0,48,0,-48
27384,1,1,260,1405,1145
27385,0,0,8,0,-8
27386,1,1,41,1227,1186
27387,0,0,7,0,-7
27388,0,0,21,0,-21
27389,1,0,95,0,-95
27390,1,0,24,0,-24
27391,1,1,665,1903,1238
27392,0,0,58,0,-58
27393,1,1,2359,1688,-671
27394,0,0,92,0,-92
27395,0,0,91,0,-91
27396,0,0,3,0,-3
27397,1,1,251,1205,954
27398,0,0,37,0,-37
27399,1,1,245,1670,1425
27400,1,1,902,1898,996
27401,1,0,89,0,-89
27402,1,0,17,0,-17
27403,0,0,26,0,-26
27404,1,0,73,0,-73
27405,1,0,5,0,-5
27406,1,1,986,1246,260
27407,1,0,104,0,-104
27408,0,0,54,0,-54
27409,0,0,12,0,-12
27410,1,0,20,0,-20
27411,1,0,4,0,-4
27412,0,0,67,0,-67
27413,1,1,555,1209,654
27414,0,0,10,0,-10
27415,0,0,23,0,-23
27416,1,0,38,0,-38
27417,1,1,460,1572,1112
27418,0,0,57,0,-57
27419,0,0,6,0,-6
27420,1,1,793,1577,784
27421,0,0,27,0,-27
27422,1,1,188,2065,1877
27423,0,0,40,0,-40
27424,1,0,64,0,-64
27425,1,0,12,0,-12
27426,1,1,659,2661,2002
27427,1,1,1425,1628,203
27428,1,0,61,0,-61
27429,1,1,722,1220,498
27430,1,0,1,0,-1
27431,0,0,22,0,-22
27432,1,1,786,1224,438
27433,1,1,229,1352,1123
27434,1,0,32,0,-32
27435,0,0,49,0,-49
27436,1,1,237,1256,1019
27437,0,0,82,0,-82
27438,0,0,168,0,-168
27439,1,1,391,1261,870
27440,1,0,65,0,-65
27441,1,0,40,0,-40
27442,0,0,31,0,-31
27443,0,0,70,0,-70
27444,1,1,446,1263,817
27445,1,0,9,0,-9
27446,0,0,132,0,-132
27447,1,0,53,0,-53
27448,0,0,67,0,-67
27449,0,0,4,0,-4
27450,0,0,156,0,-156
27451,0,0,44,0,-44
27452,0,0,2,0,-2
27453,1,1,1236,1786,550
27454,0,0,9,0,-9
27455,1,1,845,3462,2617
27456,1,1,421,1489,1068
27457,1,0,0,0,0
27458,0,0,45,0,-45
27459,1,0,81,0,-81
27460,1,0,23,0,-23
27461,0,0,14,0,-14
27462,1,0,17,0,-17
27463,1,0,9,0,-9
27464,0,0,9,0,-9
27465,0,0,1,0,-1
27466,0,0,31,0,-31
27467,0,0,14,0,-14
27468,1,0,100,0,-100
27469,0,0,148,0,-148
27470,0,0,63,0,-63
27471,0,0,166,0,-166
27472,1,0,49,0,-49
27473,1,0,56,0,-56
27474,1,1,67,1397,1330
27475,0,0,25,0,-25
27476,1,0,4,0,-4
27477,0,0,7,0,-7
27478,0,0,14,0,-14
27479,1,0,1,0,-1
27480,1,0,68,0,-68
27481,1,1,436,1375,939
27482,1,1,180,3226,3046
27483,1,0,153,0,-153
27484,1,1,803,1295,492
27485,0,0,90,0,-90
27486,0,0,2,0,-2
27487,0,0,274,0,-274
27488,0,0,9,0,-9
27489,0,0,142,0,-142
27490,1,1,343,1824,1481
27491,1,0,8,0,-8
27492,0,0,37,0,-37
27493,1,1,149,1283,1134
27494,1,1,4,1460,1456
27495,1,0,149,0,-149
27496,0,0,100,0,-100
27497,0,0,36,0,-36
27498,1,0,76,0,-76
27499,1,1,494,1865,1371
27500,0,0,65,0,-65
27501,1,1,273,1965,1692
27502,1,1,395,1238,843
27503,1,0,80,0,-80
27504,1,0,12,0,-12
27505,1,0,28,0,-28
27506,1,0,134,0,-134
27507,1,1,194,1217,1023
27508,1,0,45,0,-45
27509,0,0,18,0,-18
27510,1,0,95,0,-95
27511,1,0,39,0,-39
27512,1,0,24,0,-24
27513,0,0,27,0,-27
27514,0,0,44,0,-44
27515,0,0,10,0,-10
27516,1,1,328,1627,1299
27517,0,0,80,0,-80
27518,0,0,91,0,-91
27519,1,0,134,0,-134
27520,1,1,107,1378,1271
27521,1,0,110,0,-110
27522,0,0,71,0,-71
27523,1,1,525,1377,852
27524,1,1,191,2059,1868
27525,1,0,33,0,-33
27526,0,0,38,0,-38
27527,1,0,84,0,-84
27528,1,1,689,1491,802
27529,1,1,62,1626,1564
27530,1,1,592,1368,776
27531,1,0,2,0,-2
27532,1,1,274,1212,938
27533,1,1,56,1563,1507
27534,1,0,53,0,-53
27535,1,1,126,1279,1153
27536,1,1,1179,1212,33
27537,0,0,38,0,-38
27538,1,0,49,0,-49
27539,1,0,22,0,-22
27540,1,0,5,0,-5
27541,1,0,74,0,-74
27542,1,0,64,0,-64
27543,0,0,3,0,-3
27544,0,0,76,0,-76
27545,1,0,30,0,-30
27546,0,0,71,0,-71
27547,0,0,203,0,-203
27548,1,1,1051,1296,245
27549,1,1,263,2694,2431
27550,1,1,113,1688,1575
27551,0,0,27,0,-27
27552,0,0,41,0,-41
27553,0,0,93,0,-93
27554,0,0,53,0,-53
27555,1,1,1061,1209,148
27556,1,1,183,1380,1197
27557,0,0,55,0,-55
27558,1,0,85,0,-85
27559,1,0,136,0,-136
27560,0,0,18,0,-18
27561,0,0,81,0,-81
27562,0,0,45,0,-45
27563,1,1,457,1529,1072
27564,0,0,33,0,-33
27565,1,1,56,1848,1792
27566,0,0,90,0,-90
27567,1,1,274,1536,1262
27568,0,0,50,0,-50
27569,1,1,360,1861,1501
27570,0,0,18,0,-18
27571,1,0,76,0,-76
27572,1,1,452,1559,1107
27573,1,1,1300,1462,162
27574,0,0,4,0,-4
27575,1,0,4,0,-4
27576,0,0,24,0,-24
27577,0,0,49,0,-49
27578,1,1,952,1264,312
27579,1,1,201,2116,1915
27580,1,1,80,1550,1470
27581,0,0,3,0,-3
27582,0,0,54,0,-54
27583,0,0,23,0,-23
27584,1,1,380,1320,940
27585,1,1,816,1624,808
27586,0,0,44,0,-44
27587,0,0,84,0,-84
27588,1,1,579,2076,1497
27589,0,0,68,0,-68
27590,0,0,71,0,-71
27591,1,0,60,0,-60
27592,0,0,28,0,-28
27593,1,0,20,0,-20
27594,1,0,15,0,-15
27595,1,1,1142,1435,293
27596,0,0,77,0,-77
27597,1,0,10,0,-10
27598,1,0,36,0,-36
27599,1,1,2941,1535,-1406
27600,0,0,67,0,-67
27601,1,1,135,1391,1256
27602,1,1,73,1858,1785
27603,1,0,47,0,-47
27604,0,0,84,0,-84
27605,1,1,815,1745,930
27606,1,0,47,0,-47
27607,1,0,6,0,-6
27608,1,0,10,0,-10
27609,1,1,1307,2511,1204
27610,0,0,3,0,-3
27611,0,0,11,0,-11
27612,1,0,87,0,-87
27613,0,0,7,0,-7
27614,1,1,119,1236,1117
27615,1,1,240,1263,1023
27616,1,0,84,0,-84
27617,0,0,37,0,-37
27618,0,0,2,0,-2
27619,0,0,36,0,-36
27620,0,0,7,0,-7
27621,0,0,36,0,-36
27622,0,0,41,0,-41
27623,0,0,7,0,-7
27624,1,1,669,1477,808
27625,1,1,157,2142,1985
27626,1,1,302,2278,1976
27627,0,0,30,0,-30
27628,0,0,87,0,-87
27629,1,1,537,1561,1024
27630,0,0,9,0,-9
27631,1,1,239,3828,3589
27632,1,0,0,0,0
27633,1,1,227,1538,1311
27634,0,0,39,0,-39
27635,1,1,255,1274,1019
27636,1,1,1065,1435,370
27637,1,0,34,0,-34
27638,1,0,39,0,-39
27639,1,1,452,1995,1543
27640,0,0,0,0,0
27641,1,1,1072,2297,1225
27642,0,0,61,0,-61
27643,0,0,56,0,-56
27644,1,0,1,0,-1
27645,0,0,64,0,-64
27646,0,0,87,0,-87
27647,0,0,13,0,-13
27648,1,0,50,0,-50
27649,1,1,81,1241,1160
27650,1,0,5,0,-5
27651,0,0,100,0,-100
27652,0,0,57,0,-57
27653,0,0,87,0,-87
27654,0,0,40,0,-40
27655,1,0,45,0,-45
27656,1,1,395,1201,806
27657,0,0,53,0,-53
27658,1,0,110,0,-110
27659,0,0,9,0,-9
27660,1,1,804,1416,612
27661,1,0,21,0,-21
27662,1,0,33,0,-33
27663,0,0,39,0,-39
27664,0,0,14,0,-14
27665,0,0,82,0,-82
27666,0,0,25,0,-25
27667,1,1,382,1389,1007
27668,1,0,57,0,-57
27669,1,1,2444,1828,-616
27670,1,1,66,1273,1207
27671,0,0,72,0,-72
27672,1,0,56,0,-56
27673,1,0,180,0,-180
27674,1,1,187,1206,1019
27675,1,0,38,0,-38
27676,1,0,55,0,-55
27677,1,1,127,2139,2012
27678,1,0,61,0,-61
27679,0,0,8,0,-8
27680,0,0,49,0,-49
27681,0,0,3,0,-3
27682,0,0,9,0,-9
27683,1,0,11,0,-11
27684,0,0,33,0,-33
27685,1,0,39,0,-39
27686,0,0,61,0,-61
27687,0,0,35,0,-35
27688,1,1,265,1271,1006
27689,1,0,101,0,-101
27690,1,0,92,0,-92
27691,1,1,988,1260,272
27692,0,0,35,0,-35
27693,1,0,78,0,-78
27694,0,0,95,0,-95
27695,0,0,5,0,-5
27696,1,0,26,0,-26
27697,0,0,22,0,-22
27698,0,0,18,0,-18
27699,1,0,40,0,-40
27700,1,0,1,0,-1
27701,1,1,1110,1506,396
27702,1,0,197,0,-197
27703,0,0,32,0,-32
27704,1,0,70,0,-70
27705,1,1,2974,1779,-1195
27706,0,0,37,0,-37
27707,1,0,10,0,-10
27708,1,0,45,0,-45
27709,1,1,72,1461,1389
27710,1,0,59,0,-59
27711,0,0,1,0,-1
27712,1,1,133,1224,1091
27713,0,0,7,0,-7
27714,0,0,21,0,-21
27715,1,1,292,1215,923
27716,1,0,28,0,-28
27717,1,1,785,1371,586
27718,1,0,6,0,-6
27719,0,0,51,0,-51
27720,0,0,86,0,-86
27721,0,0,0,0,0
27722,1,0,3,0,-3
27723,1,0,124,0,-124
27724,0,0,136,0,-136
27725,0,0,260,0,-260
27726,1,1,183,1546,1363
27727,1,1,434,1653,1219
27728,1,0,28,0,-28
27729,0,0,69,0,-69
27730,0,0,40,0,-40
27731,0,0,38,0,-38
27732,1,1,89,1249,1160
27733,0,0,17,0,-17
27734,1,0,130,0,-130
27735,1,0,148,0,-148
27736,0,0,10,0,-10
27737,0,0,49,0,-49
27738,0,0,40,0,-40
27739,1,1,1057,1242,185
27740,0,0,76,0,-76
27741,1,1,618,1201,583
27742,0,0,1,0,-1
27743,0,0,90,0,-90
27744,0,0,156,0,-156
27745,0,0,14,0,-14
27746,1,0,26,0,-26
27747,1,1,102,1266,1164
27748,0,0,25,0,-25
27749,0,0,11,0,-11
27750,1,1,234,1560,1326
27751,1,0,1,0,-1
27752,1,0,143,0,-143
27753,0,0,5,0,-5
27754,1,0,41,0,-41
27755,0,0,72,0,-72
27756,0,0,40,0,-40
27757,1,1,37,1550,1513
27758,1,0,23,0,-23
27759,0,0,97,0,-97
27760,1,1,294,1431,1137
27761,0,0,21,0,-21
27762,0,0,5,0,-5
27763,0,0,10,0,-10
27764,1,1,266,1254,988
27765,1,0,30,0,-30
27766,1,1,1108,1206,98
27767,1,1,1129,2089,960
27768,1,1,1858,1377,-481
27769,1,0,38,0,-38
27770,1,0,91,0,-91
27771,0,0,50,0,-50
27772,1,1,176,2222,2046
27773,0,0,30,0,-30
27774,1,0,39,0,-39
27775,0,0,44,0,-44
27776,1,0,61,0,-61
27777,0,0,54,0,-54
27778,1,1,101,1428,1327
27779,0,0,27,0,-27
27780,0,0,73,0,-73
27781,1,0,24,0,-24
27782,1,1,950,1310,360
27783,1,0,69,0,-69
27784,1,0,15,0,-15
27785,0,0,11,0,-11
27786,1,0,63,0,-63
27787,1,1,89,1550,1461
27788,1,0,18,0,-18
27789,1,0,14,0,-14
27790,1,1,54,1213,1159
27791,0,0,0,0,0
27792,0,0,5,0,-5
27793,0,0,66,0,-66
27794,1,1,1162,1205,43
27795,1,0,28,0,-28
27796,0,0,102,0,-102
27797,1,0,65,0,-65
27798,1,0,47,0,-47
27799,0,0,18,0,-18
27800,0,0,9,0,-9
27801,0,0,35,0,-35
27802,1,0,4,0,-4
27803,0,0,56,0,-56
27804,1,1,1195,1549,354
27805,1,0,9,0,-9
27806,1,0,15,0,-15
27807,1,1,325,1505,1180
27808,0,0,56,0,-56
27809,1,1,169,1208,1039
27810,0,0,46,0,-46
27811,1,1,812,1412,600
27812,0,0,33,0,-33
27813,0,0,57,0,-57
27814,1,1,393,1589,1196
27815,1,0,112,0,-112
27816,0,0,8,0,-8
27817,0,0,37,0,-37
27818,0,0,17,0,-17
27819,1,1,163,1317,1154
27820,0,0,45,0,-45
27821,1,0,15,0,-15
27822,1,0,6,0,-6
27823,1,1,690,1692,1002
27824,0,0,88,0,-88
27825,1,1,294,1634,1340
27826,1,0,109,0,-109
27827,1,0,182,0,-182
27828,1,0,10,0,-10
27829,1,1,784,1314,530
27830,0,0,25,0,-25
27831,0,0,36,0,-36
27832,1,1,73,1698,1625
27833,1,1,18,1419,1401
27834,1,0,96,0,-96
27835,1,0,26,0,-26
27836,0,0,13,0,-13
27837,1,1,85,1407,1322
27838,1,0,3,0,-3
27839,0,0,72,0,-72
27840,1,1,79,1273,1194
27841,0,0,6,0,-6
27842,0,0,80,0,-80
27843,1,0,11,0,-11
27844,1,1,905,1299,394
27845,0,0,7,0,-7
27846,1,0,62,0,-62
27847,0,0,19,0,-19
27848,1,0,54,0,-54
27849,0,0,1,0,-1
27850,1,0,76,0,-76
27851,0,0,45,0,-45
27852,0,0,3,0,-3
27853,1,0,13,0,-13
27854,0,0,17,0,-17
27855,1,1,156,1520,1364
27856,1,0,23,0,-23
27857,1,1,288,7055,6767
27858,0,0,23,0,-23
27859,0,0,3,0,-3
27860,1,1,826,1889,1063
27861,1,1,1177,1220,43
27862,1,0,104,0,-104
27863,1,0,149,0,-149
27864,0,0,132,0,-132
27865,1,1,807,1349,542
27866,0,0,26,0,-26
27867,1,0,10,0,-10
27868,1,1,208,3711,3503
27869,1,0,36,0,-36
27870,1,1,141,1405,1264
27871,1,1,356,1842,1486
27872,0,0,32,0,-32
27873,1,1,684,1444,760
27874,0,0,14,0,-14
27875,1,0,9,0,-9
27876,1,0,26,0,-26
27877,0,0,1,0,-1
27878,1,0,135,0,-135
27879,1,0,57,0,-57
27880,1,0,3,0,-3
27881,0,0,30,0,-30
27882,1,1,462,1922,1460
27883,1,0,15,0,-15
27884,0,0,179,0,-179
27885,1,1,250,1200,950
27886,1,0,53,0,-53
27887,1,1,1486,1246,-240
27888,1,1,259,1216,957
27889,1,1,546,2876,2330
27890,1,1,285,1332,1047
27891,0,0,39,0,-39
27892,1,1,730,3156,2426
27893,1,0,43,0,-43
27894,1,1,475,2531,2056
27895,1,0,95,0,-95
27896,0,0,80,0,-80
27897,0,0,5,0,-5
27898,0,0,43,0,-43
27899,0,0,3,0,-3
27900,0,0,111,0,-111
27901,1,1,308,1319,1011
27902,0,0,36,0,-36
27903,1,1,559,1270,711
27904,0,0,20,0,-20
27905,0,0,19,0,-19
27906,1,0,42,0,-42
27907,1,0,44,0,-44
27908,0,0,112,0,-112
27909,0,0,153,0,-153
27910,1,0,2,0,-2
27911,0,0,83,0,-83
27912,0,0,50,0,-50
27913,0,0,104,0,-104
27914,1,0,68,0,-68
27915,1,1,249,2155,1906
27916,0,0,18,0,-18
27917,1,1,1288,1456,168
27918,1,0,24,0,-24
27919,1,1,1874,1547,-327
27920,0,0,7,0,-7
27921,0,0,107,0,-107
27922,0,0,1,0,-1
27923,0,0,3,0,-3
27924,1,1,64,1357,1293
27925,0,0,17,0,-17
27926,0,0,150,0,-150
27927,1,0,33,0,-33
27928,1,1,276,1406,1130
27929,1,0,94,0,-94
27930,1,0,53,0,-53
27931,0,0,68,0,-68
27932,1,1,146,2613,2467
27933,0,0,16,0,-16
27934,0,0,128,0,-128
27935,0,0,209,0,-209
27936,1,1,80,1512,1432
27937,1,1,518,1532,1014
27938,1,0,2,0,-2
27939,1,0,3,0,-3
27940,0,0,49,0,-49
27941,0,0,26,0,-26
27942,0,0,52,0,-52
27943,1,1,243,1789,1546
27944,0,0,272,0,-272
27945,1,0,6,0,-6
27946,1,1,474,1448,974
27947,1,1,465,1270,805
27948,0,0,43,0,-43
27949,0,0,7,0,-7
27950,1,1,112,3345,3233
27951,0,0,24,0,-24
27952,0,0,78,0,-78
27953,1,1,500,1251,751
27954,1,1,1716,2005,289
27955,0,0,20,0,-20
27956,0,0,0,0,0
27957,1,0,33,0,-33
27958,0,0,51,0,-51
27959,0,0,86,0,-86
27960,0,0,42,0,-42
27961,1,1,593,1346,753
27962,1,1,312,1658,1346
27963,0,0,79,0,-79
27964,0,0,68,0,-68
27965,0,0,22,0,-22
27966,1,1,1394,1465,71
27967,1,1,917,1836,919
27968,0,0,8,0,-8
27969,0,0,1,0,-1
27970,1,0,55,0,-55
27971,1,0,73,0,-73
27972,0,0,81,0,-81
27973,1,0,122,0,-122
27974,0,0,150,0,-150
27975,0,0,99,0,-99
27976,0,0,3,0,-3
27977,0,0,60,0,-60
27978,1,1,443,1589,1146
27979,1,0,195,0,-195
27980,1,1,145,1454,1309
27981,1,1,1565,1455,-110
27982,1,0,2,0,-2
27983,1,1,175,1429,1254
27984,1,1,1023,1675,652
27985,1,0,2,0,-2
27986,1,0,66,0,-66
27987,1,1,883,3134,2251
27988,0,0,77,0,-77
27989,1,1,143,1390,1247
27990,1,0,33,0,-33
27991,0,0,6,0,-6
27992,1,1,974,1299,325
27993,1,1,275,1863,1588
27994,1,0,73,0,-73
27995,1,1,169,1404,1235
27996,1,0,115,0,-115
27997,1,1,278,1329,1051
27998,0,0,91,0,-91
27999,1,0,60,0,-60
28000,0,0,44,0,-44
28001,1,1,728,1459,731
28002,0,0,3,0,-3
28003,1,0,25,0,-25
28004,1,0,27,0,-27
28005,1,1,791,1512,721
28006,0,0,6,0,-6
28007,1,1,1266,1566,300
28008,0,0,81,0,-81
28009,1,1,493,1262,769
28010,0,0,24,0,-24
28011,0,0,64,0,-64
28012,0,0,30,0,-30
28013,1,1,70,2587,2517
28014,1,0,27,0,-27
28015,0,0,33,0,-33
28016,0,0,45,0,-45
28017,1,0,13,0,-13
28018,0,0,81,0,-81
28019,1,1,220,1447,1227
28020,1,1,110,2477,2367
28021,0,0,43,0,-43
28022,0,0,9,0,-9
28023,0,0,3,0,-3
28024,1,0,62,0,-62
28025,1,0,5,0,-5
28026,1,0,147,0,-147
28027,1,0,87,0,-87
28028,1,1,892,1447,555
28029,0,0,44,0,-44
28030,1,0,48,0,-48
28031,1,0,8,0,-8
28032,1,0,47,0,-47
28033,1,0,60,0,-60
28034,0,0,203,0,-203
28035,1,1,1316,1396,80
28036,1,1,870,1496,626
28037,1,1,439,1365,926
28038,0,0,43,0,-43
28039,0,0,91,0,-91
28040,0,0,4,0,-4
28041,1,1,444,1274,830
28042,1,1,877,1226,349
28043,1,0,10,0,-10
28044,1,1,239,1359,1120
28045,1,1,270,2389,2119
28046,1,1,240,1221,981
28047,1,0,29,0,-29
28048,1,0,149,0,-149
28049,1,1,510,2165,1655
28050,1,1,92,1416,1324
28051,0,0,25,0,-25
28052,1,0,106,0,-106
28053,1,0,8,0,-8
28054,1,1,59,1663,1604
28055,1,0,38,0,-38
28056,1,0,19,0,-19
28057,0,0,52,0,-52
28058,0,0,175,0,-175
28059,1,0,38,0,-38
28060,1,1,481,2283,1802
28061,1,1,150,1961,1811
28062,1,1,252,1216,964
28063,1,0,55,0,-55
28064,1,0,72,0,-72
28065,1,0,61,0,-61
28066,1,0,68,0,-68
28067,1,1,207,1451,1244
28068,0,0,12,0,-12
28069,1,1,1620,1334,-286
28070,1,1,1239,1215,-24
28071,0,0,128,0,-128
28072,1,1,574,1491,917
28073,0,0,40,0,-40
28074,1,1,143,1413,1270
28075,0,0,2,0,-2
28076,1,0,54,0,-54
28077,1,0,72,0,-72
28078,0,0,18,0,-18
28079,1,1,365,1694,1329
28080,1,0,0,0,0
28081,1,1,732,3122,2390
28082,1,1,38,1200,1162
28083,1,1,130,1333,1203
28084,1,1,505,1385,880
28085,0,0,39,0,-39
28086,1,0,219,0,-219
28087,0,0,38,0,-38
28088,1,1,41,1596,1555
28089,1,0,83,0,-83
28090,1,0,35,0,-35
28091,1,1,59,1917,1858
28092,1,0,10,0,-10
28093,0,0,50,0,-50
28094,0,0,24,0,-24
28095,0,0,31,0,-31
28096,1,1,534,1259,725
28097,1,1,497,1602,1105
28098,1,1,363,3608,3245
28099,1,1,467,2650,2183
28100,1,1,64,1322,1258
28101,0,0,72,0,-72
28102,0,0,37,0,-37
28103,1,1,1402,3104,1702
28104,1,1,658,1437,779
28105,1,0,98,0,-98
28106,1,1,475,1960,1485
28107,1,1,346,1532,1186
28108,1,1,316,2265,1949
28109,1,1,511,1606,1095
28110,0,0,36,0,-36
28111,1,0,42,0,-42
28112,1,1,1898,1552,-346
28113,0,0,14,0,-14
28114,1,1,141,1449,1308
28115,1,0,57,0,-57
28116,0,0,109,0,-109
28117,0,0,46,0,-46
28118,1,0,0,0,0
28119,1,1,859,1427,568
28120,1,0,14,0,-14
28121,1,1,342,1454,1112
28122,0,0,21,0,-21
28123,1,1,58,1761,1703
28124,1,0,31,0,-31
28125,1,0,40,0,-40
28126,1,1,199,1391,1192
28127,1,0,13,0,-13
28128,1,1,1328,1508,180
28129,1,0,4,0,-4
28130,1,0,48,0,-48
28131,0,0,20,0,-20
28132,0,0,23,0,-23
28133,1,1,343,1667,1324
28134,1,1,1062,1305,243
28135,1,0,28,0,-28
28136,0,0,52,0,-52
28137,1,1,898,1415,517
28138,1,1,135,1867,1732
28139,0,0,40,0,-40
28140,1,1,304,1208,904
28141,1,0,107,0,-107
28142,0,0,29,0,-29
28143,0,0,98,0,-98
28144,1,0,143,0,-143
28145,0,0,60,0,-60
28146,1,1,477,1817,1340
28147,0,0,28,0,-28
28148,1,0,48,0,-48
28149,0,0,18,0,-18
28150,1,1,846,1635,789
28151,1,1,717,1205,488
28152,1,1,740,1219,479
28153,1,0,51,0,-51
28154,0,0,18,0,-18
28155,1,0,61,0,-61
28156,0,0,92,0,-92
28157,1,0,57,0,-57
28158,0,0,52,0,-52
28159,1,1,338,1287,949
28160,1,1,138,1242,1104
28161,0,0,135,0,-135
28162,0,0,96,0,-96
28163,0,0,117,0,-117
28164,0,0,54,0,-54
28165,0,0,4,0,-4
28166,0,0,199,0,-199
28167,1,1,974,1321,347
28168,1,0,24,0,-24
28169,0,0,142,0,-142
28170,1,0,59,0,-59
28171,0,0,1,0,-1
28172,0,0,8,0,-8
28173,1,1,65,1344,1279
28174,0,0,48,0,-48
28175,1,0,22,0,-22
28176,1,0,96,0,-96
28177,0,0,128,0,-128
28178,1,0,0,0,0
28179,1,1,73,1224,1151
28180,0,0,30,0,-30
28181,0,0,162,0,-162
28182,0,0,80,0,-80
28183,0,0,18,0,-18
28184,1,0,10,0,-10
28185,1,1,450,1394,944
28186,1,0,145,0,-145
28187,0,0,6,0,-6
28188,1,0,2,0,-2
28189,1,0,3,0,-3
28190,1,0,4,0,-4
28191,0,0,62,0,-62
28192,0,0,44,0,-44
28193,1,0,148,0,-148
28194,0,0,79,0,-79
28195,1,1,819,1549,730
28196,0,0,97,0,-97
28197,1,1,380,1295,915
28198,0,0,5,0,-5
28199,1,0,5,0,-5
28200,1,1,853,2190,1337
28201,1,0,133,0,-133
28202,1,1,260,1581,1321
28203,0,0,151,0,-151
28204,1,0,54,0,-54
28205,0,0,2,0,-2
28206,1,1,617,1765,1148
28207,0,0,3,0,-3
28208,1,1,1005,1547,542
28209,0,0,268,0,-268
28210,1,0,36,0,-36
28211,1,0,34,0,-34
28212,1,0,3,0,-3
28213,1,0,5,0,-5
28214,0,0,37,0,-37
28215,0,0,3,0,-3
28216,1,0,70,0,-70
28217,1,0,19,0,-19
28218,1,0,28,0,-28
28219,0,0,130,0,-130
28220,0,0,26,0,-26
28221,0,0,15,0,-15
28222,1,1,879,1264,385
28223,1,1,1775,2766,991
28224,1,0,20,0,-20
28225,1,1,576,1213,637
28226,0,0,17,0,-17
28227,1,1,197,2245,2048
28228,0,0,40,0,-40
28229,1,0,129,0,-129
28230,1,1,1408,1318,-90
28231,0,0,53,0,-53
28232,0,0,3,0,-3
28233,0,0,16,0,-16
28234,0,0,23,0,-23
28235,0,0,0,0,0
28236,1,0,85,0,-85
28237,1,0,95,0,-95
28238,0,0,2,0,-2
28239,0,0,6,0,-6
28240,1,0,167,0,-167
28241,0,0,29,0,-29
28242,0,0,30,0,-30
28243,0,0,137,0,-137
28244,1,0,8,0,-8
28245,0,0,59,0,-59
28246,0,0,106,0,-106
28247,1,0,27,0,-27
28248,1,1,979,1248,269
28249,1,0,42,0,-42
28250,1,0,32,0,-32
28251,0,0,10,0,-10
28252,0,0,18,0,-18
28253,0,0,115,0,-115
28254,1,0,125,0,-125
28255,0,0,18,0,-18
28256,1,1,923,2053,1130
28257,0,0,82,0,-82
28258,1,1,1452,1524,72
28259,1,0,106,0,-106
28260,1,1,290,1744,1454
28261,1,1,42,1221,1179
28262,0,0,9,0,-9
28263,0,0,18,0,-18
28264,0,0,76,0,-76
28265,1,0,47,0,-47
28266,1,0,30,0,-30
28267,0,0,123,0,-123
28268,1,0,67,0,-67
28269,1,0,112,0,-112
28270,1,1,122,1589,1467
28271,1,0,24,0,-24
28272,1,1,149,1267,1118
28273,1,0,21,0,-21
28274,1,1,251,1300,1049
28275,1,0,36,0,-36
28276,0,0,8,0,-8
28277,1,0,24,0,-24
28278,0,0,5,0,-5
28279,0,0,182,0,-182
28280,1,1,681,1380,699
28281,1,1,303,1320,1017
28282,0,0,54,0,-54
28283,1,1,171,1386,1215
28284,1,0,24,0,-24
28285,0,0,23,0,-23
28286,1,0,53,0,-53
28287,1,0,168,0,-168
28288,0,0,44,0,-44
28289,1,1,109,3087,2978
28290,1,0,44,0,-44
28291,0,0,177,0,-177
28292,1,0,7,0,-7
28293,0,0,38,0,-38
28294,1,0,70,0,-70
28295,1,1,150,1704,1554
28296,1,0,37,0,-37
28297,0,0,58,0,-58
28298,0,0,115,0,-115
28299,1,0,14,0,-14
28300,1,0,121,0,-121
28301,1,1,829,1383,554
28302,0,0,59,0,-59
28303,1,0,6,0,-6
28304,0,0,10,0,-10
28305,0,0,8,0,-8
28306,1,1,372,1494,1122
28307,0,0,14,0,-14
28308,0,0,46,0,-46
28309,0,0,51,0,-51
28310,1,1,222,1207,985
28311,1,0,9,0,-9
28312,0,0,67,0,-67
28313,1,1,93,1505,1412
28314,0,0,19,0,-19
28315,1,1,108,1230,1122
28316,1,0,53,0,-53
28317,1,1,338,1226,888
28318,1,1,299,1439,1140
28319,0,0,30,0,-30
28320,1,0,10,0,-10
28321,1,1,3407,1315,-2092
28322,0,0,21,0,-21
28323,0,0,64,0,-64
28324,0,0,67,0,-67
28325,1,0,105,0,-105
28326,1,0,36,0,-36
28327,1,0,21,0,-21
28328,0,0,1,0,-1
28329,0,0,11,0,-11
28330,0,0,55,0,-55
28331,1,1,384,1330,946
28332,1,0,23,0,-23
28333,0,0,46,0,-46
28334,1,0,68,0,-68
28335,1,1,114,1253,1139
28336,0,0,34,0,-34
28337,1,1,903,1790,887
28338,1,0,30,0,-30
28339,0,0,87,0,-87
28340,1,1,1005,1548,543
28341,0,0,39,0,-39
28342,0,0,37,0,-37
28343,1,1,948,2627,1679
28344,1,1,430,1256,826
28345,1,0,94,0,-94
28346,1,1,225,1236,1011
28347,0,0,31,0,-31
28348,0,0,112,0,-112
28349,1,0,7,0,-7
28350,0,0,12,0,-12
28351,0,0,86,0,-86
28352,0,0,129,0,-129
28353,0,0,118,0,-118
28354,1,0,62,0,-62
28355,1,1,489,1352,863
28356,0,0,8,0,-8
28357,1,0,79,0,-79
28358,1,0,0,0,0
28359,1,0,33,0,-33
28360,0,0,79,0,-79
28361,0,0,65,0,-65
28362,1,0,16,0,-16
28363,1,1,1178,1518,340
28364,1,1,508,1367,859
28365,1,0,138,0,-138
28366,1,0,44,0,-44
28367,1,0,75,0,-75
28368,0,0,22,0,-22
28369,0,0,15,0,-15
28370,0,0,45,0,-45
28371,1,1,104,1756,1652
28372,1,0,11,0,-11
28373,0,0,96,0,-96
28374,1,1,556,1273,717
28375,1,1,120,1838,1718
28376,1,1,500,1291,791
28377,1,0,96,0,-96
28378,0,0,30,0,-30
28379,0,0,24,0,-24
28380,1,1,841,1232,391
28381,1,1,843,1296,453
28382,1,0,28,0,-28
28383,1,0,9,0,-9
28384,1,1,310,1354,1044
28385,0,0,13,0,-13
28386,1,1,105,1255,1150
28387,1,0,17,0,-17
28388,1,1,787,1318,531
28389,0,0,86,0,-86
28390,0,0,20,0,-20
28391,1,0,70,0,-70
28392,1,1,349,1369,1020
28393,1,1,443,1243,800
28394,1,0,24,0,-24
28395,1,0,52,0,-52
28396,1,1,292,1351,1059
28397,1,1,461,2218,1757
28398,1,1,377,1831,1454
28399,0,0,5,0,-5
28400,1,0,16,0,-16
28401,1,0,9,0,-9
28402,1,0,181,0,-181
28403,0,0,111,0,-111
28404,1,0,68,0,-68
28405,0,0,9,0,-9
28406,1,1,727,1349,622
28407,0,0,194,0,-194
28408,0,0,22,0,-22
28409,1,0,69,0,-69
28410,1,0,14,0,-14
28411,1,0,22,0,-22
28412,0,0,13,0,-13
28413,1,0,8,0,-8
28414,0,0,47,0,-47
28415,0,0,129,0,-129
28416,0,0,19,0,-19
28417,1,1,187,1232,1045
28418,1,1,1604,1922,318
28419,1,0,16,0,-16
28420,0,0,115,0,-115
28421,1,1,598,7784,7186
28422,0,0,150,0,-150
28423,1,0,36,0,-36
28424,0,0,86,0,-86
28425,0,0,156,0,-156
28426,0,0,0,0,0
28427,0,0,95,0,-95
28428,1,0,37,0,-37
28429,0,0,65,0,-65
28430,1,1,323,1212,889
28431,1,1,435,1918,1483
28432,0,0,53,0,-53
28433,0,0,44,0,-44
28434,0,0,42,0,-42
28435,1,1,127,2014,1887
28436,0,0,41,0,-41
28437,0,0,12,0,-12
28438,1,1,650,1583,933
28439,0,0,94,0,-94
28440,0,0,39,0,-39
28441,1,0,47,0,-47
28442,1,0,18,0,-18
28443,0,0,386,0,-386
28444,1,0,47,0,-47
28445,1,1,608,1216,608
28446,1,1,1716,1608,-108
28447,0,0,5,0,-5
28448,0,0,32,0,-32
28449,1,1,37,2129,2092
28450,0,0,98,0,-98
28451,1,0,124,0,-124
28452,0,0,31,0,-31
28453,0,0,48,0,-48
28454,1,1,22,1203,1181
28455,1,1,84,2283,2199
28456,1,0,31,0,-31
28457,0,0,19,0,-19
28458,0,0,13,0,-13
28459,0,0,0,0,0
28460,1,0,27,0,-27
28461,1,0,137,0,-137
28462,1,0,133,0,-133
28463,0,0,67,0,-67
28464,0,0,103,0,-103
28465,1,0,42,0,-42
28466,1,0,88,0,-88
28467,1,1,1323,1222,-101
28468,0,0,10,0,-10
28469,1,1,1074,2534,1460
28470,1,0,13,0,-13
28471,1,0,8,0,-8
28472,1,0,2,0,-2
28473,0,0,33,0,-33
28474,1,0,66,0,-66
28475,0,0,17,0,-17
28476,1,1,257,1213,956
28477,0,0,5,0,-5
28478,0,0,27,0,-27
28479,0,0,31,0,-31
28480,0,0,41,0,-41
28481,1,1,178,1614,1436
28482,0,0,36,0,-36
28483,1,1,290,1537,1247
28484,0,0,95,0,-95
28485,0,0,16,0,-16
28486,0,0,116,0,-116
28487,1,1,885,3852,2967
28488,0,0,75,0,-75
28489,1,1,1488,1315,-173
28490,1,0,184,0,-184
28491,1,1,855,1585,730
28492,1,0,141,0,-141
28493,1,0,12,0,-12
28494,0,0,107,0,-107
28495,1,1,1367,1287,-80
28496,0,0,8,0,-8
28497,1,1,282,1312,1030
28498,1,1,262,1830,1568
28499,1,1,328,1330,1002
28500,1,1,342,1331,989
28501,1,0,77,0,-77
28502,0,0,115,0,-115
28503,1,0,1,0,-1
28504,1,1,238,1299,1061
28505,1,0,105,0,-105
28506,1,0,65,0,-65
28507,1,1,365,1265,900
28508,0,0,77,0,-77
28509,0,0,16,0,-16
28510,0,0,7,0,-7
28511,1,0,49,0,-49
28512,1,1,44,1237,1193
28513,1,0,49,0,-49
28514,0,0,118,0,-118
28515,1,0,21,0,-21
28516,1,1,666,1511,845
28517,1,0,45,0,-45
28518,1,0,113,0,-113
28519,0,0,61,0,-61
28520,1,1,119,1438,1319
28521,1,0,113,0,-113
28522,1,0,175,0,-175
28523,1,1,319,5444,5125
28524,1,1,690,1395,705
28525,1,0,191,0,-191
28526,0,0,10,0,-10
28527,1,1,25,1465,1440
28528,0,0,69,0,-69
28529,1,1,153,1635,1482
28530,0,0,8,0,-8
28531,0,0,58,0,-58
28532,0,0,78,0,-78
28533,0,0,5,0,-5
28534,1,1,635,1492,857
28535,0,0,73,0,-73
28536,1,1,2403,1279,-1124
28537,1,1,152,1390,1238
28538,1,0,24,0,-24
28539,1,1,402,2368,1966
28540,1,1,58,1228,1170
28541,1,0,103,0,-103
28542,1,1,269,1315,1046
28543,1,1,104,1549,1445
28544,1,0,25,0,-25
28545,1,1,168,1955,1787
28546,0,0,13,0,-13
28547,0,0,57,0,-57
28548,1,0,18,0,-18
28549,1,0,47,0,-47
28550,1,1,215,1576,1361
28551,0,0,104,0,-104
28552,0,0,37,0,-37
28553,0,0,177,0,-177
28554,1,1,1476,1472,-4
28555,0,0,89,0,-89
28556,1,0,30,0,-30
28557,0,0,193,0,-193
28558,0,0,142,0,-142
28559,1,0,21,0,-21
28560,1,1,336,1216,880
28561,1,1,742,1688,946
28562,0,0,37,0,-37
28563,0,0,72,0,-72
28564,1,0,2,0,-2
28565,1,1,95,1218,1123
28566,0,0,10,0,-10
28567,1,1,1150,1423,273
28568,1,0,22,0,-22
28569,1,1,588,1238,650
28570,1,1,2245,1376,-869
28571,0,0,55,0,-55
28572,1,0,126,0,-126
28573,1,1,988,1538,550
28574,0,0,1,0,-1
28575,0,0,7,0,-7
28576,0,0,64,0,-64
28577,0,0,46,0,-46
28578,0,0,95,0,-95
28579,1,1,241,1260,1019
28580,0,0,35,0,-35
28581,0,0,151,0,-151
28582,0,0,110,0,-110
28583,1,1,407,1415,1008
28584,1,0,53,0,-53
28585,1,0,3,0,-3
28586,0,0,28,0,-28
28587,1,1,49,1341,1292
28588,1,1,335,1255,920
28589,1,1,472,1356,884
28590,1,1,24,1289,1265
28591,0,0,26,0,-26
28592,1,1,70,1420,1350
28593,1,0,109,0,-109
28594,0,0,97,0,-97
28595,0,0,12,0,-12
28596,0,0,60,0,-60
28597,0,0,44,0,-44
28598,0,0,36,0,-36
28599,0,0,100,0,-100
28600,0,0,21,0,-21
28601,1,0,193,0,-193
28602,1,1,481,2168,1687
28603,0,0,18,0,-18
28604,0,0,24,0,-24
28605,1,1,166,1526,1360
28606,0,0,127,0,-127
28607,1,1,140,1437,1297
28608,1,0,37,0,-37
28609,1,0,61,0,-61
28610,0,0,39,0,-39
28611,1,0,95,0,-95
28612,1,0,71,0,-71
28613,1,0,43,0,-43
28614,0,0,50,0,-50
28615,1,1,100,1679,1579
28616,1,0,133,0,-133
28617,0,0,91,0,-91
28618,1,0,77,0,-77
28619,0,0,33,0,-33
28620,1,1,404,1291,887
28621,1,1,250,1366,1116
28622,0,0,1,0,-1
28623,1,1,194,1244,1050
28624,0,0,49,0,-49
28625,1,1,505,1226,721
28626,1,1,320,1301,981
28627,1,0,38,0,-38
28628,0,0,49,0,-49
28629,1,1,66,1746,1680
28630,0,0,53,0,-53
28631,1,0,25,0,-25
28632,1,0,40,0,-40
28633,0,0,24,0,-24
28634,1,1,499,1281,782
28635,1,0,62,0,-62
28636,1,0,30,0,-30
28637,1,0,10,0,-10
28638,0,0,36,0,-36
28639,1,1,2290,3821,1531
28640,0,0,10,0,-10
28641,0,0,5,0,-5
28642,1,0,57,0,-57
28643,1,1,546,1358,812
28644,0,0,36,0,-36
28645,0,0,91,0,-91
28646,1,0,4,0,-4
28647,1,0,37,0,-37
28648,1,0,70,0,-70
28649,0,0,54,0,-54
28650,1,1,631,1604,973
28651,1,1,577,1340,763
28652,1,0,123,0,-123
28653,0,0,73,0,-73
28654,1,1,347,1250,903
28655,0,0,20,0,-20
28656,1,0,18,0,-18
28657,0,0,3,0,-3
28658,1,0,6,0,-6
28659,1,0,83,0,-83
28660,0,0,11,0,-11
28661,1,1,420,1377,957
28662,0,0,7,0,-7
28663,1,0,179,0,-179
28664,0,0,75,0,-75
28665,1,1,1227,1350,123
28666,0,0,24,0,-24
28667,1,1,1225,1437,212
28668,0,0,68,0,-68
28669,0,0,15,0,-15
28670,1,0,41,0,-41
